Middle Super Output Area,Year,MSOA11NM,LAD11NM,LAD11CD,Total,M,F
E02000001,2002,City of London 001,City of London,E09000001,5728 ,3222 ,2506 
E02000002,2002,Barking and Dagenham 001,Barking and Dagenham,E09000002,3599 ,1707 ,1892 
E02000003,2002,Barking and Dagenham 002,Barking and Dagenham,E09000002,6026 ,2907 ,3119 
E02000004,2002,Barking and Dagenham 003,Barking and Dagenham,E09000002,3888 ,1877 ,2011 
E02000005,2002,Barking and Dagenham 004,Barking and Dagenham,E09000002,4983 ,2423 ,2560 
E02000007,2002,Barking and Dagenham 006,Barking and Dagenham,E09000002,4686 ,2165 ,2521 
E02000008,2002,Barking and Dagenham 007,Barking and Dagenham,E09000002,6391 ,3108 ,3283 
E02000009,2002,Barking and Dagenham 008,Barking and Dagenham,E09000002,5725 ,2762 ,2963 
E02000010,2002,Barking and Dagenham 009,Barking and Dagenham,E09000002,4871 ,2348 ,2523 
E02000011,2002,Barking and Dagenham 010,Barking and Dagenham,E09000002,3829 ,1938 ,1891 
E02000012,2002,Barking and Dagenham 011,Barking and Dagenham,E09000002,4900 ,2397 ,2503 
E02000013,2002,Barking and Dagenham 012,Barking and Dagenham,E09000002,4778 ,2254 ,2524 
E02000014,2002,Barking and Dagenham 013,Barking and Dagenham,E09000002,5591 ,2778 ,2813 
E02000015,2002,Barking and Dagenham 014,Barking and Dagenham,E09000002,4254 ,2030 ,2224 
E02000016,2002,Barking and Dagenham 015,Barking and Dagenham,E09000002,4198 ,2160 ,2038 
E02000017,2002,Barking and Dagenham 016,Barking and Dagenham,E09000002,5298 ,2771 ,2527 
E02000018,2002,Barking and Dagenham 017,Barking and Dagenham,E09000002,4702 ,2235 ,2467 
E02000019,2002,Barking and Dagenham 018,Barking and Dagenham,E09000002,4729 ,2333 ,2396 
E02000020,2002,Barking and Dagenham 019,Barking and Dagenham,E09000002,4646 ,2279 ,2367 
E02000021,2002,Barking and Dagenham 020,Barking and Dagenham,E09000002,4885 ,2411 ,2474 
E02000022,2002,Barking and Dagenham 021,Barking and Dagenham,E09000002,4243 ,2025 ,2218 
E02000023,2002,Barking and Dagenham 022,Barking and Dagenham,E09000002,3915 ,1881 ,2034 
E02006799,2002,Barking and Dagenham 023,Barking and Dagenham,E09000002,5499 ,2647 ,2852 
E02000024,2002,Barnet 001,Barnet,E09000003,6019 ,2934 ,3085 
E02000025,2002,Barnet 002,Barnet,E09000003,5141 ,2531 ,2610 
E02000026,2002,Barnet 003,Barnet,E09000003,4085 ,1992 ,2093 
E02000027,2002,Barnet 004,Barnet,E09000003,6060 ,2801 ,3259 
E02000028,2002,Barnet 005,Barnet,E09000003,3662 ,1823 ,1839 
E02000029,2002,Barnet 006,Barnet,E09000003,5381 ,2653 ,2728 
E02000030,2002,Barnet 007,Barnet,E09000003,5665 ,2719 ,2946 
E02000031,2002,Barnet 008,Barnet,E09000003,4474 ,2203 ,2271 
E02000032,2002,Barnet 009,Barnet,E09000003,4836 ,2364 ,2472 
E02000033,2002,Barnet 010,Barnet,E09000003,4920 ,2353 ,2567 
E02000034,2002,Barnet 011,Barnet,E09000003,5282 ,2564 ,2718 
E02000035,2002,Barnet 012,Barnet,E09000003,5278 ,2603 ,2675 
E02000036,2002,Barnet 013,Barnet,E09000003,6334 ,3011 ,3323 
E02000037,2002,Barnet 014,Barnet,E09000003,5776 ,2710 ,3066 
E02000038,2002,Barnet 015,Barnet,E09000003,6203 ,3081 ,3122 
E02000039,2002,Barnet 016,Barnet,E09000003,4149 ,2015 ,2134 
E02000040,2002,Barnet 017,Barnet,E09000003,3841 ,1891 ,1950 
E02000041,2002,Barnet 018,Barnet,E09000003,4999 ,2507 ,2492 
E02000042,2002,Barnet 019,Barnet,E09000003,6553 ,3314 ,3239 
E02000043,2002,Barnet 020,Barnet,E09000003,4771 ,2351 ,2420 
E02000044,2002,Barnet 021,Barnet,E09000003,5188 ,2531 ,2657 
E02000045,2002,Barnet 022,Barnet,E09000003,6317 ,3136 ,3181 
E02000046,2002,Barnet 023,Barnet,E09000003,4548 ,2334 ,2214 
E02000047,2002,Barnet 024,Barnet,E09000003,6092 ,2912 ,3180 
E02000048,2002,Barnet 025,Barnet,E09000003,5251 ,2587 ,2664 
E02000049,2002,Barnet 026,Barnet,E09000003,4876 ,2277 ,2599 
E02000050,2002,Barnet 027,Barnet,E09000003,6175 ,3032 ,3143 
E02000051,2002,Barnet 028,Barnet,E09000003,5221 ,2642 ,2579 
E02000052,2002,Barnet 029,Barnet,E09000003,6278 ,3000 ,3278 
E02000053,2002,Barnet 030,Barnet,E09000003,4779 ,2412 ,2367 
E02000054,2002,Barnet 031,Barnet,E09000003,4366 ,2214 ,2152 
E02000055,2002,Barnet 032,Barnet,E09000003,6276 ,3131 ,3145 
E02000056,2002,Barnet 033,Barnet,E09000003,5541 ,2676 ,2865 
E02000057,2002,Barnet 034,Barnet,E09000003,4012 ,1943 ,2069 
E02000058,2002,Barnet 035,Barnet,E09000003,5921 ,2909 ,3012 
E02000059,2002,Barnet 036,Barnet,E09000003,6327 ,3251 ,3076 
E02000060,2002,Barnet 037,Barnet,E09000003,5601 ,2806 ,2795 
E02000061,2002,Barnet 038,Barnet,E09000003,5072 ,2577 ,2495 
E02000062,2002,Barnet 039,Barnet,E09000003,3918 ,1912 ,2006 
E02000063,2002,Barnet 040,Barnet,E09000003,4200 ,2138 ,2062 
E02000064,2002,Barnet 041,Barnet,E09000003,3927 ,1797 ,2130 
E02000065,2002,Bexley 001,Bexley,E09000004,4426 ,2188 ,2238 
E02000066,2002,Bexley 002,Bexley,E09000004,6123 ,2886 ,3237 
E02000067,2002,Bexley 003,Bexley,E09000004,5149 ,2514 ,2635 
E02000068,2002,Bexley 004,Bexley,E09000004,3784 ,1873 ,1911 
E02000069,2002,Bexley 005,Bexley,E09000004,3738 ,1825 ,1913 
E02000070,2002,Bexley 006,Bexley,E09000004,4854 ,2360 ,2494 
E02000071,2002,Bexley 007,Bexley,E09000004,4805 ,2380 ,2425 
E02000072,2002,Bexley 008,Bexley,E09000004,6684 ,3185 ,3499 
E02000073,2002,Bexley 009,Bexley,E09000004,6592 ,3297 ,3295 
E02000074,2002,Bexley 010,Bexley,E09000004,4668 ,2258 ,2410 
E02000075,2002,Bexley 011,Bexley,E09000004,4806 ,2339 ,2467 
E02000077,2002,Bexley 013,Bexley,E09000004,4793 ,2349 ,2444 
E02000078,2002,Bexley 014,Bexley,E09000004,5056 ,2480 ,2576 
E02000079,2002,Bexley 015,Bexley,E09000004,4777 ,2356 ,2421 
E02000080,2002,Bexley 016,Bexley,E09000004,5704 ,2801 ,2903 
E02000081,2002,Bexley 017,Bexley,E09000004,4683 ,2272 ,2411 
E02000082,2002,Bexley 018,Bexley,E09000004,5649 ,2836 ,2813 
E02000083,2002,Bexley 019,Bexley,E09000004,5690 ,2752 ,2938 
E02000084,2002,Bexley 020,Bexley,E09000004,6708 ,3283 ,3425 
E02000085,2002,Bexley 021,Bexley,E09000004,4903 ,2380 ,2523 
E02000086,2002,Bexley 022,Bexley,E09000004,4864 ,2395 ,2469 
E02000087,2002,Bexley 023,Bexley,E09000004,4536 ,2290 ,2246 
E02000088,2002,Bexley 024,Bexley,E09000004,4775 ,2388 ,2387 
E02000089,2002,Bexley 025,Bexley,E09000004,4661 ,2244 ,2417 
E02000090,2002,Bexley 026,Bexley,E09000004,5045 ,2458 ,2587 
E02000091,2002,Bexley 027,Bexley,E09000004,5596 ,2673 ,2923 
E02000092,2002,Bexley 028,Bexley,E09000004,3545 ,1671 ,1874 
E02006785,2002,Bexley 029,Bexley,E09000004,3880 ,1889 ,1991 
E02000093,2002,Brent 001,Brent,E09000005,6122 ,3062 ,3060 
E02000094,2002,Brent 002,Brent,E09000005,4764 ,2431 ,2333 
E02000095,2002,Brent 003,Brent,E09000005,5873 ,2889 ,2984 
E02000096,2002,Brent 004,Brent,E09000005,4495 ,2261 ,2234 
E02000097,2002,Brent 005,Brent,E09000005,5213 ,2696 ,2517 
E02000098,2002,Brent 006,Brent,E09000005,4582 ,2316 ,2266 
E02000099,2002,Brent 007,Brent,E09000005,4110 ,2128 ,1982 
E02000100,2002,Brent 008,Brent,E09000005,5209 ,2544 ,2665 
E02000101,2002,Brent 009,Brent,E09000005,4874 ,2377 ,2497 
E02000102,2002,Brent 010,Brent,E09000005,4672 ,2369 ,2303 
E02000103,2002,Brent 011,Brent,E09000005,5123 ,2555 ,2568 
E02000104,2002,Brent 012,Brent,E09000005,4040 ,2066 ,1974 
E02000105,2002,Brent 013,Brent,E09000005,4788 ,2468 ,2320 
E02000106,2002,Brent 014,Brent,E09000005,6287 ,3191 ,3096 
E02000107,2002,Brent 015,Brent,E09000005,7738 ,4014 ,3724 
E02000108,2002,Brent 016,Brent,E09000005,3933 ,2013 ,1920 
E02000109,2002,Brent 017,Brent,E09000005,5256 ,2779 ,2477 
E02000110,2002,Brent 018,Brent,E09000005,5506 ,2745 ,2761 
E02000111,2002,Brent 019,Brent,E09000005,5419 ,2760 ,2659 
E02000112,2002,Brent 020,Brent,E09000005,5617 ,2952 ,2665 
E02000113,2002,Brent 021,Brent,E09000005,5585 ,2601 ,2984 
E02000114,2002,Brent 022,Brent,E09000005,6262 ,3180 ,3082 
E02000115,2002,Brent 023,Brent,E09000005,5897 ,3002 ,2895 
E02000116,2002,Brent 024,Brent,E09000005,4874 ,2545 ,2329 
E02000117,2002,Brent 025,Brent,E09000005,7299 ,3486 ,3813 
E02000118,2002,Brent 026,Brent,E09000005,5784 ,3049 ,2735 
E02000119,2002,Brent 027,Brent,E09000005,4677 ,2337 ,2340 
E02000120,2002,Brent 028,Brent,E09000005,6556 ,3255 ,3301 
E02000121,2002,Brent 029,Brent,E09000005,5772 ,3045 ,2727 
E02000122,2002,Brent 030,Brent,E09000005,5763 ,2943 ,2820 
E02000123,2002,Brent 031,Brent,E09000005,8570 ,4326 ,4244 
E02000124,2002,Brent 032,Brent,E09000005,6836 ,3431 ,3405 
E02000125,2002,Brent 033,Brent,E09000005,6845 ,3398 ,3447 
E02000126,2002,Brent 034,Brent,E09000005,4629 ,2293 ,2336 
E02000127,2002,Bromley 001,Bromley,E09000006,5137 ,2418 ,2719 
E02000128,2002,Bromley 002,Bromley,E09000006,4745 ,2297 ,2448 
E02000130,2002,Bromley 004,Bromley,E09000006,5318 ,2579 ,2739 
E02000131,2002,Bromley 005,Bromley,E09000006,6166 ,3030 ,3136 
E02000132,2002,Bromley 006,Bromley,E09000006,5532 ,2737 ,2795 
E02000133,2002,Bromley 007,Bromley,E09000006,5544 ,2732 ,2812 
E02000134,2002,Bromley 008,Bromley,E09000006,6903 ,3415 ,3488 
E02000135,2002,Bromley 009,Bromley,E09000006,6153 ,2872 ,3281 
E02000136,2002,Bromley 010,Bromley,E09000006,3314 ,1631 ,1683 
E02000137,2002,Bromley 011,Bromley,E09000006,5009 ,2430 ,2579 
E02000138,2002,Bromley 012,Bromley,E09000006,4964 ,2509 ,2455 
E02000139,2002,Bromley 013,Bromley,E09000006,4897 ,2375 ,2522 
E02000140,2002,Bromley 014,Bromley,E09000006,4503 ,2175 ,2328 
E02000141,2002,Bromley 015,Bromley,E09000006,5051 ,2494 ,2557 
E02000142,2002,Bromley 016,Bromley,E09000006,5003 ,2508 ,2495 
E02000144,2002,Bromley 018,Bromley,E09000006,5251 ,2639 ,2612 
E02000145,2002,Bromley 019,Bromley,E09000006,4740 ,2222 ,2518 
E02000146,2002,Bromley 020,Bromley,E09000006,4922 ,2424 ,2498 
E02000147,2002,Bromley 021,Bromley,E09000006,4758 ,2363 ,2395 
E02000148,2002,Bromley 022,Bromley,E09000006,3676 ,1819 ,1857 
E02000149,2002,Bromley 023,Bromley,E09000006,4726 ,2298 ,2428 
E02000150,2002,Bromley 024,Bromley,E09000006,4605 ,2271 ,2334 
E02000151,2002,Bromley 025,Bromley,E09000006,4730 ,2316 ,2414 
E02000152,2002,Bromley 026,Bromley,E09000006,3840 ,1811 ,2029 
E02000153,2002,Bromley 027,Bromley,E09000006,4626 ,2230 ,2396 
E02000154,2002,Bromley 028,Bromley,E09000006,4792 ,2417 ,2375 
E02000155,2002,Bromley 029,Bromley,E09000006,4320 ,2098 ,2222 
E02000156,2002,Bromley 030,Bromley,E09000006,7136 ,3538 ,3598 
E02000157,2002,Bromley 031,Bromley,E09000006,4748 ,2312 ,2436 
E02000158,2002,Bromley 032,Bromley,E09000006,4571 ,2186 ,2385 
E02000159,2002,Bromley 033,Bromley,E09000006,3969 ,1939 ,2030 
E02000160,2002,Bromley 034,Bromley,E09000006,4667 ,2341 ,2326 
E02000161,2002,Bromley 035,Bromley,E09000006,5187 ,2511 ,2676 
E02000162,2002,Bromley 036,Bromley,E09000006,3962 ,1914 ,2048 
E02000163,2002,Bromley 037,Bromley,E09000006,4744 ,2349 ,2395 
E02000165,2002,Bromley 039,Bromley,E09000006,4961 ,2467 ,2494 
E02006782,2002,Bromley 040,Bromley,E09000006,4650 ,2223 ,2427 
E02006787,2002,Bromley 041,Bromley,E09000006,4805 ,2359 ,2446 
E02006789,2002,Bromley 042,Bromley,E09000006,3942 ,1987 ,1955 
E02000166,2002,Camden 001,Camden,E09000007,5692 ,2526 ,3166 
E02000167,2002,Camden 002,Camden,E09000007,5280 ,2618 ,2662 
E02000168,2002,Camden 003,Camden,E09000007,5579 ,2735 ,2844 
E02000169,2002,Camden 004,Camden,E09000007,4645 ,2241 ,2404 
E02000170,2002,Camden 005,Camden,E09000007,5825 ,2861 ,2964 
E02000171,2002,Camden 006,Camden,E09000007,5419 ,2627 ,2792 
E02000172,2002,Camden 007,Camden,E09000007,6258 ,3133 ,3125 
E02000173,2002,Camden 008,Camden,E09000007,5311 ,2566 ,2745 
E02000174,2002,Camden 009,Camden,E09000007,5992 ,2961 ,3031 
E02000175,2002,Camden 010,Camden,E09000007,6822 ,3352 ,3470 
E02000176,2002,Camden 011,Camden,E09000007,4640 ,2313 ,2327 
E02000177,2002,Camden 012,Camden,E09000007,5736 ,2785 ,2951 
E02000178,2002,Camden 013,Camden,E09000007,6330 ,3134 ,3196 
E02000179,2002,Camden 014,Camden,E09000007,4291 ,2149 ,2142 
E02000180,2002,Camden 015,Camden,E09000007,5648 ,2907 ,2741 
E02000181,2002,Camden 016,Camden,E09000007,5970 ,3001 ,2969 
E02000182,2002,Camden 017,Camden,E09000007,3882 ,1859 ,2023 
E02000183,2002,Camden 018,Camden,E09000007,5417 ,2644 ,2773 
E02000184,2002,Camden 019,Camden,E09000007,5420 ,2783 ,2637 
E02000185,2002,Camden 020,Camden,E09000007,5540 ,2803 ,2737 
E02000186,2002,Camden 021,Camden,E09000007,4770 ,2656 ,2114 
E02000187,2002,Camden 022,Camden,E09000007,5160 ,2486 ,2674 
E02000188,2002,Camden 023,Camden,E09000007,4628 ,2291 ,2337 
E02000189,2002,Camden 024,Camden,E09000007,4569 ,2335 ,2234 
E02000190,2002,Camden 025,Camden,E09000007,5880 ,3013 ,2867 
E02000191,2002,Camden 026,Camden,E09000007,5914 ,2871 ,3043 
E02000192,2002,Camden 027,Camden,E09000007,4580 ,2472 ,2108 
E02000193,2002,Camden 028,Camden,E09000007,5576 ,2829 ,2747 
E02000194,2002,Croydon 001,Croydon,E09000008,5332 ,2649 ,2683 
E02000195,2002,Croydon 002,Croydon,E09000008,5398 ,2625 ,2773 
E02000196,2002,Croydon 003,Croydon,E09000008,4151 ,2039 ,2112 
E02000197,2002,Croydon 004,Croydon,E09000008,5271 ,2584 ,2687 
E02000198,2002,Croydon 005,Croydon,E09000008,5120 ,2398 ,2722 
E02000199,2002,Croydon 006,Croydon,E09000008,5224 ,2465 ,2759 
E02000200,2002,Croydon 007,Croydon,E09000008,5375 ,2649 ,2726 
E02000201,2002,Croydon 008,Croydon,E09000008,5252 ,2583 ,2669 
E02000202,2002,Croydon 009,Croydon,E09000008,5928 ,2893 ,3035 
E02000203,2002,Croydon 010,Croydon,E09000008,5071 ,2500 ,2571 
E02000204,2002,Croydon 011,Croydon,E09000008,6293 ,3122 ,3171 
E02000206,2002,Croydon 013,Croydon,E09000008,5905 ,2834 ,3071 
E02000207,2002,Croydon 014,Croydon,E09000008,5344 ,2548 ,2796 
E02000208,2002,Croydon 015,Croydon,E09000008,5082 ,2555 ,2527 
E02000209,2002,Croydon 016,Croydon,E09000008,5256 ,2620 ,2636 
E02000210,2002,Croydon 017,Croydon,E09000008,5617 ,2819 ,2798 
E02000211,2002,Croydon 018,Croydon,E09000008,5154 ,2529 ,2625 
E02000212,2002,Croydon 019,Croydon,E09000008,4929 ,2506 ,2423 
E02000213,2002,Croydon 020,Croydon,E09000008,5611 ,2838 ,2773 
E02000214,2002,Croydon 021,Croydon,E09000008,3984 ,2039 ,1945 
E02000215,2002,Croydon 022,Croydon,E09000008,7149 ,3648 ,3501 
E02000216,2002,Croydon 023,Croydon,E09000008,4280 ,2259 ,2021 
E02000217,2002,Croydon 024,Croydon,E09000008,5167 ,2597 ,2570 
E02000218,2002,Croydon 025,Croydon,E09000008,3999 ,1890 ,2109 
E02000219,2002,Croydon 026,Croydon,E09000008,4634 ,2236 ,2398 
E02000220,2002,Croydon 027,Croydon,E09000008,5714 ,3095 ,2619 
E02000221,2002,Croydon 028,Croydon,E09000008,5043 ,2374 ,2669 
E02000222,2002,Croydon 029,Croydon,E09000008,5233 ,2605 ,2628 
E02000223,2002,Croydon 030,Croydon,E09000008,4605 ,2018 ,2587 
E02000224,2002,Croydon 031,Croydon,E09000008,5190 ,2612 ,2578 
E02000225,2002,Croydon 032,Croydon,E09000008,4508 ,2074 ,2434 
E02000226,2002,Croydon 033,Croydon,E09000008,4830 ,2380 ,2450 
E02000227,2002,Croydon 034,Croydon,E09000008,7801 ,3750 ,4051 
E02000228,2002,Croydon 035,Croydon,E09000008,4618 ,2255 ,2363 
E02000229,2002,Croydon 036,Croydon,E09000008,3462 ,1613 ,1849 
E02000230,2002,Croydon 037,Croydon,E09000008,5720 ,2878 ,2842 
E02000231,2002,Croydon 038,Croydon,E09000008,4787 ,2399 ,2388 
E02000232,2002,Croydon 039,Croydon,E09000008,3715 ,1724 ,1991 
E02000233,2002,Croydon 040,Croydon,E09000008,3675 ,1859 ,1816 
E02000234,2002,Croydon 041,Croydon,E09000008,4917 ,2363 ,2554 
E02000235,2002,Croydon 042,Croydon,E09000008,4242 ,2067 ,2175 
E02000236,2002,Croydon 043,Croydon,E09000008,4910 ,2379 ,2531 
E02000237,2002,Croydon 044,Croydon,E09000008,4463 ,2182 ,2281 
E02006788,2002,Croydon 045,Croydon,E09000008,4859 ,2258 ,2601 
E02000238,2002,Ealing 001,Ealing,E09000009,5762 ,2945 ,2817 
E02000239,2002,Ealing 002,Ealing,E09000009,5761 ,2976 ,2785 
E02000240,2002,Ealing 003,Ealing,E09000009,5613 ,2664 ,2949 
E02000241,2002,Ealing 004,Ealing,E09000009,4161 ,2089 ,2072 
E02000242,2002,Ealing 005,Ealing,E09000009,4273 ,2253 ,2020 
E02000243,2002,Ealing 006,Ealing,E09000009,5556 ,2784 ,2772 
E02000244,2002,Ealing 007,Ealing,E09000009,4331 ,2257 ,2074 
E02000245,2002,Ealing 008,Ealing,E09000009,4960 ,2460 ,2500 
E02000246,2002,Ealing 009,Ealing,E09000009,4979 ,2427 ,2552 
E02000247,2002,Ealing 010,Ealing,E09000009,5026 ,2454 ,2572 
E02000248,2002,Ealing 011,Ealing,E09000009,4764 ,2565 ,2199 
E02000249,2002,Ealing 012,Ealing,E09000009,4378 ,2216 ,2162 
E02000250,2002,Ealing 013,Ealing,E09000009,4483 ,2270 ,2213 
E02000251,2002,Ealing 014,Ealing,E09000009,5210 ,2644 ,2566 
E02000252,2002,Ealing 015,Ealing,E09000009,5625 ,2881 ,2744 
E02000253,2002,Ealing 016,Ealing,E09000009,5857 ,2853 ,3004 
E02000254,2002,Ealing 017,Ealing,E09000009,5946 ,3099 ,2847 
E02000255,2002,Ealing 018,Ealing,E09000009,6504 ,3189 ,3315 
E02000256,2002,Ealing 019,Ealing,E09000009,5993 ,3090 ,2903 
E02000257,2002,Ealing 020,Ealing,E09000009,9525 ,5036 ,4489 
E02000258,2002,Ealing 021,Ealing,E09000009,4287 ,2205 ,2082 
E02000259,2002,Ealing 022,Ealing,E09000009,4184 ,2041 ,2143 
E02000260,2002,Ealing 023,Ealing,E09000009,5914 ,3146 ,2768 
E02000261,2002,Ealing 024,Ealing,E09000009,6400 ,3185 ,3215 
E02000262,2002,Ealing 025,Ealing,E09000009,5467 ,2740 ,2727 
E02000263,2002,Ealing 026,Ealing,E09000009,8086 ,4520 ,3566 
E02000264,2002,Ealing 027,Ealing,E09000009,5248 ,2673 ,2575 
E02000265,2002,Ealing 028,Ealing,E09000009,7201 ,3570 ,3631 
E02000266,2002,Ealing 029,Ealing,E09000009,7688 ,3861 ,3827 
E02000267,2002,Ealing 030,Ealing,E09000009,4572 ,2232 ,2340 
E02000268,2002,Ealing 031,Ealing,E09000009,6749 ,3470 ,3279 
E02000269,2002,Ealing 032,Ealing,E09000009,5829 ,2975 ,2854 
E02000270,2002,Ealing 033,Ealing,E09000009,5250 ,2531 ,2719 
E02000271,2002,Ealing 034,Ealing,E09000009,4745 ,2351 ,2394 
E02000272,2002,Ealing 035,Ealing,E09000009,4566 ,2310 ,2256 
E02000274,2002,Ealing 037,Ealing,E09000009,8089 ,4396 ,3693 
E02000275,2002,Ealing 038,Ealing,E09000009,4343 ,2255 ,2088 
E02000276,2002,Ealing 039,Ealing,E09000009,4634 ,2396 ,2238 
E02006791,2002,Ealing 040,Ealing,E09000009,5150 ,2664 ,2486 
E02000277,2002,Enfield 001,Enfield,E09000010,4420 ,2218 ,2202 
E02000278,2002,Enfield 002,Enfield,E09000010,4859 ,2368 ,2491 
E02000279,2002,Enfield 003,Enfield,E09000010,6216 ,3066 ,3150 
E02000280,2002,Enfield 004,Enfield,E09000010,5160 ,2482 ,2678 
E02000281,2002,Enfield 005,Enfield,E09000010,5179 ,2466 ,2713 
E02000282,2002,Enfield 006,Enfield,E09000010,5291 ,2633 ,2658 
E02000283,2002,Enfield 007,Enfield,E09000010,5154 ,2584 ,2570 
E02000284,2002,Enfield 008,Enfield,E09000010,5085 ,2485 ,2600 
E02000285,2002,Enfield 009,Enfield,E09000010,4280 ,2092 ,2188 
E02000286,2002,Enfield 010,Enfield,E09000010,5125 ,2597 ,2528 
E02000287,2002,Enfield 011,Enfield,E09000010,3900 ,1966 ,1934 
E02000288,2002,Enfield 012,Enfield,E09000010,5757 ,2855 ,2902 
E02000289,2002,Enfield 013,Enfield,E09000010,4098 ,1977 ,2121 
E02000290,2002,Enfield 014,Enfield,E09000010,4294 ,2072 ,2222 
E02000291,2002,Enfield 015,Enfield,E09000010,5201 ,2646 ,2555 
E02000292,2002,Enfield 016,Enfield,E09000010,5947 ,3028 ,2919 
E02000293,2002,Enfield 017,Enfield,E09000010,3799 ,1887 ,1912 
E02000294,2002,Enfield 018,Enfield,E09000010,5232 ,2564 ,2668 
E02000295,2002,Enfield 019,Enfield,E09000010,5295 ,2633 ,2662 
E02000296,2002,Enfield 020,Enfield,E09000010,5253 ,2583 ,2670 
E02000297,2002,Enfield 021,Enfield,E09000010,6097 ,3055 ,3042 
E02000298,2002,Enfield 022,Enfield,E09000010,5195 ,2591 ,2604 
E02000299,2002,Enfield 023,Enfield,E09000010,5382 ,2655 ,2727 
E02000300,2002,Enfield 024,Enfield,E09000010,5193 ,2527 ,2666 
E02000301,2002,Enfield 025,Enfield,E09000010,5344 ,2611 ,2733 
E02000302,2002,Enfield 026,Enfield,E09000010,5268 ,2639 ,2629 
E02000303,2002,Enfield 027,Enfield,E09000010,5105 ,2485 ,2620 
E02000304,2002,Enfield 028,Enfield,E09000010,4871 ,2415 ,2456 
E02000305,2002,Enfield 029,Enfield,E09000010,5531 ,2794 ,2737 
E02000306,2002,Enfield 030,Enfield,E09000010,4569 ,2177 ,2392 
E02000307,2002,Enfield 031,Enfield,E09000010,5919 ,2926 ,2993 
E02000308,2002,Enfield 032,Enfield,E09000010,4901 ,2495 ,2406 
E02000309,2002,Enfield 033,Enfield,E09000010,5797 ,2795 ,3002 
E02000311,2002,Enfield 035,Enfield,E09000010,6097 ,2944 ,3153 
E02000312,2002,Enfield 036,Enfield,E09000010,6611 ,3372 ,3239 
E02006793,2002,Enfield 037,Enfield,E09000010,5245 ,2494 ,2751 
E02000313,2002,Greenwich 001,Greenwich,E09000011,4125 ,2021 ,2104 
E02000314,2002,Greenwich 002,Greenwich,E09000011,5212 ,2914 ,2298 
E02000315,2002,Greenwich 003,Greenwich,E09000011,4510 ,2139 ,2371 
E02000316,2002,Greenwich 004,Greenwich,E09000011,4004 ,2095 ,1909 
E02000317,2002,Greenwich 005,Greenwich,E09000011,5246 ,2558 ,2688 
E02000318,2002,Greenwich 006,Greenwich,E09000011,5643 ,2821 ,2822 
E02000319,2002,Greenwich 007,Greenwich,E09000011,5406 ,2687 ,2719 
E02000320,2002,Greenwich 008,Greenwich,E09000011,4033 ,1963 ,2070 
E02000321,2002,Greenwich 009,Greenwich,E09000011,4264 ,2094 ,2170 
E02000323,2002,Greenwich 011,Greenwich,E09000011,6393 ,3168 ,3225 
E02000324,2002,Greenwich 012,Greenwich,E09000011,4217 ,2112 ,2105 
E02000326,2002,Greenwich 014,Greenwich,E09000011,4656 ,2207 ,2449 
E02000327,2002,Greenwich 015,Greenwich,E09000011,3957 ,2055 ,1902 
E02000328,2002,Greenwich 016,Greenwich,E09000011,4240 ,2058 ,2182 
E02000329,2002,Greenwich 017,Greenwich,E09000011,3975 ,1933 ,2042 
E02000331,2002,Greenwich 019,Greenwich,E09000011,4301 ,2099 ,2202 
E02000332,2002,Greenwich 020,Greenwich,E09000011,4771 ,2336 ,2435 
E02000333,2002,Greenwich 021,Greenwich,E09000011,4353 ,2298 ,2055 
E02000334,2002,Greenwich 022,Greenwich,E09000011,3923 ,1963 ,1960 
E02000335,2002,Greenwich 023,Greenwich,E09000011,4137 ,2020 ,2117 
E02000337,2002,Greenwich 025,Greenwich,E09000011,4956 ,2379 ,2577 
E02000339,2002,Greenwich 027,Greenwich,E09000011,3802 ,1925 ,1877 
E02000340,2002,Greenwich 028,Greenwich,E09000011,3742 ,1812 ,1930 
E02000341,2002,Greenwich 029,Greenwich,E09000011,4759 ,2281 ,2478 
E02000342,2002,Greenwich 030,Greenwich,E09000011,3949 ,1764 ,2185 
E02000343,2002,Greenwich 031,Greenwich,E09000011,3912 ,1917 ,1995 
E02000344,2002,Greenwich 032,Greenwich,E09000011,3969 ,1948 ,2021 
E02006786,2002,Greenwich 033,Greenwich,E09000011,4107 ,1980 ,2127 
E02006927,2002,Greenwich 034,Greenwich,E09000011,7446 ,3552 ,3894 
E02006928,2002,Greenwich 035,Greenwich,E09000011,2790 ,1436 ,1354 
E02006929,2002,Greenwich 036,Greenwich,E09000011,3330 ,1660 ,1670 
E02006930,2002,Greenwich 037,Greenwich,E09000011,4361 ,2180 ,2181 
E02006931,2002,Greenwich 038,Greenwich,E09000011,5746 ,2932 ,2814 
E02000345,2002,Hackney 001,Hackney,E09000012,4634 ,2352 ,2282 
E02000346,2002,Hackney 002,Hackney,E09000012,4938 ,2423 ,2515 
E02000347,2002,Hackney 003,Hackney,E09000012,4587 ,2310 ,2277 
E02000348,2002,Hackney 004,Hackney,E09000012,4575 ,2273 ,2302 
E02000350,2002,Hackney 006,Hackney,E09000012,6342 ,3182 ,3160 
E02000351,2002,Hackney 007,Hackney,E09000012,6113 ,3037 ,3076 
E02000352,2002,Hackney 008,Hackney,E09000012,4045 ,1910 ,2135 
E02000353,2002,Hackney 009,Hackney,E09000012,5284 ,2584 ,2700 
E02000354,2002,Hackney 010,Hackney,E09000012,5612 ,2684 ,2928 
E02000355,2002,Hackney 011,Hackney,E09000012,5547 ,2661 ,2886 
E02000356,2002,Hackney 012,Hackney,E09000012,5009 ,2484 ,2525 
E02000357,2002,Hackney 013,Hackney,E09000012,3958 ,1908 ,2050 
E02000358,2002,Hackney 014,Hackney,E09000012,7326 ,3576 ,3750 
E02000359,2002,Hackney 015,Hackney,E09000012,4273 ,2039 ,2234 
E02000360,2002,Hackney 016,Hackney,E09000012,6219 ,3075 ,3144 
E02000361,2002,Hackney 017,Hackney,E09000012,4546 ,2232 ,2314 
E02000362,2002,Hackney 018,Hackney,E09000012,3125 ,1460 ,1665 
E02000363,2002,Hackney 019,Hackney,E09000012,6540 ,3096 ,3444 
E02000364,2002,Hackney 020,Hackney,E09000012,5355 ,2647 ,2708 
E02000365,2002,Hackney 021,Hackney,E09000012,6904 ,3475 ,3429 
E02000366,2002,Hackney 022,Hackney,E09000012,5029 ,2409 ,2620 
E02000367,2002,Hackney 023,Hackney,E09000012,4960 ,2388 ,2572 
E02000368,2002,Hackney 024,Hackney,E09000012,6005 ,2955 ,3050 
E02000369,2002,Hackney 025,Hackney,E09000012,5951 ,2956 ,2995 
E02000370,2002,Hackney 026,Hackney,E09000012,4170 ,2074 ,2096 
E02000371,2002,Hackney 027,Hackney,E09000012,5968 ,3187 ,2781 
E02006918,2002,Hackney 028,Hackney,E09000012,3526 ,1757 ,1769 
E02006921,2002,Hackney 029,Hackney,E09000012,4298 ,2078 ,2220 
E02000372,2002,Hammersmith and Fulham 001,Hammersmith and Fulham,E09000013,5900 ,2913 ,2987 
E02000373,2002,Hammersmith and Fulham 002,Hammersmith and Fulham,E09000013,4269 ,2037 ,2232 
E02000374,2002,Hammersmith and Fulham 003,Hammersmith and Fulham,E09000013,4624 ,2284 ,2340 
E02000375,2002,Hammersmith and Fulham 004,Hammersmith and Fulham,E09000013,5204 ,2816 ,2388 
E02000376,2002,Hammersmith and Fulham 005,Hammersmith and Fulham,E09000013,4987 ,2543 ,2444 
E02000377,2002,Hammersmith and Fulham 006,Hammersmith and Fulham,E09000013,6006 ,3058 ,2948 
E02000378,2002,Hammersmith and Fulham 007,Hammersmith and Fulham,E09000013,5190 ,2593 ,2597 
E02000379,2002,Hammersmith and Fulham 008,Hammersmith and Fulham,E09000013,4410 ,2269 ,2141 
E02000380,2002,Hammersmith and Fulham 009,Hammersmith and Fulham,E09000013,4525 ,2285 ,2240 
E02000381,2002,Hammersmith and Fulham 010,Hammersmith and Fulham,E09000013,5994 ,2971 ,3023 
E02000382,2002,Hammersmith and Fulham 011,Hammersmith and Fulham,E09000013,4352 ,2157 ,2195 
E02000383,2002,Hammersmith and Fulham 012,Hammersmith and Fulham,E09000013,7022 ,3573 ,3449 
E02000384,2002,Hammersmith and Fulham 013,Hammersmith and Fulham,E09000013,5181 ,2580 ,2601 
E02000385,2002,Hammersmith and Fulham 014,Hammersmith and Fulham,E09000013,5282 ,2775 ,2507 
E02000386,2002,Hammersmith and Fulham 015,Hammersmith and Fulham,E09000013,6006 ,3088 ,2918 
E02000387,2002,Hammersmith and Fulham 016,Hammersmith and Fulham,E09000013,4373 ,2138 ,2235 
E02000388,2002,Hammersmith and Fulham 017,Hammersmith and Fulham,E09000013,5783 ,2922 ,2861 
E02000389,2002,Hammersmith and Fulham 018,Hammersmith and Fulham,E09000013,5491 ,2675 ,2816 
E02000390,2002,Hammersmith and Fulham 019,Hammersmith and Fulham,E09000013,4611 ,2296 ,2315 
E02000391,2002,Hammersmith and Fulham 020,Hammersmith and Fulham,E09000013,5242 ,2495 ,2747 
E02000392,2002,Hammersmith and Fulham 021,Hammersmith and Fulham,E09000013,6833 ,3367 ,3466 
E02000393,2002,Hammersmith and Fulham 022,Hammersmith and Fulham,E09000013,4393 ,2173 ,2220 
E02000394,2002,Hammersmith and Fulham 023,Hammersmith and Fulham,E09000013,3731 ,1808 ,1923 
E02000395,2002,Hammersmith and Fulham 024,Hammersmith and Fulham,E09000013,4152 ,2007 ,2145 
E02000396,2002,Hammersmith and Fulham 025,Hammersmith and Fulham,E09000013,4514 ,2164 ,2350 
E02000397,2002,Haringey 001,Haringey,E09000014,4698 ,2285 ,2413 
E02000398,2002,Haringey 002,Haringey,E09000014,4369 ,2157 ,2212 
E02000400,2002,Haringey 004,Haringey,E09000014,4100 ,1960 ,2140 
E02000401,2002,Haringey 005,Haringey,E09000014,3907 ,1878 ,2029 
E02000402,2002,Haringey 006,Haringey,E09000014,4083 ,1909 ,2174 
E02000403,2002,Haringey 007,Haringey,E09000014,4427 ,2188 ,2239 
E02000404,2002,Haringey 008,Haringey,E09000014,4099 ,2009 ,2090 
E02000405,2002,Haringey 009,Haringey,E09000014,4164 ,1999 ,2165 
E02000406,2002,Haringey 010,Haringey,E09000014,4362 ,2052 ,2310 
E02000407,2002,Haringey 011,Haringey,E09000014,4064 ,2025 ,2039 
E02000408,2002,Haringey 012,Haringey,E09000014,3975 ,1979 ,1996 
E02000409,2002,Haringey 013,Haringey,E09000014,4235 ,2111 ,2124 
E02000410,2002,Haringey 014,Haringey,E09000014,4656 ,2369 ,2287 
E02000411,2002,Haringey 015,Haringey,E09000014,4555 ,2257 ,2298 
E02000412,2002,Haringey 016,Haringey,E09000014,4364 ,2223 ,2141 
E02000413,2002,Haringey 017,Haringey,E09000014,4241 ,2068 ,2173 
E02000414,2002,Haringey 018,Haringey,E09000014,4684 ,2333 ,2351 
E02000415,2002,Haringey 019,Haringey,E09000014,4503 ,2360 ,2143 
E02000416,2002,Haringey 020,Haringey,E09000014,4170 ,2048 ,2122 
E02000417,2002,Haringey 021,Haringey,E09000014,4379 ,2263 ,2116 
E02000418,2002,Haringey 022,Haringey,E09000014,3523 ,1699 ,1824 
E02000419,2002,Haringey 023,Haringey,E09000014,5654 ,2970 ,2684 
E02000420,2002,Haringey 024,Haringey,E09000014,4477 ,2205 ,2272 
E02000421,2002,Haringey 025,Haringey,E09000014,4316 ,2126 ,2190 
E02000422,2002,Haringey 026,Haringey,E09000014,4497 ,2240 ,2257 
E02000423,2002,Haringey 027,Haringey,E09000014,4923 ,2686 ,2237 
E02000424,2002,Haringey 028,Haringey,E09000014,4870 ,2422 ,2448 
E02000425,2002,Haringey 029,Haringey,E09000014,4050 ,2101 ,1949 
E02000426,2002,Haringey 030,Haringey,E09000014,4273 ,2138 ,2135 
E02000427,2002,Haringey 031,Haringey,E09000014,5293 ,2821 ,2472 
E02000428,2002,Haringey 032,Haringey,E09000014,4196 ,2140 ,2056 
E02000429,2002,Haringey 033,Haringey,E09000014,4647 ,2316 ,2331 
E02000430,2002,Haringey 034,Haringey,E09000014,4937 ,2478 ,2459 
E02000431,2002,Haringey 035,Haringey,E09000014,4706 ,2375 ,2331 
E02000432,2002,Haringey 036,Haringey,E09000014,4748 ,2441 ,2307 
E02006794,2002,Haringey 037,Haringey,E09000014,4243 ,2086 ,2157 
E02000433,2002,Harrow 001,Harrow,E09000015,3547 ,1680 ,1867 
E02000434,2002,Harrow 002,Harrow,E09000015,4641 ,2266 ,2375 
E02000435,2002,Harrow 003,Harrow,E09000015,4143 ,2037 ,2106 
E02000436,2002,Harrow 004,Harrow,E09000015,3745 ,1791 ,1954 
E02000437,2002,Harrow 005,Harrow,E09000015,4900 ,2391 ,2509 
E02000438,2002,Harrow 006,Harrow,E09000015,4417 ,2120 ,2297 
E02000439,2002,Harrow 007,Harrow,E09000015,4822 ,2510 ,2312 
E02000440,2002,Harrow 008,Harrow,E09000015,5505 ,2705 ,2800 
E02000441,2002,Harrow 009,Harrow,E09000015,4225 ,1986 ,2239 
E02000442,2002,Harrow 010,Harrow,E09000015,5174 ,2610 ,2564 
E02000443,2002,Harrow 011,Harrow,E09000015,5239 ,2650 ,2589 
E02000444,2002,Harrow 012,Harrow,E09000015,4816 ,2369 ,2447 
E02000445,2002,Harrow 013,Harrow,E09000015,5514 ,2731 ,2783 
E02000447,2002,Harrow 015,Harrow,E09000015,4457 ,2176 ,2281 
E02000448,2002,Harrow 016,Harrow,E09000015,3886 ,1891 ,1995 
E02000449,2002,Harrow 017,Harrow,E09000015,4950 ,2473 ,2477 
E02000451,2002,Harrow 019,Harrow,E09000015,4177 ,2110 ,2067 
E02000452,2002,Harrow 020,Harrow,E09000015,4793 ,2460 ,2333 
E02000453,2002,Harrow 021,Harrow,E09000015,4567 ,2334 ,2233 
E02000454,2002,Harrow 022,Harrow,E09000015,4362 ,2181 ,2181 
E02000455,2002,Harrow 023,Harrow,E09000015,4636 ,2274 ,2362 
E02000456,2002,Harrow 024,Harrow,E09000015,4427 ,2162 ,2265 
E02000457,2002,Harrow 025,Harrow,E09000015,4109 ,2089 ,2020 
E02000459,2002,Harrow 027,Harrow,E09000015,4330 ,2238 ,2092 
E02000460,2002,Harrow 028,Harrow,E09000015,4179 ,2048 ,2131 
E02000461,2002,Harrow 029,Harrow,E09000015,4538 ,2449 ,2089 
E02000462,2002,Harrow 030,Harrow,E09000015,4121 ,2118 ,2003 
E02000463,2002,Harrow 031,Harrow,E09000015,5286 ,2594 ,2692 
E02006795,2002,Harrow 032,Harrow,E09000015,5092 ,2585 ,2507 
E02006882,2002,Harrow 033,Harrow,E09000015,9024 ,4535 ,4489 
E02000464,2002,Havering 001,Havering,E09000016,3462 ,1714 ,1748 
E02000465,2002,Havering 002,Havering,E09000016,4586 ,2221 ,2365 
E02000466,2002,Havering 003,Havering,E09000016,4929 ,2349 ,2580 
E02000467,2002,Havering 004,Havering,E09000016,5474 ,2606 ,2868 
E02000468,2002,Havering 005,Havering,E09000016,4938 ,2395 ,2543 
E02000469,2002,Havering 006,Havering,E09000016,3846 ,1859 ,1987 
E02000470,2002,Havering 007,Havering,E09000016,4977 ,2454 ,2523 
E02000471,2002,Havering 008,Havering,E09000016,4617 ,2216 ,2401 
E02000472,2002,Havering 009,Havering,E09000016,5720 ,2790 ,2930 
E02000473,2002,Havering 010,Havering,E09000016,5862 ,2863 ,2999 
E02000474,2002,Havering 011,Havering,E09000016,4806 ,2344 ,2462 
E02000475,2002,Havering 012,Havering,E09000016,5306 ,2628 ,2678 
E02000476,2002,Havering 013,Havering,E09000016,3995 ,2032 ,1963 
E02000477,2002,Havering 014,Havering,E09000016,5971 ,2955 ,3016 
E02000478,2002,Havering 015,Havering,E09000016,3528 ,1746 ,1782 
E02000479,2002,Havering 016,Havering,E09000016,5146 ,2552 ,2594 
E02000480,2002,Havering 017,Havering,E09000016,5755 ,2886 ,2869 
E02000481,2002,Havering 018,Havering,E09000016,4404 ,2148 ,2256 
E02000482,2002,Havering 019,Havering,E09000016,3792 ,1865 ,1927 
E02000483,2002,Havering 020,Havering,E09000016,4498 ,2177 ,2321 
E02000484,2002,Havering 021,Havering,E09000016,5200 ,2599 ,2601 
E02000485,2002,Havering 022,Havering,E09000016,4800 ,2368 ,2432 
E02000486,2002,Havering 023,Havering,E09000016,4810 ,2418 ,2392 
E02000487,2002,Havering 024,Havering,E09000016,5065 ,2509 ,2556 
E02000488,2002,Havering 025,Havering,E09000016,4913 ,2439 ,2474 
E02000489,2002,Havering 026,Havering,E09000016,4680 ,2246 ,2434 
E02000490,2002,Havering 027,Havering,E09000016,4642 ,2251 ,2391 
E02000491,2002,Havering 028,Havering,E09000016,5222 ,2568 ,2654 
E02000492,2002,Havering 029,Havering,E09000016,4054 ,1997 ,2057 
E02000493,2002,Havering 030,Havering,E09000016,3903 ,1873 ,2030 
E02000494,2002,Hillingdon 001,Hillingdon,E09000017,5044 ,2477 ,2567 
E02000495,2002,Hillingdon 002,Hillingdon,E09000017,6065 ,2869 ,3196 
E02000496,2002,Hillingdon 003,Hillingdon,E09000017,4669 ,2272 ,2397 
E02000497,2002,Hillingdon 004,Hillingdon,E09000017,5036 ,2411 ,2625 
E02000498,2002,Hillingdon 005,Hillingdon,E09000017,3800 ,1803 ,1997 
E02000499,2002,Hillingdon 006,Hillingdon,E09000017,4729 ,2290 ,2439 
E02000500,2002,Hillingdon 007,Hillingdon,E09000017,4510 ,2230 ,2280 
E02000501,2002,Hillingdon 008,Hillingdon,E09000017,5143 ,2476 ,2667 
E02000502,2002,Hillingdon 009,Hillingdon,E09000017,4715 ,2352 ,2363 
E02000503,2002,Hillingdon 010,Hillingdon,E09000017,5214 ,2643 ,2571 
E02000504,2002,Hillingdon 011,Hillingdon,E09000017,4401 ,2171 ,2230 
E02000506,2002,Hillingdon 013,Hillingdon,E09000017,4604 ,2276 ,2328 
E02000507,2002,Hillingdon 014,Hillingdon,E09000017,4984 ,2479 ,2505 
E02000508,2002,Hillingdon 015,Hillingdon,E09000017,5445 ,2784 ,2661 
E02000509,2002,Hillingdon 016,Hillingdon,E09000017,5952 ,3082 ,2870 
E02000510,2002,Hillingdon 017,Hillingdon,E09000017,5069 ,2530 ,2539 
E02000511,2002,Hillingdon 018,Hillingdon,E09000017,5670 ,2831 ,2839 
E02000512,2002,Hillingdon 019,Hillingdon,E09000017,4744 ,2317 ,2427 
E02000513,2002,Hillingdon 020,Hillingdon,E09000017,5192 ,2557 ,2635 
E02000514,2002,Hillingdon 021,Hillingdon,E09000017,6038 ,2994 ,3044 
E02000515,2002,Hillingdon 022,Hillingdon,E09000017,6284 ,3110 ,3174 
E02000516,2002,Hillingdon 023,Hillingdon,E09000017,5180 ,2549 ,2631 
E02000517,2002,Hillingdon 024,Hillingdon,E09000017,5152 ,2584 ,2568 
E02000518,2002,Hillingdon 025,Hillingdon,E09000017,5292 ,2608 ,2684 
E02000519,2002,Hillingdon 026,Hillingdon,E09000017,4881 ,2429 ,2452 
E02000520,2002,Hillingdon 027,Hillingdon,E09000017,6148 ,3154 ,2994 
E02000521,2002,Hillingdon 028,Hillingdon,E09000017,4847 ,2363 ,2484 
E02000522,2002,Hillingdon 029,Hillingdon,E09000017,4938 ,2464 ,2474 
E02000523,2002,Hillingdon 030,Hillingdon,E09000017,5380 ,2808 ,2572 
E02000524,2002,Hillingdon 031,Hillingdon,E09000017,4214 ,2206 ,2008 
E02000525,2002,Hillingdon 032,Hillingdon,E09000017,5101 ,2550 ,2551 
E02006796,2002,Hillingdon 033,Hillingdon,E09000017,5310 ,2593 ,2717 
E02000526,2002,Hounslow 001,Hounslow,E09000018,5845 ,2859 ,2986 
E02000528,2002,Hounslow 003,Hounslow,E09000018,5571 ,2735 ,2836 
E02000529,2002,Hounslow 004,Hounslow,E09000018,5272 ,2659 ,2613 
E02000530,2002,Hounslow 005,Hounslow,E09000018,4320 ,2195 ,2125 
E02000531,2002,Hounslow 006,Hounslow,E09000018,5665 ,2769 ,2896 
E02000532,2002,Hounslow 007,Hounslow,E09000018,6173 ,3059 ,3114 
E02000533,2002,Hounslow 008,Hounslow,E09000018,5835 ,2966 ,2869 
E02000534,2002,Hounslow 009,Hounslow,E09000018,4372 ,2287 ,2085 
E02000535,2002,Hounslow 010,Hounslow,E09000018,5613 ,2918 ,2695 
E02000536,2002,Hounslow 011,Hounslow,E09000018,5835 ,2988 ,2847 
E02000537,2002,Hounslow 012,Hounslow,E09000018,5820 ,3124 ,2696 
E02000538,2002,Hounslow 013,Hounslow,E09000018,5566 ,2986 ,2580 
E02000539,2002,Hounslow 014,Hounslow,E09000018,5653 ,2771 ,2882 
E02000540,2002,Hounslow 015,Hounslow,E09000018,5432 ,2775 ,2657 
E02000541,2002,Hounslow 016,Hounslow,E09000018,5444 ,2857 ,2587 
E02000542,2002,Hounslow 017,Hounslow,E09000018,5376 ,2826 ,2550 
E02000543,2002,Hounslow 018,Hounslow,E09000018,5811 ,3084 ,2727 
E02000544,2002,Hounslow 019,Hounslow,E09000018,5079 ,2545 ,2534 
E02000545,2002,Hounslow 020,Hounslow,E09000018,5352 ,2568 ,2784 
E02000546,2002,Hounslow 021,Hounslow,E09000018,5966 ,3180 ,2786 
E02000547,2002,Hounslow 022,Hounslow,E09000018,5244 ,2678 ,2566 
E02000548,2002,Hounslow 023,Hounslow,E09000018,4640 ,2307 ,2333 
E02000549,2002,Hounslow 024,Hounslow,E09000018,6241 ,3217 ,3024 
E02000550,2002,Hounslow 025,Hounslow,E09000018,4999 ,2397 ,2602 
E02000551,2002,Hounslow 026,Hounslow,E09000018,4890 ,2353 ,2537 
E02000552,2002,Hounslow 027,Hounslow,E09000018,4708 ,2514 ,2194 
E02000553,2002,Hounslow 028,Hounslow,E09000018,4054 ,2028 ,2026 
E02006792,2002,Hounslow 029,Hounslow,E09000018,5783 ,2944 ,2839 
E02000554,2002,Islington 001,Islington,E09000019,6677 ,3194 ,3483 
E02000555,2002,Islington 002,Islington,E09000019,6353 ,3038 ,3315 
E02000556,2002,Islington 003,Islington,E09000019,7402 ,3616 ,3786 
E02000557,2002,Islington 004,Islington,E09000019,5727 ,2699 ,3028 
E02000558,2002,Islington 005,Islington,E09000019,5534 ,2705 ,2829 
E02000559,2002,Islington 006,Islington,E09000019,5416 ,2695 ,2721 
E02000560,2002,Islington 007,Islington,E09000019,5416 ,2667 ,2749 
E02000561,2002,Islington 008,Islington,E09000019,4949 ,2410 ,2539 
E02000562,2002,Islington 009,Islington,E09000019,5235 ,2565 ,2670 
E02000563,2002,Islington 010,Islington,E09000019,5705 ,2654 ,3051 
E02000564,2002,Islington 011,Islington,E09000019,4904 ,2410 ,2494 
E02000565,2002,Islington 012,Islington,E09000019,5027 ,2469 ,2558 
E02000566,2002,Islington 013,Islington,E09000019,5296 ,2614 ,2682 
E02000567,2002,Islington 014,Islington,E09000019,6658 ,3254 ,3404 
E02000568,2002,Islington 015,Islington,E09000019,5446 ,2868 ,2578 
E02000569,2002,Islington 016,Islington,E09000019,6273 ,3000 ,3273 
E02000570,2002,Islington 017,Islington,E09000019,5812 ,2875 ,2937 
E02000571,2002,Islington 018,Islington,E09000019,5277 ,2593 ,2684 
E02000572,2002,Islington 019,Islington,E09000019,5109 ,2530 ,2579 
E02000573,2002,Islington 020,Islington,E09000019,5779 ,2964 ,2815 
E02000574,2002,Islington 021,Islington,E09000019,5665 ,2820 ,2845 
E02000575,2002,Islington 022,Islington,E09000019,6726 ,3526 ,3200 
E02000576,2002,Islington 023,Islington,E09000019,5157 ,2582 ,2575 
E02000577,2002,Kensington and Chelsea 001,Kensington and Chelsea,E09000020,4952 ,2437 ,2515 
E02000578,2002,Kensington and Chelsea 002,Kensington and Chelsea,E09000020,3990 ,1888 ,2102 
E02000579,2002,Kensington and Chelsea 003,Kensington and Chelsea,E09000020,5332 ,2522 ,2810 
E02000580,2002,Kensington and Chelsea 004,Kensington and Chelsea,E09000020,6122 ,3003 ,3119 
E02000581,2002,Kensington and Chelsea 005,Kensington and Chelsea,E09000020,5102 ,2458 ,2644 
E02000582,2002,Kensington and Chelsea 006,Kensington and Chelsea,E09000020,6457 ,3208 ,3249 
E02000583,2002,Kensington and Chelsea 007,Kensington and Chelsea,E09000020,5665 ,2710 ,2955 
E02000584,2002,Kensington and Chelsea 008,Kensington and Chelsea,E09000020,6267 ,3160 ,3107 
E02000585,2002,Kensington and Chelsea 009,Kensington and Chelsea,E09000020,6453 ,3162 ,3291 
E02000586,2002,Kensington and Chelsea 010,Kensington and Chelsea,E09000020,6388 ,3195 ,3193 
E02000587,2002,Kensington and Chelsea 011,Kensington and Chelsea,E09000020,5461 ,2710 ,2751 
E02000588,2002,Kensington and Chelsea 012,Kensington and Chelsea,E09000020,6138 ,2923 ,3215 
E02000589,2002,Kensington and Chelsea 013,Kensington and Chelsea,E09000020,7035 ,3795 ,3240 
E02000590,2002,Kensington and Chelsea 014,Kensington and Chelsea,E09000020,5486 ,2566 ,2920 
E02000591,2002,Kensington and Chelsea 015,Kensington and Chelsea,E09000020,5209 ,2822 ,2387 
E02000592,2002,Kensington and Chelsea 016,Kensington and Chelsea,E09000020,6120 ,3097 ,3023 
E02000593,2002,Kensington and Chelsea 017,Kensington and Chelsea,E09000020,6296 ,3266 ,3030 
E02000594,2002,Kensington and Chelsea 018,Kensington and Chelsea,E09000020,5164 ,2455 ,2709 
E02000595,2002,Kensington and Chelsea 019,Kensington and Chelsea,E09000020,5327 ,2566 ,2761 
E02000596,2002,Kensington and Chelsea 020,Kensington and Chelsea,E09000020,5903 ,2913 ,2990 
E02000597,2002,Kensington and Chelsea 021,Kensington and Chelsea,E09000020,5724 ,2800 ,2924 
E02000598,2002,Kingston upon Thames 001,Kingston upon Thames,E09000021,4568 ,2218 ,2350 
E02000599,2002,Kingston upon Thames 002,Kingston upon Thames,E09000021,4922 ,2444 ,2478 
E02000600,2002,Kingston upon Thames 003,Kingston upon Thames,E09000021,5689 ,2850 ,2839 
E02000601,2002,Kingston upon Thames 004,Kingston upon Thames,E09000021,5649 ,2784 ,2865 
E02000602,2002,Kingston upon Thames 005,Kingston upon Thames,E09000021,5428 ,2852 ,2576 
E02000603,2002,Kingston upon Thames 006,Kingston upon Thames,E09000021,5031 ,2524 ,2507 
E02000604,2002,Kingston upon Thames 007,Kingston upon Thames,E09000021,5593 ,2853 ,2740 
E02000605,2002,Kingston upon Thames 008,Kingston upon Thames,E09000021,5272 ,2699 ,2573 
E02000606,2002,Kingston upon Thames 009,Kingston upon Thames,E09000021,6193 ,3298 ,2895 
E02000607,2002,Kingston upon Thames 010,Kingston upon Thames,E09000021,4641 ,2455 ,2186 
E02000608,2002,Kingston upon Thames 011,Kingston upon Thames,E09000021,5403 ,2852 ,2551 
E02000609,2002,Kingston upon Thames 012,Kingston upon Thames,E09000021,4719 ,2355 ,2364 
E02000610,2002,Kingston upon Thames 013,Kingston upon Thames,E09000021,5556 ,2893 ,2663 
E02000611,2002,Kingston upon Thames 014,Kingston upon Thames,E09000021,4931 ,2485 ,2446 
E02000612,2002,Kingston upon Thames 015,Kingston upon Thames,E09000021,5069 ,2577 ,2492 
E02000613,2002,Kingston upon Thames 016,Kingston upon Thames,E09000021,5136 ,2568 ,2568 
E02000614,2002,Kingston upon Thames 017,Kingston upon Thames,E09000021,5578 ,2835 ,2743 
E02000615,2002,Kingston upon Thames 018,Kingston upon Thames,E09000021,4901 ,2511 ,2390 
E02000616,2002,Kingston upon Thames 019,Kingston upon Thames,E09000021,4079 ,2016 ,2063 
E02000617,2002,Kingston upon Thames 020,Kingston upon Thames,E09000021,5083 ,2452 ,2631 
E02000619,2002,Lambeth 002,Lambeth,E09000022,5436 ,2881 ,2555 
E02000620,2002,Lambeth 003,Lambeth,E09000022,5473 ,2828 ,2645 
E02000621,2002,Lambeth 004,Lambeth,E09000022,6131 ,3351 ,2780 
E02000622,2002,Lambeth 005,Lambeth,E09000022,5596 ,2971 ,2625 
E02000623,2002,Lambeth 006,Lambeth,E09000022,5384 ,2789 ,2595 
E02000624,2002,Lambeth 007,Lambeth,E09000022,5431 ,2736 ,2695 
E02000625,2002,Lambeth 008,Lambeth,E09000022,5730 ,2915 ,2815 
E02000626,2002,Lambeth 009,Lambeth,E09000022,5588 ,2771 ,2817 
E02000627,2002,Lambeth 010,Lambeth,E09000022,6493 ,3469 ,3024 
E02000628,2002,Lambeth 011,Lambeth,E09000022,6618 ,3382 ,3236 
E02000629,2002,Lambeth 012,Lambeth,E09000022,6194 ,3250 ,2944 
E02000630,2002,Lambeth 013,Lambeth,E09000022,4909 ,2571 ,2338 
E02000631,2002,Lambeth 014,Lambeth,E09000022,6211 ,3175 ,3036 
E02000632,2002,Lambeth 015,Lambeth,E09000022,7074 ,3718 ,3356 
E02000633,2002,Lambeth 016,Lambeth,E09000022,5704 ,3045 ,2659 
E02000634,2002,Lambeth 017,Lambeth,E09000022,4774 ,2509 ,2265 
E02000635,2002,Lambeth 018,Lambeth,E09000022,6090 ,3120 ,2970 
E02000636,2002,Lambeth 019,Lambeth,E09000022,5363 ,2857 ,2506 
E02000637,2002,Lambeth 020,Lambeth,E09000022,6418 ,3394 ,3024 
E02000638,2002,Lambeth 021,Lambeth,E09000022,5807 ,2992 ,2815 
E02000639,2002,Lambeth 022,Lambeth,E09000022,5622 ,2714 ,2908 
E02000640,2002,Lambeth 023,Lambeth,E09000022,6052 ,3130 ,2922 
E02000641,2002,Lambeth 024,Lambeth,E09000022,5460 ,2648 ,2812 
E02000642,2002,Lambeth 025,Lambeth,E09000022,6271 ,3076 ,3195 
E02000643,2002,Lambeth 026,Lambeth,E09000022,5662 ,2852 ,2810 
E02000644,2002,Lambeth 027,Lambeth,E09000022,5491 ,2803 ,2688 
E02000645,2002,Lambeth 028,Lambeth,E09000022,5551 ,2791 ,2760 
E02000646,2002,Lambeth 029,Lambeth,E09000022,5585 ,2932 ,2653 
E02000647,2002,Lambeth 030,Lambeth,E09000022,5234 ,2648 ,2586 
E02000648,2002,Lambeth 031,Lambeth,E09000022,4421 ,2074 ,2347 
E02000649,2002,Lambeth 032,Lambeth,E09000022,6806 ,3481 ,3325 
E02000650,2002,Lambeth 033,Lambeth,E09000022,5031 ,2399 ,2632 
E02000651,2002,Lambeth 034,Lambeth,E09000022,5204 ,2710 ,2494 
E02000652,2002,Lambeth 035,Lambeth,E09000022,4313 ,2152 ,2161 
E02006801,2002,Lambeth 036,Lambeth,E09000022,6034 ,3133 ,2901 
E02000653,2002,Lewisham 001,Lewisham,E09000023,4946 ,2503 ,2443 
E02000654,2002,Lewisham 002,Lewisham,E09000023,4796 ,2311 ,2485 
E02000655,2002,Lewisham 003,Lewisham,E09000023,4867 ,2469 ,2398 
E02000657,2002,Lewisham 005,Lewisham,E09000023,6181 ,3022 ,3159 
E02000658,2002,Lewisham 006,Lewisham,E09000023,5612 ,2794 ,2818 
E02000659,2002,Lewisham 007,Lewisham,E09000023,5350 ,2708 ,2642 
E02000660,2002,Lewisham 008,Lewisham,E09000023,5137 ,2646 ,2491 
E02000661,2002,Lewisham 009,Lewisham,E09000023,4326 ,2239 ,2087 
E02000662,2002,Lewisham 010,Lewisham,E09000023,5489 ,2746 ,2743 
E02000663,2002,Lewisham 011,Lewisham,E09000023,5178 ,2623 ,2555 
E02000664,2002,Lewisham 012,Lewisham,E09000023,5760 ,2932 ,2828 
E02000665,2002,Lewisham 013,Lewisham,E09000023,4933 ,2455 ,2478 
E02000666,2002,Lewisham 014,Lewisham,E09000023,5166 ,2572 ,2594 
E02000667,2002,Lewisham 015,Lewisham,E09000023,4617 ,2321 ,2296 
E02000668,2002,Lewisham 016,Lewisham,E09000023,4064 ,2033 ,2031 
E02000669,2002,Lewisham 017,Lewisham,E09000023,4618 ,2453 ,2165 
E02000670,2002,Lewisham 018,Lewisham,E09000023,4089 ,2058 ,2031 
E02000671,2002,Lewisham 019,Lewisham,E09000023,5506 ,2762 ,2744 
E02000672,2002,Lewisham 020,Lewisham,E09000023,4902 ,2512 ,2390 
E02000673,2002,Lewisham 021,Lewisham,E09000023,5260 ,2740 ,2520 
E02000674,2002,Lewisham 022,Lewisham,E09000023,5147 ,2563 ,2584 
E02000675,2002,Lewisham 023,Lewisham,E09000023,5339 ,2656 ,2683 
E02000676,2002,Lewisham 024,Lewisham,E09000023,5051 ,2506 ,2545 
E02000677,2002,Lewisham 025,Lewisham,E09000023,4491 ,2317 ,2174 
E02000678,2002,Lewisham 026,Lewisham,E09000023,3790 ,1854 ,1936 
E02000679,2002,Lewisham 027,Lewisham,E09000023,5123 ,2483 ,2640 
E02000680,2002,Lewisham 028,Lewisham,E09000023,4230 ,2106 ,2124 
E02000681,2002,Lewisham 029,Lewisham,E09000023,5035 ,2465 ,2570 
E02000682,2002,Lewisham 030,Lewisham,E09000023,4667 ,2299 ,2368 
E02000683,2002,Lewisham 031,Lewisham,E09000023,4138 ,2028 ,2110 
E02000685,2002,Lewisham 033,Lewisham,E09000023,5024 ,2362 ,2662 
E02000686,2002,Lewisham 034,Lewisham,E09000023,4126 ,1950 ,2176 
E02000687,2002,Lewisham 035,Lewisham,E09000023,5028 ,2494 ,2534 
E02006783,2002,Lewisham 037,Lewisham,E09000023,4425 ,2105 ,2320 
E02006784,2002,Lewisham 038,Lewisham,E09000023,4174 ,2127 ,2047 
E02006798,2002,Lewisham 039,Lewisham,E09000023,5267 ,2649 ,2618 
E02000689,2002,Merton 001,Merton,E09000024,5129 ,2645 ,2484 
E02000690,2002,Merton 002,Merton,E09000024,3781 ,1886 ,1895 
E02000691,2002,Merton 003,Merton,E09000024,5393 ,2781 ,2612 
E02000692,2002,Merton 004,Merton,E09000024,5733 ,3006 ,2727 
E02000693,2002,Merton 005,Merton,E09000024,6137 ,3107 ,3030 
E02000694,2002,Merton 006,Merton,E09000024,6073 ,3062 ,3011 
E02000695,2002,Merton 007,Merton,E09000024,5841 ,3056 ,2785 
E02000696,2002,Merton 008,Merton,E09000024,5756 ,2942 ,2814 
E02000697,2002,Merton 009,Merton,E09000024,6262 ,3215 ,3047 
E02000698,2002,Merton 010,Merton,E09000024,5310 ,2654 ,2656 
E02000699,2002,Merton 011,Merton,E09000024,5521 ,2842 ,2679 
E02000700,2002,Merton 012,Merton,E09000024,5742 ,2842 ,2900 
E02000701,2002,Merton 013,Merton,E09000024,4833 ,2439 ,2394 
E02000702,2002,Merton 014,Merton,E09000024,4878 ,2347 ,2531 
E02000703,2002,Merton 015,Merton,E09000024,5222 ,2690 ,2532 
E02000704,2002,Merton 016,Merton,E09000024,5394 ,2703 ,2691 
E02000705,2002,Merton 017,Merton,E09000024,5173 ,2584 ,2589 
E02000706,2002,Merton 018,Merton,E09000024,4873 ,2390 ,2483 
E02000707,2002,Merton 019,Merton,E09000024,4696 ,2291 ,2405 
E02000708,2002,Merton 020,Merton,E09000024,5614 ,2824 ,2790 
E02000709,2002,Merton 021,Merton,E09000024,5043 ,2590 ,2453 
E02000710,2002,Merton 022,Merton,E09000024,5028 ,2438 ,2590 
E02000711,2002,Merton 023,Merton,E09000024,4905 ,2469 ,2436 
E02000712,2002,Merton 024,Merton,E09000024,4633 ,2282 ,2351 
E02000713,2002,Merton 025,Merton,E09000024,4501 ,2259 ,2242 
E02000714,2002,Newham 001,Newham,E09000025,4456 ,2280 ,2176 
E02000715,2002,Newham 002,Newham,E09000025,4023 ,2059 ,1964 
E02000716,2002,Newham 003,Newham,E09000025,4056 ,2135 ,1921 
E02000717,2002,Newham 004,Newham,E09000025,4245 ,2206 ,2039 
E02000718,2002,Newham 005,Newham,E09000025,3776 ,1867 ,1909 
E02000719,2002,Newham 006,Newham,E09000025,4560 ,2339 ,2221 
E02000720,2002,Newham 007,Newham,E09000025,4469 ,2407 ,2062 
E02000721,2002,Newham 008,Newham,E09000025,5471 ,2892 ,2579 
E02000722,2002,Newham 009,Newham,E09000025,4740 ,2362 ,2378 
E02000723,2002,Newham 010,Newham,E09000025,6247 ,3435 ,2812 
E02000724,2002,Newham 011,Newham,E09000025,5454 ,2978 ,2476 
E02000725,2002,Newham 012,Newham,E09000025,4424 ,2204 ,2220 
E02000726,2002,Newham 013,Newham,E09000025,4470 ,2285 ,2185 
E02000727,2002,Newham 014,Newham,E09000025,4677 ,2526 ,2151 
E02000728,2002,Newham 015,Newham,E09000025,6025 ,3366 ,2659 
E02000729,2002,Newham 016,Newham,E09000025,4240 ,2251 ,1989 
E02000730,2002,Newham 017,Newham,E09000025,5301 ,2777 ,2524 
E02000731,2002,Newham 018,Newham,E09000025,5489 ,3044 ,2445 
E02000732,2002,Newham 019,Newham,E09000025,4093 ,2161 ,1932 
E02000733,2002,Newham 020,Newham,E09000025,5633 ,2787 ,2846 
E02000734,2002,Newham 021,Newham,E09000025,4023 ,1944 ,2079 
E02000735,2002,Newham 022,Newham,E09000025,4103 ,2192 ,1911 
E02000736,2002,Newham 023,Newham,E09000025,4759 ,2424 ,2335 
E02000737,2002,Newham 024,Newham,E09000025,5104 ,2582 ,2522 
E02000738,2002,Newham 025,Newham,E09000025,4397 ,2225 ,2172 
E02000739,2002,Newham 026,Newham,E09000025,4030 ,2070 ,1960 
E02000740,2002,Newham 027,Newham,E09000025,4195 ,2002 ,2193 
E02000741,2002,Newham 028,Newham,E09000025,4398 ,2131 ,2267 
E02000742,2002,Newham 029,Newham,E09000025,4107 ,2095 ,2012 
E02000743,2002,Newham 030,Newham,E09000025,4190 ,2034 ,2156 
E02000744,2002,Newham 031,Newham,E09000025,4103 ,2049 ,2054 
E02000745,2002,Newham 032,Newham,E09000025,5260 ,2620 ,2640 
E02000746,2002,Newham 033,Newham,E09000025,3926 ,1893 ,2033 
E02000747,2002,Newham 034,Newham,E09000025,5370 ,2594 ,2776 
E02000748,2002,Newham 035,Newham,E09000025,4236 ,2157 ,2079 
E02000749,2002,Newham 036,Newham,E09000025,4902 ,2349 ,2553 
E02000750,2002,Newham 037,Newham,E09000025,4671 ,2386 ,2285 
E02000751,2002,Redbridge 001,Redbridge,E09000026,6398 ,3128 ,3270 
E02000752,2002,Redbridge 002,Redbridge,E09000026,3501 ,1729 ,1772 
E02000753,2002,Redbridge 003,Redbridge,E09000026,3523 ,1691 ,1832 
E02000754,2002,Redbridge 004,Redbridge,E09000026,4145 ,2038 ,2107 
E02000755,2002,Redbridge 005,Redbridge,E09000026,3451 ,1692 ,1759 
E02000756,2002,Redbridge 006,Redbridge,E09000026,7028 ,3403 ,3625 
E02000757,2002,Redbridge 007,Redbridge,E09000026,7109 ,3569 ,3540 
E02000758,2002,Redbridge 008,Redbridge,E09000026,3655 ,1772 ,1883 
E02000759,2002,Redbridge 009,Redbridge,E09000026,7394 ,3719 ,3675 
E02000760,2002,Redbridge 010,Redbridge,E09000026,3540 ,1724 ,1816 
E02000762,2002,Redbridge 012,Redbridge,E09000026,3696 ,1828 ,1868 
E02000763,2002,Redbridge 013,Redbridge,E09000026,3902 ,1960 ,1942 
E02000764,2002,Redbridge 014,Redbridge,E09000026,7139 ,3477 ,3662 
E02000765,2002,Redbridge 015,Redbridge,E09000026,3673 ,1840 ,1833 
E02000767,2002,Redbridge 017,Redbridge,E09000026,4049 ,2013 ,2036 
E02000768,2002,Redbridge 018,Redbridge,E09000026,3805 ,1909 ,1896 
E02000769,2002,Redbridge 019,Redbridge,E09000026,7039 ,3456 ,3583 
E02000770,2002,Redbridge 020,Redbridge,E09000026,4404 ,2239 ,2165 
E02000772,2002,Redbridge 022,Redbridge,E09000026,4021 ,2045 ,1976 
E02000773,2002,Redbridge 023,Redbridge,E09000026,4709 ,2375 ,2334 
E02000774,2002,Redbridge 024,Redbridge,E09000026,4499 ,2268 ,2231 
E02000776,2002,Redbridge 026,Redbridge,E09000026,3955 ,2034 ,1921 
E02000777,2002,Redbridge 027,Redbridge,E09000026,3917 ,2003 ,1914 
E02000779,2002,Redbridge 029,Redbridge,E09000026,4678 ,2462 ,2216 
E02000780,2002,Redbridge 030,Redbridge,E09000026,7751 ,3974 ,3777 
E02000781,2002,Redbridge 031,Redbridge,E09000026,7525 ,3879 ,3646 
E02000782,2002,Redbridge 032,Redbridge,E09000026,5162 ,2651 ,2511 
E02000783,2002,Redbridge 033,Redbridge,E09000026,3912 ,1910 ,2002 
E02006800,2002,Redbridge 034,Redbridge,E09000026,7714 ,3896 ,3818 
E02006924,2002,Redbridge 035,Redbridge,E09000026,8114 ,4211 ,3903 
E02006925,2002,Redbridge 036,Redbridge,E09000026,7814 ,3921 ,3893 
E02000784,2002,Richmond upon Thames 001,Richmond upon Thames,E09000027,6802 ,3380 ,3422 
E02000785,2002,Richmond upon Thames 002,Richmond upon Thames,E09000027,6531 ,3252 ,3279 
E02000786,2002,Richmond upon Thames 003,Richmond upon Thames,E09000027,7285 ,3677 ,3608 
E02000787,2002,Richmond upon Thames 004,Richmond upon Thames,E09000027,6090 ,3116 ,2974 
E02000788,2002,Richmond upon Thames 005,Richmond upon Thames,E09000027,5616 ,2762 ,2854 
E02000789,2002,Richmond upon Thames 006,Richmond upon Thames,E09000027,4355 ,2247 ,2108 
E02000790,2002,Richmond upon Thames 007,Richmond upon Thames,E09000027,4202 ,2090 ,2112 
E02000791,2002,Richmond upon Thames 008,Richmond upon Thames,E09000027,4512 ,2323 ,2189 
E02000792,2002,Richmond upon Thames 009,Richmond upon Thames,E09000027,4846 ,2428 ,2418 
E02000793,2002,Richmond upon Thames 010,Richmond upon Thames,E09000027,5051 ,2522 ,2529 
E02000794,2002,Richmond upon Thames 011,Richmond upon Thames,E09000027,4089 ,2038 ,2051 
E02000795,2002,Richmond upon Thames 012,Richmond upon Thames,E09000027,4103 ,2102 ,2001 
E02000796,2002,Richmond upon Thames 013,Richmond upon Thames,E09000027,6294 ,3203 ,3091 
E02000797,2002,Richmond upon Thames 014,Richmond upon Thames,E09000027,4762 ,2425 ,2337 
E02000798,2002,Richmond upon Thames 015,Richmond upon Thames,E09000027,6904 ,3463 ,3441 
E02000799,2002,Richmond upon Thames 016,Richmond upon Thames,E09000027,4239 ,2052 ,2187 
E02000800,2002,Richmond upon Thames 017,Richmond upon Thames,E09000027,3377 ,1719 ,1658 
E02000801,2002,Richmond upon Thames 018,Richmond upon Thames,E09000027,4485 ,2187 ,2298 
E02000802,2002,Richmond upon Thames 019,Richmond upon Thames,E09000027,4125 ,2038 ,2087 
E02000803,2002,Richmond upon Thames 020,Richmond upon Thames,E09000027,6084 ,2992 ,3092 
E02000804,2002,Richmond upon Thames 021,Richmond upon Thames,E09000027,4541 ,2260 ,2281 
E02000805,2002,Richmond upon Thames 022,Richmond upon Thames,E09000027,6103 ,3051 ,3052 
E02000806,2002,Richmond upon Thames 023,Richmond upon Thames,E09000027,6154 ,3005 ,3149 
E02000807,2002,Southwark 001,Southwark,E09000028,5787 ,3166 ,2621 
E02000808,2002,Southwark 002,Southwark,E09000028,5889 ,3078 ,2811 
E02000809,2002,Southwark 003,Southwark,E09000028,6899 ,3959 ,2940 
E02000810,2002,Southwark 004,Southwark,E09000028,5307 ,2784 ,2523 
E02000812,2002,Southwark 006,Southwark,E09000028,6349 ,3349 ,3000 
E02000813,2002,Southwark 007,Southwark,E09000028,5060 ,2656 ,2404 
E02000814,2002,Southwark 008,Southwark,E09000028,5913 ,3358 ,2555 
E02000815,2002,Southwark 009,Southwark,E09000028,6312 ,3374 ,2938 
E02000816,2002,Southwark 010,Southwark,E09000028,5391 ,2723 ,2668 
E02000817,2002,Southwark 011,Southwark,E09000028,4084 ,1910 ,2174 
E02000818,2002,Southwark 012,Southwark,E09000028,5065 ,2536 ,2529 
E02000819,2002,Southwark 013,Southwark,E09000028,4934 ,2530 ,2404 
E02000820,2002,Southwark 014,Southwark,E09000028,5122 ,2639 ,2483 
E02000821,2002,Southwark 015,Southwark,E09000028,5259 ,2683 ,2576 
E02000822,2002,Southwark 016,Southwark,E09000028,5536 ,2750 ,2786 
E02000823,2002,Southwark 017,Southwark,E09000028,5043 ,2547 ,2496 
E02000824,2002,Southwark 018,Southwark,E09000028,5577 ,2672 ,2905 
E02000825,2002,Southwark 019,Southwark,E09000028,4940 ,2379 ,2561 
E02000826,2002,Southwark 020,Southwark,E09000028,5438 ,2648 ,2790 
E02000827,2002,Southwark 021,Southwark,E09000028,6141 ,3080 ,3061 
E02000828,2002,Southwark 022,Southwark,E09000028,5303 ,2671 ,2632 
E02000829,2002,Southwark 023,Southwark,E09000028,5686 ,2844 ,2842 
E02000830,2002,Southwark 024,Southwark,E09000028,5705 ,2922 ,2783 
E02000831,2002,Southwark 025,Southwark,E09000028,5618 ,2790 ,2828 
E02000832,2002,Southwark 026,Southwark,E09000028,5544 ,2688 ,2856 
E02000833,2002,Southwark 027,Southwark,E09000028,5397 ,2564 ,2833 
E02000834,2002,Southwark 028,Southwark,E09000028,6210 ,3074 ,3136 
E02000835,2002,Southwark 029,Southwark,E09000028,4605 ,2237 ,2368 
E02000836,2002,Southwark 030,Southwark,E09000028,5663 ,2803 ,2860 
E02000837,2002,Southwark 031,Southwark,E09000028,5019 ,2463 ,2556 
E02000838,2002,Southwark 032,Southwark,E09000028,5648 ,2729 ,2919 
E02000839,2002,Southwark 033,Southwark,E09000028,5148 ,2595 ,2553 
E02006802,2002,Southwark 034,Southwark,E09000028,5579 ,2741 ,2838 
E02000840,2002,Sutton 001,Sutton,E09000029,4751 ,2282 ,2469 
E02000841,2002,Sutton 002,Sutton,E09000029,4820 ,2411 ,2409 
E02000842,2002,Sutton 003,Sutton,E09000029,4805 ,2416 ,2389 
E02000843,2002,Sutton 004,Sutton,E09000029,5160 ,2533 ,2627 
E02000844,2002,Sutton 005,Sutton,E09000029,4794 ,2304 ,2490 
E02000845,2002,Sutton 006,Sutton,E09000029,4789 ,2293 ,2496 
E02000846,2002,Sutton 007,Sutton,E09000029,4422 ,2161 ,2261 
E02000847,2002,Sutton 008,Sutton,E09000029,5437 ,2667 ,2770 
E02000848,2002,Sutton 009,Sutton,E09000029,4795 ,2400 ,2395 
E02000849,2002,Sutton 010,Sutton,E09000029,4838 ,2386 ,2452 
E02000850,2002,Sutton 011,Sutton,E09000029,6744 ,3413 ,3331 
E02000851,2002,Sutton 012,Sutton,E09000029,5102 ,2657 ,2445 
E02000852,2002,Sutton 013,Sutton,E09000029,5074 ,2523 ,2551 
E02000853,2002,Sutton 014,Sutton,E09000029,5025 ,2528 ,2497 
E02000854,2002,Sutton 015,Sutton,E09000029,4520 ,2256 ,2264 
E02000855,2002,Sutton 016,Sutton,E09000029,4666 ,2307 ,2359 
E02000856,2002,Sutton 017,Sutton,E09000029,5312 ,2658 ,2654 
E02000857,2002,Sutton 018,Sutton,E09000029,5165 ,2634 ,2531 
E02000858,2002,Sutton 019,Sutton,E09000029,4843 ,2328 ,2515 
E02000859,2002,Sutton 020,Sutton,E09000029,5177 ,2558 ,2619 
E02000860,2002,Sutton 021,Sutton,E09000029,4924 ,2549 ,2375 
E02000861,2002,Sutton 022,Sutton,E09000029,4951 ,2454 ,2497 
E02000863,2002,Sutton 024,Sutton,E09000029,4015 ,1997 ,2018 
E02006836,2002,Sutton 025,Sutton,E09000029,5126 ,2490 ,2636 
E02000864,2002,Tower Hamlets 001,Tower Hamlets,E09000030,4482 ,2173 ,2309 
E02000865,2002,Tower Hamlets 002,Tower Hamlets,E09000030,4324 ,2180 ,2144 
E02000866,2002,Tower Hamlets 003,Tower Hamlets,E09000030,6103 ,3116 ,2987 
E02000867,2002,Tower Hamlets 004,Tower Hamlets,E09000030,4344 ,2188 ,2156 
E02000868,2002,Tower Hamlets 005,Tower Hamlets,E09000030,4243 ,2111 ,2132 
E02000869,2002,Tower Hamlets 006,Tower Hamlets,E09000030,3418 ,1788 ,1630 
E02000870,2002,Tower Hamlets 007,Tower Hamlets,E09000030,3948 ,1967 ,1981 
E02000871,2002,Tower Hamlets 008,Tower Hamlets,E09000030,4810 ,2400 ,2410 
E02000872,2002,Tower Hamlets 009,Tower Hamlets,E09000030,4280 ,2306 ,1974 
E02000873,2002,Tower Hamlets 010,Tower Hamlets,E09000030,4239 ,2001 ,2238 
E02000874,2002,Tower Hamlets 011,Tower Hamlets,E09000030,4899 ,2467 ,2432 
E02000875,2002,Tower Hamlets 012,Tower Hamlets,E09000030,5079 ,2581 ,2498 
E02000876,2002,Tower Hamlets 013,Tower Hamlets,E09000030,4613 ,2434 ,2179 
E02000877,2002,Tower Hamlets 014,Tower Hamlets,E09000030,5835 ,2916 ,2919 
E02000878,2002,Tower Hamlets 015,Tower Hamlets,E09000030,7050 ,3882 ,3168 
E02000879,2002,Tower Hamlets 016,Tower Hamlets,E09000030,4332 ,2174 ,2158 
E02000880,2002,Tower Hamlets 017,Tower Hamlets,E09000030,4137 ,2125 ,2012 
E02000881,2002,Tower Hamlets 018,Tower Hamlets,E09000030,3693 ,1829 ,1864 
E02000882,2002,Tower Hamlets 019,Tower Hamlets,E09000030,4218 ,2181 ,2037 
E02000883,2002,Tower Hamlets 020,Tower Hamlets,E09000030,4014 ,2011 ,2003 
E02000884,2002,Tower Hamlets 021,Tower Hamlets,E09000030,5365 ,2963 ,2402 
E02000885,2002,Tower Hamlets 022,Tower Hamlets,E09000030,3891 ,2086 ,1805 
E02000886,2002,Tower Hamlets 023,Tower Hamlets,E09000030,4417 ,2427 ,1990 
E02000887,2002,Tower Hamlets 024,Tower Hamlets,E09000030,4631 ,2350 ,2281 
E02000888,2002,Tower Hamlets 025,Tower Hamlets,E09000030,4548 ,2542 ,2006 
E02000889,2002,Tower Hamlets 026,Tower Hamlets,E09000030,4690 ,2604 ,2086 
E02000890,2002,Tower Hamlets 027,Tower Hamlets,E09000030,4407 ,2470 ,1937 
E02000891,2002,Tower Hamlets 028,Tower Hamlets,E09000030,5208 ,2861 ,2347 
E02000893,2002,Tower Hamlets 030,Tower Hamlets,E09000030,4935 ,2614 ,2321 
E02000894,2002,Tower Hamlets 031,Tower Hamlets,E09000030,6322 ,3437 ,2885 
E02006853,2002,Tower Hamlets 032,Tower Hamlets,E09000030,1969 ,1033 ,936 
E02006854,2002,Tower Hamlets 033,Tower Hamlets,E09000030,2173 ,1283 ,890 
E02000895,2002,Waltham Forest 001,Waltham Forest,E09000031,4508 ,2211 ,2297 
E02000896,2002,Waltham Forest 002,Waltham Forest,E09000031,5200 ,2587 ,2613 
E02000897,2002,Waltham Forest 003,Waltham Forest,E09000031,4472 ,2108 ,2364 
E02000898,2002,Waltham Forest 004,Waltham Forest,E09000031,4786 ,2300 ,2486 
E02000899,2002,Waltham Forest 005,Waltham Forest,E09000031,4763 ,2364 ,2399 
E02000900,2002,Waltham Forest 006,Waltham Forest,E09000031,4984 ,2478 ,2506 
E02000901,2002,Waltham Forest 007,Waltham Forest,E09000031,5733 ,2864 ,2869 
E02000902,2002,Waltham Forest 008,Waltham Forest,E09000031,5040 ,2497 ,2543 
E02000903,2002,Waltham Forest 009,Waltham Forest,E09000031,5394 ,2625 ,2769 
E02000904,2002,Waltham Forest 010,Waltham Forest,E09000031,4299 ,2144 ,2155 
E02000905,2002,Waltham Forest 011,Waltham Forest,E09000031,5387 ,2650 ,2737 
E02000906,2002,Waltham Forest 012,Waltham Forest,E09000031,5810 ,2929 ,2881 
E02000907,2002,Waltham Forest 013,Waltham Forest,E09000031,5533 ,2754 ,2779 
E02000908,2002,Waltham Forest 014,Waltham Forest,E09000031,6020 ,3085 ,2935 
E02000909,2002,Waltham Forest 015,Waltham Forest,E09000031,5274 ,2710 ,2564 
E02000910,2002,Waltham Forest 016,Waltham Forest,E09000031,6717 ,3477 ,3240 
E02000911,2002,Waltham Forest 017,Waltham Forest,E09000031,6240 ,3126 ,3114 
E02000912,2002,Waltham Forest 018,Waltham Forest,E09000031,5258 ,2627 ,2631 
E02000913,2002,Waltham Forest 019,Waltham Forest,E09000031,5576 ,2884 ,2692 
E02000914,2002,Waltham Forest 020,Waltham Forest,E09000031,6238 ,3235 ,3003 
E02000915,2002,Waltham Forest 021,Waltham Forest,E09000031,5650 ,2927 ,2723 
E02000916,2002,Waltham Forest 022,Waltham Forest,E09000031,5457 ,2746 ,2711 
E02000917,2002,Waltham Forest 023,Waltham Forest,E09000031,5258 ,2750 ,2508 
E02000918,2002,Waltham Forest 024,Waltham Forest,E09000031,5576 ,2862 ,2714 
E02000919,2002,Waltham Forest 025,Waltham Forest,E09000031,5679 ,2947 ,2732 
E02000920,2002,Waltham Forest 026,Waltham Forest,E09000031,5641 ,2842 ,2799 
E02000921,2002,Waltham Forest 027,Waltham Forest,E09000031,6417 ,3214 ,3203 
E02000922,2002,Waltham Forest 028,Waltham Forest,E09000031,6101 ,3114 ,2987 
E02000923,2002,Wandsworth 001,Wandsworth,E09000032,5347 ,2719 ,2628 
E02000924,2002,Wandsworth 002,Wandsworth,E09000032,6310 ,3105 ,3205 
E02000925,2002,Wandsworth 003,Wandsworth,E09000032,4862 ,2363 ,2499 
E02000926,2002,Wandsworth 004,Wandsworth,E09000032,5121 ,2630 ,2491 
E02000927,2002,Wandsworth 005,Wandsworth,E09000032,5240 ,2585 ,2655 
E02000928,2002,Wandsworth 006,Wandsworth,E09000032,6085 ,3056 ,3029 
E02000929,2002,Wandsworth 007,Wandsworth,E09000032,4388 ,2151 ,2237 
E02000930,2002,Wandsworth 008,Wandsworth,E09000032,6723 ,3321 ,3402 
E02000931,2002,Wandsworth 009,Wandsworth,E09000032,6320 ,3246 ,3074 
E02000932,2002,Wandsworth 010,Wandsworth,E09000032,6486 ,3314 ,3172 
E02000933,2002,Wandsworth 011,Wandsworth,E09000032,5680 ,2729 ,2951 
E02000934,2002,Wandsworth 012,Wandsworth,E09000032,6358 ,3207 ,3151 
E02000935,2002,Wandsworth 013,Wandsworth,E09000032,4096 ,1573 ,2523 
E02000936,2002,Wandsworth 014,Wandsworth,E09000032,5930 ,2933 ,2997 
E02000937,2002,Wandsworth 015,Wandsworth,E09000032,5441 ,2665 ,2776 
E02000938,2002,Wandsworth 016,Wandsworth,E09000032,5524 ,2591 ,2933 
E02000939,2002,Wandsworth 017,Wandsworth,E09000032,5300 ,2608 ,2692 
E02000940,2002,Wandsworth 018,Wandsworth,E09000032,4768 ,2329 ,2439 
E02000941,2002,Wandsworth 019,Wandsworth,E09000032,7701 ,4234 ,3467 
E02000942,2002,Wandsworth 020,Wandsworth,E09000032,6764 ,3330 ,3434 
E02000943,2002,Wandsworth 021,Wandsworth,E09000032,5735 ,2871 ,2864 
E02000944,2002,Wandsworth 022,Wandsworth,E09000032,4661 ,2192 ,2469 
E02000945,2002,Wandsworth 023,Wandsworth,E09000032,4032 ,1813 ,2219 
E02000946,2002,Wandsworth 024,Wandsworth,E09000032,5203 ,2591 ,2612 
E02000947,2002,Wandsworth 025,Wandsworth,E09000032,6426 ,3074 ,3352 
E02000948,2002,Wandsworth 026,Wandsworth,E09000032,7396 ,3772 ,3624 
E02000949,2002,Wandsworth 027,Wandsworth,E09000032,7112 ,3468 ,3644 
E02000950,2002,Wandsworth 028,Wandsworth,E09000032,5435 ,2703 ,2732 
E02000951,2002,Wandsworth 029,Wandsworth,E09000032,4883 ,2440 ,2443 
E02000952,2002,Wandsworth 030,Wandsworth,E09000032,4590 ,2341 ,2249 
E02000953,2002,Wandsworth 031,Wandsworth,E09000032,4818 ,2173 ,2645 
E02000954,2002,Wandsworth 032,Wandsworth,E09000032,4498 ,2257 ,2241 
E02000955,2002,Wandsworth 033,Wandsworth,E09000032,4593 ,2288 ,2305 
E02000956,2002,Wandsworth 034,Wandsworth,E09000032,5003 ,2399 ,2604 
E02000957,2002,Wandsworth 035,Wandsworth,E09000032,7339 ,3631 ,3708 
E02000958,2002,Wandsworth 036,Wandsworth,E09000032,5415 ,2593 ,2822 
E02000959,2002,Wandsworth 037,Wandsworth,E09000032,4552 ,2251 ,2301 
E02000960,2002,Westminster 001,Westminster,E09000033,4848 ,2364 ,2484 
E02000961,2002,Westminster 002,Westminster,E09000033,5942 ,2902 ,3040 
E02000962,2002,Westminster 003,Westminster,E09000033,6264 ,3081 ,3183 
E02000963,2002,Westminster 004,Westminster,E09000033,5884 ,2761 ,3123 
E02000964,2002,Westminster 005,Westminster,E09000033,7118 ,3393 ,3725 
E02000965,2002,Westminster 006,Westminster,E09000033,6765 ,3363 ,3402 
E02000966,2002,Westminster 007,Westminster,E09000033,6546 ,3327 ,3219 
E02000967,2002,Westminster 008,Westminster,E09000033,5703 ,3034 ,2669 
E02000968,2002,Westminster 009,Westminster,E09000033,9219 ,4448 ,4771 
E02000969,2002,Westminster 010,Westminster,E09000033,5749 ,2730 ,3019 
E02000970,2002,Westminster 011,Westminster,E09000033,6771 ,3490 ,3281 
E02000971,2002,Westminster 012,Westminster,E09000033,6991 ,3782 ,3209 
E02000972,2002,Westminster 013,Westminster,E09000033,6218 ,3252 ,2966 
E02000973,2002,Westminster 014,Westminster,E09000033,6886 ,3442 ,3444 
E02000974,2002,Westminster 015,Westminster,E09000033,6650 ,3542 ,3108 
E02000975,2002,Westminster 016,Westminster,E09000033,6879 ,3818 ,3061 
E02000976,2002,Westminster 017,Westminster,E09000033,8077 ,4225 ,3852 
E02000977,2002,Westminster 018,Westminster,E09000033,5710 ,3316 ,2394 
E02000978,2002,Westminster 019,Westminster,E09000033,8495 ,4295 ,4200 
E02000979,2002,Westminster 020,Westminster,E09000033,6499 ,3382 ,3117 
E02000980,2002,Westminster 021,Westminster,E09000033,5556 ,2818 ,2738 
E02000981,2002,Westminster 022,Westminster,E09000033,7237 ,3794 ,3443 
E02000982,2002,Westminster 023,Westminster,E09000033,5574 ,2825 ,2749 
E02000983,2002,Westminster 024,Westminster,E09000033,6368 ,3130 ,3238 
E02000001,2003,City of London 001,City of London,E09000001,5615 ,3150 ,2465 
E02000002,2003,Barking and Dagenham 001,Barking and Dagenham,E09000002,3597 ,1747 ,1850 
E02000003,2003,Barking and Dagenham 002,Barking and Dagenham,E09000002,6104 ,2904 ,3200 
E02000004,2003,Barking and Dagenham 003,Barking and Dagenham,E09000002,3921 ,1889 ,2032 
E02000005,2003,Barking and Dagenham 004,Barking and Dagenham,E09000002,5032 ,2426 ,2606 
E02000007,2003,Barking and Dagenham 006,Barking and Dagenham,E09000002,4655 ,2172 ,2483 
E02000008,2003,Barking and Dagenham 007,Barking and Dagenham,E09000002,6436 ,3083 ,3353 
E02000009,2003,Barking and Dagenham 008,Barking and Dagenham,E09000002,5629 ,2776 ,2853 
E02000010,2003,Barking and Dagenham 009,Barking and Dagenham,E09000002,4807 ,2310 ,2497 
E02000011,2003,Barking and Dagenham 010,Barking and Dagenham,E09000002,3748 ,1901 ,1847 
E02000012,2003,Barking and Dagenham 011,Barking and Dagenham,E09000002,5025 ,2508 ,2517 
E02000013,2003,Barking and Dagenham 012,Barking and Dagenham,E09000002,4751 ,2289 ,2462 
E02000014,2003,Barking and Dagenham 013,Barking and Dagenham,E09000002,5570 ,2762 ,2808 
E02000015,2003,Barking and Dagenham 014,Barking and Dagenham,E09000002,4268 ,2065 ,2203 
E02000016,2003,Barking and Dagenham 015,Barking and Dagenham,E09000002,3973 ,2068 ,1905 
E02000017,2003,Barking and Dagenham 016,Barking and Dagenham,E09000002,5343 ,2764 ,2579 
E02000018,2003,Barking and Dagenham 017,Barking and Dagenham,E09000002,4683 ,2253 ,2430 
E02000019,2003,Barking and Dagenham 018,Barking and Dagenham,E09000002,4687 ,2287 ,2400 
E02000020,2003,Barking and Dagenham 019,Barking and Dagenham,E09000002,4947 ,2448 ,2499 
E02000021,2003,Barking and Dagenham 020,Barking and Dagenham,E09000002,4799 ,2348 ,2451 
E02000022,2003,Barking and Dagenham 021,Barking and Dagenham,E09000002,4325 ,2073 ,2252 
E02000023,2003,Barking and Dagenham 022,Barking and Dagenham,E09000002,3906 ,1873 ,2033 
E02006799,2003,Barking and Dagenham 023,Barking and Dagenham,E09000002,5483 ,2603 ,2880 
E02000024,2003,Barnet 001,Barnet,E09000003,6056 ,2918 ,3138 
E02000025,2003,Barnet 002,Barnet,E09000003,5068 ,2461 ,2607 
E02000026,2003,Barnet 003,Barnet,E09000003,3954 ,1905 ,2049 
E02000027,2003,Barnet 004,Barnet,E09000003,6145 ,2783 ,3362 
E02000028,2003,Barnet 005,Barnet,E09000003,3711 ,1841 ,1870 
E02000029,2003,Barnet 006,Barnet,E09000003,5276 ,2567 ,2709 
E02000030,2003,Barnet 007,Barnet,E09000003,5720 ,2769 ,2951 
E02000031,2003,Barnet 008,Barnet,E09000003,4398 ,2130 ,2268 
E02000032,2003,Barnet 009,Barnet,E09000003,4729 ,2260 ,2469 
E02000033,2003,Barnet 010,Barnet,E09000003,4857 ,2309 ,2548 
E02000034,2003,Barnet 011,Barnet,E09000003,5158 ,2450 ,2708 
E02000035,2003,Barnet 012,Barnet,E09000003,5248 ,2573 ,2675 
E02000036,2003,Barnet 013,Barnet,E09000003,6370 ,3036 ,3334 
E02000037,2003,Barnet 014,Barnet,E09000003,5833 ,2738 ,3095 
E02000038,2003,Barnet 015,Barnet,E09000003,6196 ,3029 ,3167 
E02000039,2003,Barnet 016,Barnet,E09000003,4117 ,1989 ,2128 
E02000040,2003,Barnet 017,Barnet,E09000003,3855 ,1893 ,1962 
E02000041,2003,Barnet 018,Barnet,E09000003,5057 ,2537 ,2520 
E02000042,2003,Barnet 019,Barnet,E09000003,6507 ,3304 ,3203 
E02000043,2003,Barnet 020,Barnet,E09000003,4757 ,2317 ,2440 
E02000044,2003,Barnet 021,Barnet,E09000003,5139 ,2447 ,2692 
E02000045,2003,Barnet 022,Barnet,E09000003,6507 ,3205 ,3302 
E02000046,2003,Barnet 023,Barnet,E09000003,4535 ,2346 ,2189 
E02000047,2003,Barnet 024,Barnet,E09000003,6154 ,2937 ,3217 
E02000048,2003,Barnet 025,Barnet,E09000003,5400 ,2666 ,2734 
E02000049,2003,Barnet 026,Barnet,E09000003,5008 ,2296 ,2712 
E02000050,2003,Barnet 027,Barnet,E09000003,6179 ,3034 ,3145 
E02000051,2003,Barnet 028,Barnet,E09000003,5307 ,2704 ,2603 
E02000052,2003,Barnet 029,Barnet,E09000003,6149 ,2960 ,3189 
E02000053,2003,Barnet 030,Barnet,E09000003,4822 ,2461 ,2361 
E02000054,2003,Barnet 031,Barnet,E09000003,4368 ,2217 ,2151 
E02000055,2003,Barnet 032,Barnet,E09000003,6491 ,3225 ,3266 
E02000056,2003,Barnet 033,Barnet,E09000003,5539 ,2680 ,2859 
E02000057,2003,Barnet 034,Barnet,E09000003,4050 ,1971 ,2079 
E02000058,2003,Barnet 035,Barnet,E09000003,5998 ,2923 ,3075 
E02000059,2003,Barnet 036,Barnet,E09000003,6388 ,3215 ,3173 
E02000060,2003,Barnet 037,Barnet,E09000003,5719 ,2849 ,2870 
E02000061,2003,Barnet 038,Barnet,E09000003,5066 ,2544 ,2522 
E02000062,2003,Barnet 039,Barnet,E09000003,3957 ,1944 ,2013 
E02000063,2003,Barnet 040,Barnet,E09000003,4282 ,2145 ,2137 
E02000064,2003,Barnet 041,Barnet,E09000003,3888 ,1796 ,2092 
E02000065,2003,Bexley 001,Bexley,E09000004,4483 ,2202 ,2281 
E02000066,2003,Bexley 002,Bexley,E09000004,6173 ,2910 ,3263 
E02000067,2003,Bexley 003,Bexley,E09000004,5148 ,2490 ,2658 
E02000068,2003,Bexley 004,Bexley,E09000004,3933 ,1917 ,2016 
E02000069,2003,Bexley 005,Bexley,E09000004,3740 ,1852 ,1888 
E02000070,2003,Bexley 006,Bexley,E09000004,4896 ,2339 ,2557 
E02000071,2003,Bexley 007,Bexley,E09000004,4823 ,2357 ,2466 
E02000072,2003,Bexley 008,Bexley,E09000004,6836 ,3237 ,3599 
E02000073,2003,Bexley 009,Bexley,E09000004,6528 ,3252 ,3276 
E02000074,2003,Bexley 010,Bexley,E09000004,4650 ,2230 ,2420 
E02000075,2003,Bexley 011,Bexley,E09000004,4768 ,2312 ,2456 
E02000077,2003,Bexley 013,Bexley,E09000004,4815 ,2355 ,2460 
E02000078,2003,Bexley 014,Bexley,E09000004,5111 ,2499 ,2612 
E02000079,2003,Bexley 015,Bexley,E09000004,4770 ,2312 ,2458 
E02000080,2003,Bexley 016,Bexley,E09000004,5664 ,2815 ,2849 
E02000081,2003,Bexley 017,Bexley,E09000004,4687 ,2293 ,2394 
E02000082,2003,Bexley 018,Bexley,E09000004,5630 ,2816 ,2814 
E02000083,2003,Bexley 019,Bexley,E09000004,5772 ,2808 ,2964 
E02000084,2003,Bexley 020,Bexley,E09000004,6705 ,3314 ,3391 
E02000085,2003,Bexley 021,Bexley,E09000004,4828 ,2372 ,2456 
E02000086,2003,Bexley 022,Bexley,E09000004,4857 ,2386 ,2471 
E02000087,2003,Bexley 023,Bexley,E09000004,4498 ,2256 ,2242 
E02000088,2003,Bexley 024,Bexley,E09000004,4803 ,2356 ,2447 
E02000089,2003,Bexley 025,Bexley,E09000004,4744 ,2336 ,2408 
E02000090,2003,Bexley 026,Bexley,E09000004,5001 ,2434 ,2567 
E02000091,2003,Bexley 027,Bexley,E09000004,5671 ,2750 ,2921 
E02000092,2003,Bexley 028,Bexley,E09000004,3601 ,1690 ,1911 
E02006785,2003,Bexley 029,Bexley,E09000004,3827 ,1887 ,1940 
E02000093,2003,Brent 001,Brent,E09000005,6107 ,3055 ,3052 
E02000094,2003,Brent 002,Brent,E09000005,4798 ,2431 ,2367 
E02000095,2003,Brent 003,Brent,E09000005,5752 ,2836 ,2916 
E02000096,2003,Brent 004,Brent,E09000005,4477 ,2263 ,2214 
E02000097,2003,Brent 005,Brent,E09000005,5128 ,2592 ,2536 
E02000098,2003,Brent 006,Brent,E09000005,4415 ,2224 ,2191 
E02000099,2003,Brent 007,Brent,E09000005,4020 ,2022 ,1998 
E02000100,2003,Brent 008,Brent,E09000005,5126 ,2476 ,2650 
E02000101,2003,Brent 009,Brent,E09000005,4738 ,2214 ,2524 
E02000102,2003,Brent 010,Brent,E09000005,4636 ,2377 ,2259 
E02000103,2003,Brent 011,Brent,E09000005,4966 ,2478 ,2488 
E02000104,2003,Brent 012,Brent,E09000005,3879 ,1976 ,1903 
E02000105,2003,Brent 013,Brent,E09000005,4881 ,2511 ,2370 
E02000106,2003,Brent 014,Brent,E09000005,6162 ,3193 ,2969 
E02000107,2003,Brent 015,Brent,E09000005,7587 ,3991 ,3596 
E02000108,2003,Brent 016,Brent,E09000005,3776 ,1952 ,1824 
E02000109,2003,Brent 017,Brent,E09000005,5241 ,2728 ,2513 
E02000110,2003,Brent 018,Brent,E09000005,5400 ,2688 ,2712 
E02000111,2003,Brent 019,Brent,E09000005,5380 ,2779 ,2601 
E02000112,2003,Brent 020,Brent,E09000005,5561 ,2911 ,2650 
E02000113,2003,Brent 021,Brent,E09000005,5514 ,2568 ,2946 
E02000114,2003,Brent 022,Brent,E09000005,6149 ,3150 ,2999 
E02000115,2003,Brent 023,Brent,E09000005,5772 ,2938 ,2834 
E02000116,2003,Brent 024,Brent,E09000005,4855 ,2563 ,2292 
E02000117,2003,Brent 025,Brent,E09000005,7276 ,3517 ,3759 
E02000118,2003,Brent 026,Brent,E09000005,5674 ,3004 ,2670 
E02000119,2003,Brent 027,Brent,E09000005,4563 ,2267 ,2296 
E02000120,2003,Brent 028,Brent,E09000005,6579 ,3318 ,3261 
E02000121,2003,Brent 029,Brent,E09000005,5571 ,2957 ,2614 
E02000122,2003,Brent 030,Brent,E09000005,5550 ,2832 ,2718 
E02000123,2003,Brent 031,Brent,E09000005,8558 ,4354 ,4204 
E02000124,2003,Brent 032,Brent,E09000005,6829 ,3449 ,3380 
E02000125,2003,Brent 033,Brent,E09000005,6798 ,3396 ,3402 
E02000126,2003,Brent 034,Brent,E09000005,4628 ,2281 ,2347 
E02000127,2003,Bromley 001,Bromley,E09000006,5209 ,2432 ,2777 
E02000128,2003,Bromley 002,Bromley,E09000006,4745 ,2292 ,2453 
E02000130,2003,Bromley 004,Bromley,E09000006,5211 ,2491 ,2720 
E02000131,2003,Bromley 005,Bromley,E09000006,6174 ,3030 ,3144 
E02000132,2003,Bromley 006,Bromley,E09000006,5531 ,2768 ,2763 
E02000133,2003,Bromley 007,Bromley,E09000006,5541 ,2745 ,2796 
E02000134,2003,Bromley 008,Bromley,E09000006,6915 ,3431 ,3484 
E02000135,2003,Bromley 009,Bromley,E09000006,6106 ,2888 ,3218 
E02000136,2003,Bromley 010,Bromley,E09000006,3338 ,1613 ,1725 
E02000137,2003,Bromley 011,Bromley,E09000006,4907 ,2406 ,2501 
E02000138,2003,Bromley 012,Bromley,E09000006,4995 ,2531 ,2464 
E02000139,2003,Bromley 013,Bromley,E09000006,4985 ,2423 ,2562 
E02000140,2003,Bromley 014,Bromley,E09000006,4491 ,2129 ,2362 
E02000141,2003,Bromley 015,Bromley,E09000006,5121 ,2552 ,2569 
E02000142,2003,Bromley 016,Bromley,E09000006,5053 ,2509 ,2544 
E02000144,2003,Bromley 018,Bromley,E09000006,5263 ,2644 ,2619 
E02000145,2003,Bromley 019,Bromley,E09000006,4733 ,2216 ,2517 
E02000146,2003,Bromley 020,Bromley,E09000006,4962 ,2425 ,2537 
E02000147,2003,Bromley 021,Bromley,E09000006,4783 ,2393 ,2390 
E02000148,2003,Bromley 022,Bromley,E09000006,3780 ,1878 ,1902 
E02000149,2003,Bromley 023,Bromley,E09000006,4688 ,2286 ,2402 
E02000150,2003,Bromley 024,Bromley,E09000006,4761 ,2341 ,2420 
E02000151,2003,Bromley 025,Bromley,E09000006,4717 ,2286 ,2431 
E02000152,2003,Bromley 026,Bromley,E09000006,3890 ,1843 ,2047 
E02000153,2003,Bromley 027,Bromley,E09000006,4631 ,2236 ,2395 
E02000154,2003,Bromley 028,Bromley,E09000006,4902 ,2465 ,2437 
E02000155,2003,Bromley 029,Bromley,E09000006,4330 ,2099 ,2231 
E02000156,2003,Bromley 030,Bromley,E09000006,7177 ,3528 ,3649 
E02000157,2003,Bromley 031,Bromley,E09000006,4698 ,2297 ,2401 
E02000158,2003,Bromley 032,Bromley,E09000006,4486 ,2132 ,2354 
E02000159,2003,Bromley 033,Bromley,E09000006,3853 ,1880 ,1973 
E02000160,2003,Bromley 034,Bromley,E09000006,4690 ,2354 ,2336 
E02000161,2003,Bromley 035,Bromley,E09000006,5163 ,2516 ,2647 
E02000162,2003,Bromley 036,Bromley,E09000006,3937 ,1893 ,2044 
E02000163,2003,Bromley 037,Bromley,E09000006,4882 ,2393 ,2489 
E02000165,2003,Bromley 039,Bromley,E09000006,4925 ,2444 ,2481 
E02006782,2003,Bromley 040,Bromley,E09000006,4659 ,2226 ,2433 
E02006787,2003,Bromley 041,Bromley,E09000006,4764 ,2327 ,2437 
E02006789,2003,Bromley 042,Bromley,E09000006,3987 ,2000 ,1987 
E02000166,2003,Camden 001,Camden,E09000007,5712 ,2554 ,3158 
E02000167,2003,Camden 002,Camden,E09000007,5114 ,2434 ,2680 
E02000168,2003,Camden 003,Camden,E09000007,5635 ,2782 ,2853 
E02000169,2003,Camden 004,Camden,E09000007,4556 ,2167 ,2389 
E02000170,2003,Camden 005,Camden,E09000007,5887 ,2858 ,3029 
E02000171,2003,Camden 006,Camden,E09000007,5368 ,2597 ,2771 
E02000172,2003,Camden 007,Camden,E09000007,6251 ,3116 ,3135 
E02000173,2003,Camden 008,Camden,E09000007,5293 ,2539 ,2754 
E02000174,2003,Camden 009,Camden,E09000007,6051 ,2995 ,3056 
E02000175,2003,Camden 010,Camden,E09000007,6963 ,3449 ,3514 
E02000176,2003,Camden 011,Camden,E09000007,4574 ,2301 ,2273 
E02000177,2003,Camden 012,Camden,E09000007,5717 ,2799 ,2918 
E02000178,2003,Camden 013,Camden,E09000007,6495 ,3205 ,3290 
E02000179,2003,Camden 014,Camden,E09000007,4299 ,2178 ,2121 
E02000180,2003,Camden 015,Camden,E09000007,5624 ,2896 ,2728 
E02000181,2003,Camden 016,Camden,E09000007,6175 ,3103 ,3072 
E02000182,2003,Camden 017,Camden,E09000007,3891 ,1876 ,2015 
E02000183,2003,Camden 018,Camden,E09000007,5516 ,2736 ,2780 
E02000184,2003,Camden 019,Camden,E09000007,5435 ,2798 ,2637 
E02000185,2003,Camden 020,Camden,E09000007,5561 ,2849 ,2712 
E02000186,2003,Camden 021,Camden,E09000007,4844 ,2714 ,2130 
E02000187,2003,Camden 022,Camden,E09000007,5122 ,2471 ,2651 
E02000188,2003,Camden 023,Camden,E09000007,4741 ,2374 ,2367 
E02000189,2003,Camden 024,Camden,E09000007,4354 ,2234 ,2120 
E02000190,2003,Camden 025,Camden,E09000007,5722 ,2910 ,2812 
E02000191,2003,Camden 026,Camden,E09000007,5802 ,2772 ,3030 
E02000192,2003,Camden 027,Camden,E09000007,4659 ,2537 ,2122 
E02000193,2003,Camden 028,Camden,E09000007,5539 ,2806 ,2733 
E02000194,2003,Croydon 001,Croydon,E09000008,5295 ,2613 ,2682 
E02000195,2003,Croydon 002,Croydon,E09000008,5500 ,2724 ,2776 
E02000196,2003,Croydon 003,Croydon,E09000008,4264 ,2067 ,2197 
E02000197,2003,Croydon 004,Croydon,E09000008,5357 ,2626 ,2731 
E02000198,2003,Croydon 005,Croydon,E09000008,5195 ,2407 ,2788 
E02000199,2003,Croydon 006,Croydon,E09000008,5265 ,2477 ,2788 
E02000200,2003,Croydon 007,Croydon,E09000008,5346 ,2667 ,2679 
E02000201,2003,Croydon 008,Croydon,E09000008,5345 ,2622 ,2723 
E02000202,2003,Croydon 009,Croydon,E09000008,5886 ,2907 ,2979 
E02000203,2003,Croydon 010,Croydon,E09000008,5139 ,2498 ,2641 
E02000204,2003,Croydon 011,Croydon,E09000008,6388 ,3116 ,3272 
E02000206,2003,Croydon 013,Croydon,E09000008,6067 ,2876 ,3191 
E02000207,2003,Croydon 014,Croydon,E09000008,5303 ,2506 ,2797 
E02000208,2003,Croydon 015,Croydon,E09000008,5107 ,2535 ,2572 
E02000209,2003,Croydon 016,Croydon,E09000008,5242 ,2611 ,2631 
E02000210,2003,Croydon 017,Croydon,E09000008,5551 ,2805 ,2746 
E02000211,2003,Croydon 018,Croydon,E09000008,5026 ,2478 ,2548 
E02000212,2003,Croydon 019,Croydon,E09000008,4864 ,2449 ,2415 
E02000213,2003,Croydon 020,Croydon,E09000008,5731 ,2910 ,2821 
E02000214,2003,Croydon 021,Croydon,E09000008,4009 ,2058 ,1951 
E02000215,2003,Croydon 022,Croydon,E09000008,7024 ,3671 ,3353 
E02000216,2003,Croydon 023,Croydon,E09000008,4056 ,2150 ,1906 
E02000217,2003,Croydon 024,Croydon,E09000008,5308 ,2672 ,2636 
E02000218,2003,Croydon 025,Croydon,E09000008,3920 ,1843 ,2077 
E02000219,2003,Croydon 026,Croydon,E09000008,4651 ,2283 ,2368 
E02000220,2003,Croydon 027,Croydon,E09000008,5714 ,3053 ,2661 
E02000221,2003,Croydon 028,Croydon,E09000008,5173 ,2455 ,2718 
E02000222,2003,Croydon 029,Croydon,E09000008,5263 ,2625 ,2638 
E02000223,2003,Croydon 030,Croydon,E09000008,4732 ,2121 ,2611 
E02000224,2003,Croydon 031,Croydon,E09000008,5154 ,2595 ,2559 
E02000225,2003,Croydon 032,Croydon,E09000008,4548 ,2103 ,2445 
E02000226,2003,Croydon 033,Croydon,E09000008,4863 ,2386 ,2477 
E02000227,2003,Croydon 034,Croydon,E09000008,7672 ,3672 ,4000 
E02000228,2003,Croydon 035,Croydon,E09000008,4543 ,2221 ,2322 
E02000229,2003,Croydon 036,Croydon,E09000008,3506 ,1656 ,1850 
E02000230,2003,Croydon 037,Croydon,E09000008,5644 ,2851 ,2793 
E02000231,2003,Croydon 038,Croydon,E09000008,4770 ,2377 ,2393 
E02000232,2003,Croydon 039,Croydon,E09000008,3641 ,1715 ,1926 
E02000233,2003,Croydon 040,Croydon,E09000008,3751 ,1838 ,1913 
E02000234,2003,Croydon 041,Croydon,E09000008,4965 ,2397 ,2568 
E02000235,2003,Croydon 042,Croydon,E09000008,4283 ,2086 ,2197 
E02000236,2003,Croydon 043,Croydon,E09000008,4980 ,2442 ,2538 
E02000237,2003,Croydon 044,Croydon,E09000008,4486 ,2161 ,2325 
E02006788,2003,Croydon 045,Croydon,E09000008,4847 ,2216 ,2631 
E02000238,2003,Ealing 001,Ealing,E09000009,5768 ,2935 ,2833 
E02000239,2003,Ealing 002,Ealing,E09000009,5684 ,2930 ,2754 
E02000240,2003,Ealing 003,Ealing,E09000009,5640 ,2655 ,2985 
E02000241,2003,Ealing 004,Ealing,E09000009,4140 ,2119 ,2021 
E02000242,2003,Ealing 005,Ealing,E09000009,4208 ,2217 ,1991 
E02000243,2003,Ealing 006,Ealing,E09000009,5624 ,2818 ,2806 
E02000244,2003,Ealing 007,Ealing,E09000009,4282 ,2289 ,1993 
E02000245,2003,Ealing 008,Ealing,E09000009,5011 ,2455 ,2556 
E02000246,2003,Ealing 009,Ealing,E09000009,5044 ,2449 ,2595 
E02000247,2003,Ealing 010,Ealing,E09000009,4988 ,2482 ,2506 
E02000248,2003,Ealing 011,Ealing,E09000009,4681 ,2540 ,2141 
E02000249,2003,Ealing 012,Ealing,E09000009,4448 ,2251 ,2197 
E02000250,2003,Ealing 013,Ealing,E09000009,4475 ,2228 ,2247 
E02000251,2003,Ealing 014,Ealing,E09000009,5122 ,2562 ,2560 
E02000252,2003,Ealing 015,Ealing,E09000009,5629 ,2938 ,2691 
E02000253,2003,Ealing 016,Ealing,E09000009,5808 ,2802 ,3006 
E02000254,2003,Ealing 017,Ealing,E09000009,5872 ,3087 ,2785 
E02000255,2003,Ealing 018,Ealing,E09000009,6459 ,3150 ,3309 
E02000256,2003,Ealing 019,Ealing,E09000009,5965 ,3122 ,2843 
E02000257,2003,Ealing 020,Ealing,E09000009,9481 ,4957 ,4524 
E02000258,2003,Ealing 021,Ealing,E09000009,4286 ,2180 ,2106 
E02000259,2003,Ealing 022,Ealing,E09000009,4182 ,2032 ,2150 
E02000260,2003,Ealing 023,Ealing,E09000009,5844 ,3096 ,2748 
E02000261,2003,Ealing 024,Ealing,E09000009,6217 ,3079 ,3138 
E02000262,2003,Ealing 025,Ealing,E09000009,5510 ,2809 ,2701 
E02000263,2003,Ealing 026,Ealing,E09000009,7751 ,4283 ,3468 
E02000264,2003,Ealing 027,Ealing,E09000009,5296 ,2709 ,2587 
E02000265,2003,Ealing 028,Ealing,E09000009,7165 ,3638 ,3527 
E02000266,2003,Ealing 029,Ealing,E09000009,7647 ,3874 ,3773 
E02000267,2003,Ealing 030,Ealing,E09000009,4584 ,2234 ,2350 
E02000268,2003,Ealing 031,Ealing,E09000009,6549 ,3314 ,3235 
E02000269,2003,Ealing 032,Ealing,E09000009,5823 ,2946 ,2877 
E02000270,2003,Ealing 033,Ealing,E09000009,5267 ,2522 ,2745 
E02000271,2003,Ealing 034,Ealing,E09000009,4778 ,2368 ,2410 
E02000272,2003,Ealing 035,Ealing,E09000009,4538 ,2281 ,2257 
E02000274,2003,Ealing 037,Ealing,E09000009,7902 ,4201 ,3701 
E02000275,2003,Ealing 038,Ealing,E09000009,4309 ,2265 ,2044 
E02000276,2003,Ealing 039,Ealing,E09000009,4584 ,2332 ,2252 
E02006791,2003,Ealing 040,Ealing,E09000009,5241 ,2692 ,2549 
E02000277,2003,Enfield 001,Enfield,E09000010,4353 ,2138 ,2215 
E02000278,2003,Enfield 002,Enfield,E09000010,4802 ,2364 ,2438 
E02000279,2003,Enfield 003,Enfield,E09000010,6312 ,3068 ,3244 
E02000280,2003,Enfield 004,Enfield,E09000010,5136 ,2503 ,2633 
E02000281,2003,Enfield 005,Enfield,E09000010,5078 ,2390 ,2688 
E02000282,2003,Enfield 006,Enfield,E09000010,5289 ,2576 ,2713 
E02000283,2003,Enfield 007,Enfield,E09000010,5115 ,2547 ,2568 
E02000284,2003,Enfield 008,Enfield,E09000010,5031 ,2460 ,2571 
E02000285,2003,Enfield 009,Enfield,E09000010,4249 ,2075 ,2174 
E02000286,2003,Enfield 010,Enfield,E09000010,5055 ,2538 ,2517 
E02000287,2003,Enfield 011,Enfield,E09000010,3883 ,1958 ,1925 
E02000288,2003,Enfield 012,Enfield,E09000010,5832 ,2919 ,2913 
E02000289,2003,Enfield 013,Enfield,E09000010,4077 ,2018 ,2059 
E02000290,2003,Enfield 014,Enfield,E09000010,4360 ,2086 ,2274 
E02000291,2003,Enfield 015,Enfield,E09000010,5205 ,2642 ,2563 
E02000292,2003,Enfield 016,Enfield,E09000010,5889 ,2928 ,2961 
E02000293,2003,Enfield 017,Enfield,E09000010,3898 ,1913 ,1985 
E02000294,2003,Enfield 018,Enfield,E09000010,5241 ,2547 ,2694 
E02000295,2003,Enfield 019,Enfield,E09000010,5281 ,2619 ,2662 
E02000296,2003,Enfield 020,Enfield,E09000010,5307 ,2635 ,2672 
E02000297,2003,Enfield 021,Enfield,E09000010,6147 ,3111 ,3036 
E02000298,2003,Enfield 022,Enfield,E09000010,5232 ,2593 ,2639 
E02000299,2003,Enfield 023,Enfield,E09000010,5303 ,2638 ,2665 
E02000300,2003,Enfield 024,Enfield,E09000010,5176 ,2510 ,2666 
E02000301,2003,Enfield 025,Enfield,E09000010,5723 ,2753 ,2970 
E02000302,2003,Enfield 026,Enfield,E09000010,5271 ,2624 ,2647 
E02000303,2003,Enfield 027,Enfield,E09000010,5098 ,2465 ,2633 
E02000304,2003,Enfield 028,Enfield,E09000010,4905 ,2444 ,2461 
E02000305,2003,Enfield 029,Enfield,E09000010,5501 ,2822 ,2679 
E02000306,2003,Enfield 030,Enfield,E09000010,4523 ,2158 ,2365 
E02000307,2003,Enfield 031,Enfield,E09000010,5926 ,2941 ,2985 
E02000308,2003,Enfield 032,Enfield,E09000010,4901 ,2494 ,2407 
E02000309,2003,Enfield 033,Enfield,E09000010,5883 ,2833 ,3050 
E02000311,2003,Enfield 035,Enfield,E09000010,6090 ,3023 ,3067 
E02000312,2003,Enfield 036,Enfield,E09000010,6512 ,3380 ,3132 
E02006793,2003,Enfield 037,Enfield,E09000010,5388 ,2577 ,2811 
E02000313,2003,Greenwich 001,Greenwich,E09000011,4123 ,2036 ,2087 
E02000314,2003,Greenwich 002,Greenwich,E09000011,5872 ,3271 ,2601 
E02000315,2003,Greenwich 003,Greenwich,E09000011,4635 ,2210 ,2425 
E02000316,2003,Greenwich 004,Greenwich,E09000011,4164 ,2203 ,1961 
E02000317,2003,Greenwich 005,Greenwich,E09000011,5231 ,2567 ,2664 
E02000318,2003,Greenwich 006,Greenwich,E09000011,5631 ,2857 ,2774 
E02000319,2003,Greenwich 007,Greenwich,E09000011,5591 ,2766 ,2825 
E02000320,2003,Greenwich 008,Greenwich,E09000011,3981 ,1941 ,2040 
E02000321,2003,Greenwich 009,Greenwich,E09000011,4330 ,2153 ,2177 
E02000323,2003,Greenwich 011,Greenwich,E09000011,6369 ,3146 ,3223 
E02000324,2003,Greenwich 012,Greenwich,E09000011,4275 ,2111 ,2164 
E02000326,2003,Greenwich 014,Greenwich,E09000011,4674 ,2265 ,2409 
E02000327,2003,Greenwich 015,Greenwich,E09000011,3997 ,2059 ,1938 
E02000328,2003,Greenwich 016,Greenwich,E09000011,4236 ,2078 ,2158 
E02000329,2003,Greenwich 017,Greenwich,E09000011,3989 ,1950 ,2039 
E02000331,2003,Greenwich 019,Greenwich,E09000011,4592 ,2238 ,2354 
E02000332,2003,Greenwich 020,Greenwich,E09000011,4792 ,2365 ,2427 
E02000333,2003,Greenwich 021,Greenwich,E09000011,4337 ,2261 ,2076 
E02000334,2003,Greenwich 022,Greenwich,E09000011,3911 ,1959 ,1952 
E02000335,2003,Greenwich 023,Greenwich,E09000011,4077 ,1991 ,2086 
E02000337,2003,Greenwich 025,Greenwich,E09000011,4988 ,2370 ,2618 
E02000339,2003,Greenwich 027,Greenwich,E09000011,3782 ,1901 ,1881 
E02000340,2003,Greenwich 028,Greenwich,E09000011,3744 ,1871 ,1873 
E02000341,2003,Greenwich 029,Greenwich,E09000011,4775 ,2269 ,2506 
E02000342,2003,Greenwich 030,Greenwich,E09000011,3925 ,1770 ,2155 
E02000343,2003,Greenwich 031,Greenwich,E09000011,3965 ,1960 ,2005 
E02000344,2003,Greenwich 032,Greenwich,E09000011,4063 ,1990 ,2073 
E02006786,2003,Greenwich 033,Greenwich,E09000011,4186 ,2016 ,2170 
E02006927,2003,Greenwich 034,Greenwich,E09000011,7534 ,3630 ,3904 
E02006928,2003,Greenwich 035,Greenwich,E09000011,3248 ,1655 ,1593 
E02006929,2003,Greenwich 036,Greenwich,E09000011,3588 ,1795 ,1793 
E02006930,2003,Greenwich 037,Greenwich,E09000011,4439 ,2233 ,2206 
E02006931,2003,Greenwich 038,Greenwich,E09000011,5789 ,2974 ,2815 
E02000345,2003,Hackney 001,Hackney,E09000012,4573 ,2409 ,2164 
E02000346,2003,Hackney 002,Hackney,E09000012,4971 ,2458 ,2513 
E02000347,2003,Hackney 003,Hackney,E09000012,4626 ,2371 ,2255 
E02000348,2003,Hackney 004,Hackney,E09000012,4638 ,2287 ,2351 
E02000350,2003,Hackney 006,Hackney,E09000012,6389 ,3215 ,3174 
E02000351,2003,Hackney 007,Hackney,E09000012,6120 ,3058 ,3062 
E02000352,2003,Hackney 008,Hackney,E09000012,4087 ,1944 ,2143 
E02000353,2003,Hackney 009,Hackney,E09000012,5322 ,2581 ,2741 
E02000354,2003,Hackney 010,Hackney,E09000012,5496 ,2679 ,2817 
E02000355,2003,Hackney 011,Hackney,E09000012,5472 ,2674 ,2798 
E02000356,2003,Hackney 012,Hackney,E09000012,5040 ,2495 ,2545 
E02000357,2003,Hackney 013,Hackney,E09000012,4075 ,1908 ,2167 
E02000358,2003,Hackney 014,Hackney,E09000012,7304 ,3581 ,3723 
E02000359,2003,Hackney 015,Hackney,E09000012,4052 ,1911 ,2141 
E02000360,2003,Hackney 016,Hackney,E09000012,6457 ,3240 ,3217 
E02000361,2003,Hackney 017,Hackney,E09000012,4620 ,2313 ,2307 
E02000362,2003,Hackney 018,Hackney,E09000012,3233 ,1486 ,1747 
E02000363,2003,Hackney 019,Hackney,E09000012,6578 ,3110 ,3468 
E02000364,2003,Hackney 020,Hackney,E09000012,5539 ,2768 ,2771 
E02000365,2003,Hackney 021,Hackney,E09000012,7128 ,3578 ,3550 
E02000366,2003,Hackney 022,Hackney,E09000012,5046 ,2402 ,2644 
E02000367,2003,Hackney 023,Hackney,E09000012,5215 ,2535 ,2680 
E02000368,2003,Hackney 024,Hackney,E09000012,6010 ,2974 ,3036 
E02000369,2003,Hackney 025,Hackney,E09000012,6176 ,3131 ,3045 
E02000370,2003,Hackney 026,Hackney,E09000012,4349 ,2181 ,2168 
E02000371,2003,Hackney 027,Hackney,E09000012,5972 ,3111 ,2861 
E02006918,2003,Hackney 028,Hackney,E09000012,3514 ,1779 ,1735 
E02006921,2003,Hackney 029,Hackney,E09000012,4280 ,2092 ,2188 
E02000372,2003,Hammersmith and Fulham 001,Hammersmith and Fulham,E09000013,5935 ,2955 ,2980 
E02000373,2003,Hammersmith and Fulham 002,Hammersmith and Fulham,E09000013,4191 ,1946 ,2245 
E02000374,2003,Hammersmith and Fulham 003,Hammersmith and Fulham,E09000013,4573 ,2279 ,2294 
E02000375,2003,Hammersmith and Fulham 004,Hammersmith and Fulham,E09000013,5074 ,2695 ,2379 
E02000376,2003,Hammersmith and Fulham 005,Hammersmith and Fulham,E09000013,4933 ,2502 ,2431 
E02000377,2003,Hammersmith and Fulham 006,Hammersmith and Fulham,E09000013,5798 ,2906 ,2892 
E02000378,2003,Hammersmith and Fulham 007,Hammersmith and Fulham,E09000013,5094 ,2516 ,2578 
E02000379,2003,Hammersmith and Fulham 008,Hammersmith and Fulham,E09000013,4492 ,2284 ,2208 
E02000380,2003,Hammersmith and Fulham 009,Hammersmith and Fulham,E09000013,4473 ,2251 ,2222 
E02000381,2003,Hammersmith and Fulham 010,Hammersmith and Fulham,E09000013,6101 ,3023 ,3078 
E02000382,2003,Hammersmith and Fulham 011,Hammersmith and Fulham,E09000013,4294 ,2099 ,2195 
E02000383,2003,Hammersmith and Fulham 012,Hammersmith and Fulham,E09000013,7148 ,3655 ,3493 
E02000384,2003,Hammersmith and Fulham 013,Hammersmith and Fulham,E09000013,5380 ,2687 ,2693 
E02000385,2003,Hammersmith and Fulham 014,Hammersmith and Fulham,E09000013,5258 ,2745 ,2513 
E02000386,2003,Hammersmith and Fulham 015,Hammersmith and Fulham,E09000013,5948 ,3009 ,2939 
E02000387,2003,Hammersmith and Fulham 016,Hammersmith and Fulham,E09000013,4261 ,2115 ,2146 
E02000388,2003,Hammersmith and Fulham 017,Hammersmith and Fulham,E09000013,5754 ,2928 ,2826 
E02000389,2003,Hammersmith and Fulham 018,Hammersmith and Fulham,E09000013,5519 ,2633 ,2886 
E02000390,2003,Hammersmith and Fulham 019,Hammersmith and Fulham,E09000013,4758 ,2387 ,2371 
E02000391,2003,Hammersmith and Fulham 020,Hammersmith and Fulham,E09000013,5263 ,2533 ,2730 
E02000392,2003,Hammersmith and Fulham 021,Hammersmith and Fulham,E09000013,6769 ,3344 ,3425 
E02000393,2003,Hammersmith and Fulham 022,Hammersmith and Fulham,E09000013,4236 ,2120 ,2116 
E02000394,2003,Hammersmith and Fulham 023,Hammersmith and Fulham,E09000013,3754 ,1840 ,1914 
E02000395,2003,Hammersmith and Fulham 024,Hammersmith and Fulham,E09000013,3998 ,1948 ,2050 
E02000396,2003,Hammersmith and Fulham 025,Hammersmith and Fulham,E09000013,4416 ,2082 ,2334 
E02000397,2003,Haringey 001,Haringey,E09000014,4706 ,2345 ,2361 
E02000398,2003,Haringey 002,Haringey,E09000014,4546 ,2254 ,2292 
E02000400,2003,Haringey 004,Haringey,E09000014,4164 ,1999 ,2165 
E02000401,2003,Haringey 005,Haringey,E09000014,3933 ,1896 ,2037 
E02000402,2003,Haringey 006,Haringey,E09000014,4094 ,1896 ,2198 
E02000403,2003,Haringey 007,Haringey,E09000014,4397 ,2262 ,2135 
E02000404,2003,Haringey 008,Haringey,E09000014,4087 ,2024 ,2063 
E02000405,2003,Haringey 009,Haringey,E09000014,4093 ,1974 ,2119 
E02000406,2003,Haringey 010,Haringey,E09000014,4395 ,2127 ,2268 
E02000407,2003,Haringey 011,Haringey,E09000014,4261 ,2135 ,2126 
E02000408,2003,Haringey 012,Haringey,E09000014,4053 ,2023 ,2030 
E02000409,2003,Haringey 013,Haringey,E09000014,4287 ,2163 ,2124 
E02000410,2003,Haringey 014,Haringey,E09000014,4596 ,2302 ,2294 
E02000411,2003,Haringey 015,Haringey,E09000014,4631 ,2307 ,2324 
E02000412,2003,Haringey 016,Haringey,E09000014,4292 ,2175 ,2117 
E02000413,2003,Haringey 017,Haringey,E09000014,4205 ,2035 ,2170 
E02000414,2003,Haringey 018,Haringey,E09000014,4699 ,2377 ,2322 
E02000415,2003,Haringey 019,Haringey,E09000014,4493 ,2398 ,2095 
E02000416,2003,Haringey 020,Haringey,E09000014,4152 ,2047 ,2105 
E02000417,2003,Haringey 021,Haringey,E09000014,4391 ,2202 ,2189 
E02000418,2003,Haringey 022,Haringey,E09000014,3519 ,1661 ,1858 
E02000419,2003,Haringey 023,Haringey,E09000014,5621 ,2950 ,2671 
E02000420,2003,Haringey 024,Haringey,E09000014,4474 ,2212 ,2262 
E02000421,2003,Haringey 025,Haringey,E09000014,4509 ,2202 ,2307 
E02000422,2003,Haringey 026,Haringey,E09000014,4606 ,2332 ,2274 
E02000423,2003,Haringey 027,Haringey,E09000014,4923 ,2744 ,2179 
E02000424,2003,Haringey 028,Haringey,E09000014,4991 ,2510 ,2481 
E02000425,2003,Haringey 029,Haringey,E09000014,3949 ,2044 ,1905 
E02000426,2003,Haringey 030,Haringey,E09000014,4059 ,1994 ,2065 
E02000427,2003,Haringey 031,Haringey,E09000014,5155 ,2788 ,2367 
E02000428,2003,Haringey 032,Haringey,E09000014,4296 ,2179 ,2117 
E02000429,2003,Haringey 033,Haringey,E09000014,4539 ,2240 ,2299 
E02000430,2003,Haringey 034,Haringey,E09000014,4922 ,2467 ,2455 
E02000431,2003,Haringey 035,Haringey,E09000014,4458 ,2172 ,2286 
E02000432,2003,Haringey 036,Haringey,E09000014,4593 ,2350 ,2243 
E02006794,2003,Haringey 037,Haringey,E09000014,4381 ,2211 ,2170 
E02000433,2003,Harrow 001,Harrow,E09000015,3636 ,1726 ,1910 
E02000434,2003,Harrow 002,Harrow,E09000015,4731 ,2337 ,2394 
E02000435,2003,Harrow 003,Harrow,E09000015,4215 ,2031 ,2184 
E02000436,2003,Harrow 004,Harrow,E09000015,3735 ,1808 ,1927 
E02000437,2003,Harrow 005,Harrow,E09000015,4929 ,2412 ,2517 
E02000438,2003,Harrow 006,Harrow,E09000015,4524 ,2160 ,2364 
E02000439,2003,Harrow 007,Harrow,E09000015,4926 ,2558 ,2368 
E02000440,2003,Harrow 008,Harrow,E09000015,5516 ,2687 ,2829 
E02000441,2003,Harrow 009,Harrow,E09000015,4255 ,2037 ,2218 
E02000442,2003,Harrow 010,Harrow,E09000015,5152 ,2643 ,2509 
E02000443,2003,Harrow 011,Harrow,E09000015,5246 ,2669 ,2577 
E02000444,2003,Harrow 012,Harrow,E09000015,4854 ,2390 ,2464 
E02000445,2003,Harrow 013,Harrow,E09000015,5481 ,2737 ,2744 
E02000447,2003,Harrow 015,Harrow,E09000015,4435 ,2179 ,2256 
E02000448,2003,Harrow 016,Harrow,E09000015,3998 ,1961 ,2037 
E02000449,2003,Harrow 017,Harrow,E09000015,4938 ,2417 ,2521 
E02000451,2003,Harrow 019,Harrow,E09000015,4196 ,2134 ,2062 
E02000452,2003,Harrow 020,Harrow,E09000015,4815 ,2444 ,2371 
E02000453,2003,Harrow 021,Harrow,E09000015,4554 ,2324 ,2230 
E02000454,2003,Harrow 022,Harrow,E09000015,4424 ,2191 ,2233 
E02000455,2003,Harrow 023,Harrow,E09000015,4626 ,2282 ,2344 
E02000456,2003,Harrow 024,Harrow,E09000015,4497 ,2207 ,2290 
E02000457,2003,Harrow 025,Harrow,E09000015,4066 ,2081 ,1985 
E02000459,2003,Harrow 027,Harrow,E09000015,4424 ,2287 ,2137 
E02000460,2003,Harrow 028,Harrow,E09000015,4200 ,2104 ,2096 
E02000461,2003,Harrow 029,Harrow,E09000015,4484 ,2392 ,2092 
E02000462,2003,Harrow 030,Harrow,E09000015,4101 ,2084 ,2017 
E02000463,2003,Harrow 031,Harrow,E09000015,5302 ,2583 ,2719 
E02006795,2003,Harrow 032,Harrow,E09000015,5049 ,2561 ,2488 
E02006882,2003,Harrow 033,Harrow,E09000015,9042 ,4532 ,4510 
E02000464,2003,Havering 001,Havering,E09000016,3543 ,1773 ,1770 
E02000465,2003,Havering 002,Havering,E09000016,4610 ,2234 ,2376 
E02000466,2003,Havering 003,Havering,E09000016,4929 ,2326 ,2603 
E02000467,2003,Havering 004,Havering,E09000016,5458 ,2579 ,2879 
E02000468,2003,Havering 005,Havering,E09000016,4856 ,2355 ,2501 
E02000469,2003,Havering 006,Havering,E09000016,3793 ,1831 ,1962 
E02000470,2003,Havering 007,Havering,E09000016,4968 ,2423 ,2545 
E02000471,2003,Havering 008,Havering,E09000016,4590 ,2219 ,2371 
E02000472,2003,Havering 009,Havering,E09000016,5758 ,2875 ,2883 
E02000473,2003,Havering 010,Havering,E09000016,5797 ,2803 ,2994 
E02000474,2003,Havering 011,Havering,E09000016,4815 ,2386 ,2429 
E02000475,2003,Havering 012,Havering,E09000016,5307 ,2619 ,2688 
E02000476,2003,Havering 013,Havering,E09000016,4034 ,2047 ,1987 
E02000477,2003,Havering 014,Havering,E09000016,5879 ,2890 ,2989 
E02000478,2003,Havering 015,Havering,E09000016,3542 ,1754 ,1788 
E02000479,2003,Havering 016,Havering,E09000016,5235 ,2611 ,2624 
E02000480,2003,Havering 017,Havering,E09000016,5852 ,2939 ,2913 
E02000481,2003,Havering 018,Havering,E09000016,4359 ,2126 ,2233 
E02000482,2003,Havering 019,Havering,E09000016,3766 ,1864 ,1902 
E02000483,2003,Havering 020,Havering,E09000016,4610 ,2265 ,2345 
E02000484,2003,Havering 021,Havering,E09000016,5346 ,2637 ,2709 
E02000485,2003,Havering 022,Havering,E09000016,4712 ,2334 ,2378 
E02000486,2003,Havering 023,Havering,E09000016,4842 ,2420 ,2422 
E02000487,2003,Havering 024,Havering,E09000016,5029 ,2486 ,2543 
E02000488,2003,Havering 025,Havering,E09000016,4933 ,2452 ,2481 
E02000489,2003,Havering 026,Havering,E09000016,4632 ,2242 ,2390 
E02000490,2003,Havering 027,Havering,E09000016,4583 ,2215 ,2368 
E02000491,2003,Havering 028,Havering,E09000016,5295 ,2619 ,2676 
E02000492,2003,Havering 029,Havering,E09000016,3947 ,1925 ,2022 
E02000493,2003,Havering 030,Havering,E09000016,3973 ,1908 ,2065 
E02000494,2003,Hillingdon 001,Hillingdon,E09000017,4977 ,2444 ,2533 
E02000495,2003,Hillingdon 002,Hillingdon,E09000017,6112 ,2941 ,3171 
E02000496,2003,Hillingdon 003,Hillingdon,E09000017,4720 ,2307 ,2413 
E02000497,2003,Hillingdon 004,Hillingdon,E09000017,5064 ,2407 ,2657 
E02000498,2003,Hillingdon 005,Hillingdon,E09000017,3801 ,1826 ,1975 
E02000499,2003,Hillingdon 006,Hillingdon,E09000017,4738 ,2299 ,2439 
E02000500,2003,Hillingdon 007,Hillingdon,E09000017,4567 ,2278 ,2289 
E02000501,2003,Hillingdon 008,Hillingdon,E09000017,5228 ,2531 ,2697 
E02000502,2003,Hillingdon 009,Hillingdon,E09000017,4680 ,2332 ,2348 
E02000503,2003,Hillingdon 010,Hillingdon,E09000017,5370 ,2740 ,2630 
E02000504,2003,Hillingdon 011,Hillingdon,E09000017,4500 ,2252 ,2248 
E02000506,2003,Hillingdon 013,Hillingdon,E09000017,4594 ,2243 ,2351 
E02000507,2003,Hillingdon 014,Hillingdon,E09000017,5015 ,2503 ,2512 
E02000508,2003,Hillingdon 015,Hillingdon,E09000017,5355 ,2795 ,2560 
E02000509,2003,Hillingdon 016,Hillingdon,E09000017,5964 ,3130 ,2834 
E02000510,2003,Hillingdon 017,Hillingdon,E09000017,5086 ,2516 ,2570 
E02000511,2003,Hillingdon 018,Hillingdon,E09000017,5602 ,2780 ,2822 
E02000512,2003,Hillingdon 019,Hillingdon,E09000017,4758 ,2292 ,2466 
E02000513,2003,Hillingdon 020,Hillingdon,E09000017,5229 ,2523 ,2706 
E02000514,2003,Hillingdon 021,Hillingdon,E09000017,6014 ,3012 ,3002 
E02000515,2003,Hillingdon 022,Hillingdon,E09000017,6201 ,3068 ,3133 
E02000516,2003,Hillingdon 023,Hillingdon,E09000017,5222 ,2584 ,2638 
E02000517,2003,Hillingdon 024,Hillingdon,E09000017,5024 ,2494 ,2530 
E02000518,2003,Hillingdon 025,Hillingdon,E09000017,5291 ,2569 ,2722 
E02000519,2003,Hillingdon 026,Hillingdon,E09000017,4906 ,2412 ,2494 
E02000520,2003,Hillingdon 027,Hillingdon,E09000017,6113 ,3113 ,3000 
E02000521,2003,Hillingdon 028,Hillingdon,E09000017,4938 ,2437 ,2501 
E02000522,2003,Hillingdon 029,Hillingdon,E09000017,4970 ,2462 ,2508 
E02000523,2003,Hillingdon 030,Hillingdon,E09000017,5476 ,2822 ,2654 
E02000524,2003,Hillingdon 031,Hillingdon,E09000017,4321 ,2291 ,2030 
E02000525,2003,Hillingdon 032,Hillingdon,E09000017,5229 ,2613 ,2616 
E02006796,2003,Hillingdon 033,Hillingdon,E09000017,5324 ,2625 ,2699 
E02000526,2003,Hounslow 001,Hounslow,E09000018,5892 ,2882 ,3010 
E02000528,2003,Hounslow 003,Hounslow,E09000018,5806 ,2817 ,2989 
E02000529,2003,Hounslow 004,Hounslow,E09000018,5199 ,2610 ,2589 
E02000530,2003,Hounslow 005,Hounslow,E09000018,4103 ,2059 ,2044 
E02000531,2003,Hounslow 006,Hounslow,E09000018,5656 ,2772 ,2884 
E02000532,2003,Hounslow 007,Hounslow,E09000018,6219 ,3088 ,3131 
E02000533,2003,Hounslow 008,Hounslow,E09000018,5868 ,3005 ,2863 
E02000534,2003,Hounslow 009,Hounslow,E09000018,4299 ,2206 ,2093 
E02000535,2003,Hounslow 010,Hounslow,E09000018,5509 ,2861 ,2648 
E02000536,2003,Hounslow 011,Hounslow,E09000018,5797 ,2924 ,2873 
E02000537,2003,Hounslow 012,Hounslow,E09000018,5742 ,3067 ,2675 
E02000538,2003,Hounslow 013,Hounslow,E09000018,5421 ,2941 ,2480 
E02000539,2003,Hounslow 014,Hounslow,E09000018,5684 ,2777 ,2907 
E02000540,2003,Hounslow 015,Hounslow,E09000018,5512 ,2838 ,2674 
E02000541,2003,Hounslow 016,Hounslow,E09000018,5165 ,2696 ,2469 
E02000542,2003,Hounslow 017,Hounslow,E09000018,5292 ,2780 ,2512 
E02000543,2003,Hounslow 018,Hounslow,E09000018,5746 ,3035 ,2711 
E02000544,2003,Hounslow 019,Hounslow,E09000018,5007 ,2522 ,2485 
E02000545,2003,Hounslow 020,Hounslow,E09000018,5360 ,2558 ,2802 
E02000546,2003,Hounslow 021,Hounslow,E09000018,5796 ,3081 ,2715 
E02000547,2003,Hounslow 022,Hounslow,E09000018,5266 ,2677 ,2589 
E02000548,2003,Hounslow 023,Hounslow,E09000018,4660 ,2338 ,2322 
E02000549,2003,Hounslow 024,Hounslow,E09000018,6293 ,3194 ,3099 
E02000550,2003,Hounslow 025,Hounslow,E09000018,5050 ,2466 ,2584 
E02000551,2003,Hounslow 026,Hounslow,E09000018,4970 ,2392 ,2578 
E02000552,2003,Hounslow 027,Hounslow,E09000018,4715 ,2533 ,2182 
E02000553,2003,Hounslow 028,Hounslow,E09000018,4143 ,2082 ,2061 
E02006792,2003,Hounslow 029,Hounslow,E09000018,5854 ,3005 ,2849 
E02000554,2003,Islington 001,Islington,E09000019,6752 ,3233 ,3519 
E02000555,2003,Islington 002,Islington,E09000019,6467 ,3061 ,3406 
E02000556,2003,Islington 003,Islington,E09000019,7112 ,3412 ,3700 
E02000557,2003,Islington 004,Islington,E09000019,5808 ,2799 ,3009 
E02000558,2003,Islington 005,Islington,E09000019,5467 ,2678 ,2789 
E02000559,2003,Islington 006,Islington,E09000019,5562 ,2780 ,2782 
E02000560,2003,Islington 007,Islington,E09000019,5294 ,2649 ,2645 
E02000561,2003,Islington 008,Islington,E09000019,4989 ,2443 ,2546 
E02000562,2003,Islington 009,Islington,E09000019,5302 ,2599 ,2703 
E02000563,2003,Islington 010,Islington,E09000019,5771 ,2688 ,3083 
E02000564,2003,Islington 011,Islington,E09000019,4984 ,2449 ,2535 
E02000565,2003,Islington 012,Islington,E09000019,5152 ,2517 ,2635 
E02000566,2003,Islington 013,Islington,E09000019,5433 ,2691 ,2742 
E02000567,2003,Islington 014,Islington,E09000019,6832 ,3412 ,3420 
E02000568,2003,Islington 015,Islington,E09000019,5544 ,2943 ,2601 
E02000569,2003,Islington 016,Islington,E09000019,6371 ,3053 ,3318 
E02000570,2003,Islington 017,Islington,E09000019,5886 ,2926 ,2960 
E02000571,2003,Islington 018,Islington,E09000019,5346 ,2624 ,2722 
E02000572,2003,Islington 019,Islington,E09000019,5248 ,2560 ,2688 
E02000573,2003,Islington 020,Islington,E09000019,5709 ,2922 ,2787 
E02000574,2003,Islington 021,Islington,E09000019,5787 ,2894 ,2893 
E02000575,2003,Islington 022,Islington,E09000019,6922 ,3619 ,3303 
E02000576,2003,Islington 023,Islington,E09000019,5074 ,2527 ,2547 
E02000577,2003,Kensington and Chelsea 001,Kensington and Chelsea,E09000020,4983 ,2457 ,2526 
E02000578,2003,Kensington and Chelsea 002,Kensington and Chelsea,E09000020,3997 ,1907 ,2090 
E02000579,2003,Kensington and Chelsea 003,Kensington and Chelsea,E09000020,5384 ,2539 ,2845 
E02000580,2003,Kensington and Chelsea 004,Kensington and Chelsea,E09000020,6178 ,3047 ,3131 
E02000581,2003,Kensington and Chelsea 005,Kensington and Chelsea,E09000020,5008 ,2385 ,2623 
E02000582,2003,Kensington and Chelsea 006,Kensington and Chelsea,E09000020,6533 ,3225 ,3308 
E02000583,2003,Kensington and Chelsea 007,Kensington and Chelsea,E09000020,5672 ,2713 ,2959 
E02000584,2003,Kensington and Chelsea 008,Kensington and Chelsea,E09000020,6200 ,3109 ,3091 
E02000585,2003,Kensington and Chelsea 009,Kensington and Chelsea,E09000020,6615 ,3186 ,3429 
E02000586,2003,Kensington and Chelsea 010,Kensington and Chelsea,E09000020,6303 ,3139 ,3164 
E02000587,2003,Kensington and Chelsea 011,Kensington and Chelsea,E09000020,5558 ,2766 ,2792 
E02000588,2003,Kensington and Chelsea 012,Kensington and Chelsea,E09000020,6104 ,2929 ,3175 
E02000589,2003,Kensington and Chelsea 013,Kensington and Chelsea,E09000020,7115 ,3891 ,3224 
E02000590,2003,Kensington and Chelsea 014,Kensington and Chelsea,E09000020,5522 ,2604 ,2918 
E02000591,2003,Kensington and Chelsea 015,Kensington and Chelsea,E09000020,5423 ,2920 ,2503 
E02000592,2003,Kensington and Chelsea 016,Kensington and Chelsea,E09000020,5992 ,3016 ,2976 
E02000593,2003,Kensington and Chelsea 017,Kensington and Chelsea,E09000020,6385 ,3363 ,3022 
E02000594,2003,Kensington and Chelsea 018,Kensington and Chelsea,E09000020,5224 ,2504 ,2720 
E02000595,2003,Kensington and Chelsea 019,Kensington and Chelsea,E09000020,5473 ,2609 ,2864 
E02000596,2003,Kensington and Chelsea 020,Kensington and Chelsea,E09000020,6041 ,2992 ,3049 
E02000597,2003,Kensington and Chelsea 021,Kensington and Chelsea,E09000020,5748 ,2771 ,2977 
E02000598,2003,Kingston upon Thames 001,Kingston upon Thames,E09000021,4612 ,2228 ,2384 
E02000599,2003,Kingston upon Thames 002,Kingston upon Thames,E09000021,4855 ,2445 ,2410 
E02000600,2003,Kingston upon Thames 003,Kingston upon Thames,E09000021,5633 ,2844 ,2789 
E02000601,2003,Kingston upon Thames 004,Kingston upon Thames,E09000021,5755 ,2840 ,2915 
E02000602,2003,Kingston upon Thames 005,Kingston upon Thames,E09000021,5564 ,2902 ,2662 
E02000603,2003,Kingston upon Thames 006,Kingston upon Thames,E09000021,5029 ,2484 ,2545 
E02000604,2003,Kingston upon Thames 007,Kingston upon Thames,E09000021,5510 ,2837 ,2673 
E02000605,2003,Kingston upon Thames 008,Kingston upon Thames,E09000021,5255 ,2688 ,2567 
E02000606,2003,Kingston upon Thames 009,Kingston upon Thames,E09000021,6275 ,3358 ,2917 
E02000607,2003,Kingston upon Thames 010,Kingston upon Thames,E09000021,4646 ,2372 ,2274 
E02000608,2003,Kingston upon Thames 011,Kingston upon Thames,E09000021,5415 ,2840 ,2575 
E02000609,2003,Kingston upon Thames 012,Kingston upon Thames,E09000021,4694 ,2355 ,2339 
E02000610,2003,Kingston upon Thames 013,Kingston upon Thames,E09000021,5558 ,2868 ,2690 
E02000611,2003,Kingston upon Thames 014,Kingston upon Thames,E09000021,4915 ,2470 ,2445 
E02000612,2003,Kingston upon Thames 015,Kingston upon Thames,E09000021,5053 ,2518 ,2535 
E02000613,2003,Kingston upon Thames 016,Kingston upon Thames,E09000021,5153 ,2572 ,2581 
E02000614,2003,Kingston upon Thames 017,Kingston upon Thames,E09000021,5692 ,2904 ,2788 
E02000615,2003,Kingston upon Thames 018,Kingston upon Thames,E09000021,4871 ,2479 ,2392 
E02000616,2003,Kingston upon Thames 019,Kingston upon Thames,E09000021,4051 ,2028 ,2023 
E02000617,2003,Kingston upon Thames 020,Kingston upon Thames,E09000021,5189 ,2499 ,2690 
E02000619,2003,Lambeth 002,Lambeth,E09000022,5347 ,2780 ,2567 
E02000620,2003,Lambeth 003,Lambeth,E09000022,5450 ,2793 ,2657 
E02000621,2003,Lambeth 004,Lambeth,E09000022,6206 ,3386 ,2820 
E02000622,2003,Lambeth 005,Lambeth,E09000022,5617 ,2992 ,2625 
E02000623,2003,Lambeth 006,Lambeth,E09000022,5315 ,2785 ,2530 
E02000624,2003,Lambeth 007,Lambeth,E09000022,5514 ,2754 ,2760 
E02000625,2003,Lambeth 008,Lambeth,E09000022,5686 ,2891 ,2795 
E02000626,2003,Lambeth 009,Lambeth,E09000022,5627 ,2781 ,2846 
E02000627,2003,Lambeth 010,Lambeth,E09000022,6348 ,3386 ,2962 
E02000628,2003,Lambeth 011,Lambeth,E09000022,6563 ,3353 ,3210 
E02000629,2003,Lambeth 012,Lambeth,E09000022,6175 ,3264 ,2911 
E02000630,2003,Lambeth 013,Lambeth,E09000022,4956 ,2498 ,2458 
E02000631,2003,Lambeth 014,Lambeth,E09000022,6162 ,3105 ,3057 
E02000632,2003,Lambeth 015,Lambeth,E09000022,7045 ,3710 ,3335 
E02000633,2003,Lambeth 016,Lambeth,E09000022,5736 ,3039 ,2697 
E02000634,2003,Lambeth 017,Lambeth,E09000022,4721 ,2454 ,2267 
E02000635,2003,Lambeth 018,Lambeth,E09000022,6269 ,3224 ,3045 
E02000636,2003,Lambeth 019,Lambeth,E09000022,5177 ,2730 ,2447 
E02000637,2003,Lambeth 020,Lambeth,E09000022,6349 ,3380 ,2969 
E02000638,2003,Lambeth 021,Lambeth,E09000022,5840 ,3050 ,2790 
E02000639,2003,Lambeth 022,Lambeth,E09000022,5594 ,2714 ,2880 
E02000640,2003,Lambeth 023,Lambeth,E09000022,6176 ,3240 ,2936 
E02000641,2003,Lambeth 024,Lambeth,E09000022,5561 ,2692 ,2869 
E02000642,2003,Lambeth 025,Lambeth,E09000022,6299 ,3089 ,3210 
E02000643,2003,Lambeth 026,Lambeth,E09000022,5537 ,2867 ,2670 
E02000644,2003,Lambeth 027,Lambeth,E09000022,5461 ,2793 ,2668 
E02000645,2003,Lambeth 028,Lambeth,E09000022,5525 ,2791 ,2734 
E02000646,2003,Lambeth 029,Lambeth,E09000022,5519 ,2863 ,2656 
E02000647,2003,Lambeth 030,Lambeth,E09000022,5163 ,2596 ,2567 
E02000648,2003,Lambeth 031,Lambeth,E09000022,4396 ,2087 ,2309 
E02000649,2003,Lambeth 032,Lambeth,E09000022,6522 ,3335 ,3187 
E02000650,2003,Lambeth 033,Lambeth,E09000022,5067 ,2417 ,2650 
E02000651,2003,Lambeth 034,Lambeth,E09000022,5248 ,2707 ,2541 
E02000652,2003,Lambeth 035,Lambeth,E09000022,4239 ,2079 ,2160 
E02006801,2003,Lambeth 036,Lambeth,E09000022,5858 ,3063 ,2795 
E02000653,2003,Lewisham 001,Lewisham,E09000023,4828 ,2463 ,2365 
E02000654,2003,Lewisham 002,Lewisham,E09000023,4764 ,2257 ,2507 
E02000655,2003,Lewisham 003,Lewisham,E09000023,4855 ,2501 ,2354 
E02000657,2003,Lewisham 005,Lewisham,E09000023,6189 ,3017 ,3172 
E02000658,2003,Lewisham 006,Lewisham,E09000023,5385 ,2687 ,2698 
E02000659,2003,Lewisham 007,Lewisham,E09000023,5282 ,2678 ,2604 
E02000660,2003,Lewisham 008,Lewisham,E09000023,5073 ,2619 ,2454 
E02000661,2003,Lewisham 009,Lewisham,E09000023,4259 ,2216 ,2043 
E02000662,2003,Lewisham 010,Lewisham,E09000023,5429 ,2763 ,2666 
E02000663,2003,Lewisham 011,Lewisham,E09000023,5097 ,2579 ,2518 
E02000664,2003,Lewisham 012,Lewisham,E09000023,5866 ,3043 ,2823 
E02000665,2003,Lewisham 013,Lewisham,E09000023,4932 ,2476 ,2456 
E02000666,2003,Lewisham 014,Lewisham,E09000023,5041 ,2521 ,2520 
E02000667,2003,Lewisham 015,Lewisham,E09000023,4515 ,2248 ,2267 
E02000668,2003,Lewisham 016,Lewisham,E09000023,4190 ,2095 ,2095 
E02000669,2003,Lewisham 017,Lewisham,E09000023,4510 ,2364 ,2146 
E02000670,2003,Lewisham 018,Lewisham,E09000023,4001 ,1980 ,2021 
E02000671,2003,Lewisham 019,Lewisham,E09000023,5422 ,2763 ,2659 
E02000672,2003,Lewisham 020,Lewisham,E09000023,4920 ,2494 ,2426 
E02000673,2003,Lewisham 021,Lewisham,E09000023,5212 ,2684 ,2528 
E02000674,2003,Lewisham 022,Lewisham,E09000023,5184 ,2537 ,2647 
E02000675,2003,Lewisham 023,Lewisham,E09000023,5228 ,2636 ,2592 
E02000676,2003,Lewisham 024,Lewisham,E09000023,5050 ,2529 ,2521 
E02000677,2003,Lewisham 025,Lewisham,E09000023,4501 ,2260 ,2241 
E02000678,2003,Lewisham 026,Lewisham,E09000023,3717 ,1798 ,1919 
E02000679,2003,Lewisham 027,Lewisham,E09000023,5081 ,2498 ,2583 
E02000680,2003,Lewisham 028,Lewisham,E09000023,4287 ,2146 ,2141 
E02000681,2003,Lewisham 029,Lewisham,E09000023,5038 ,2432 ,2606 
E02000682,2003,Lewisham 030,Lewisham,E09000023,4685 ,2281 ,2404 
E02000683,2003,Lewisham 031,Lewisham,E09000023,4077 ,1995 ,2082 
E02000685,2003,Lewisham 033,Lewisham,E09000023,5016 ,2354 ,2662 
E02000686,2003,Lewisham 034,Lewisham,E09000023,4185 ,1953 ,2232 
E02000687,2003,Lewisham 035,Lewisham,E09000023,5059 ,2508 ,2551 
E02006783,2003,Lewisham 037,Lewisham,E09000023,4397 ,2113 ,2284 
E02006784,2003,Lewisham 038,Lewisham,E09000023,4249 ,2156 ,2093 
E02006798,2003,Lewisham 039,Lewisham,E09000023,5277 ,2633 ,2644 
E02000689,2003,Merton 001,Merton,E09000024,5059 ,2568 ,2491 
E02000690,2003,Merton 002,Merton,E09000024,3605 ,1795 ,1810 
E02000691,2003,Merton 003,Merton,E09000024,5360 ,2789 ,2571 
E02000692,2003,Merton 004,Merton,E09000024,5500 ,2938 ,2562 
E02000693,2003,Merton 005,Merton,E09000024,6178 ,3116 ,3062 
E02000694,2003,Merton 006,Merton,E09000024,6288 ,3169 ,3119 
E02000695,2003,Merton 007,Merton,E09000024,5794 ,3023 ,2771 
E02000696,2003,Merton 008,Merton,E09000024,5626 ,2845 ,2781 
E02000697,2003,Merton 009,Merton,E09000024,6343 ,3252 ,3091 
E02000698,2003,Merton 010,Merton,E09000024,5241 ,2577 ,2664 
E02000699,2003,Merton 011,Merton,E09000024,5552 ,2853 ,2699 
E02000700,2003,Merton 012,Merton,E09000024,5685 ,2827 ,2858 
E02000701,2003,Merton 013,Merton,E09000024,4868 ,2466 ,2402 
E02000702,2003,Merton 014,Merton,E09000024,4859 ,2348 ,2511 
E02000703,2003,Merton 015,Merton,E09000024,5160 ,2641 ,2519 
E02000704,2003,Merton 016,Merton,E09000024,5319 ,2696 ,2623 
E02000705,2003,Merton 017,Merton,E09000024,5118 ,2523 ,2595 
E02000706,2003,Merton 018,Merton,E09000024,4866 ,2394 ,2472 
E02000707,2003,Merton 019,Merton,E09000024,4704 ,2343 ,2361 
E02000708,2003,Merton 020,Merton,E09000024,5478 ,2758 ,2720 
E02000709,2003,Merton 021,Merton,E09000024,4993 ,2531 ,2462 
E02000710,2003,Merton 022,Merton,E09000024,4906 ,2397 ,2509 
E02000711,2003,Merton 023,Merton,E09000024,4957 ,2513 ,2444 
E02000712,2003,Merton 024,Merton,E09000024,4654 ,2278 ,2376 
E02000713,2003,Merton 025,Merton,E09000024,4507 ,2233 ,2274 
E02000714,2003,Newham 001,Newham,E09000025,4472 ,2277 ,2195 
E02000715,2003,Newham 002,Newham,E09000025,4037 ,2066 ,1971 
E02000716,2003,Newham 003,Newham,E09000025,4085 ,2094 ,1991 
E02000717,2003,Newham 004,Newham,E09000025,4454 ,2351 ,2103 
E02000718,2003,Newham 005,Newham,E09000025,3779 ,1839 ,1940 
E02000719,2003,Newham 006,Newham,E09000025,4577 ,2356 ,2221 
E02000720,2003,Newham 007,Newham,E09000025,4364 ,2351 ,2013 
E02000721,2003,Newham 008,Newham,E09000025,5415 ,2853 ,2562 
E02000722,2003,Newham 009,Newham,E09000025,4738 ,2463 ,2275 
E02000723,2003,Newham 010,Newham,E09000025,6097 ,3371 ,2726 
E02000724,2003,Newham 011,Newham,E09000025,5322 ,2954 ,2368 
E02000725,2003,Newham 012,Newham,E09000025,4631 ,2348 ,2283 
E02000726,2003,Newham 013,Newham,E09000025,4826 ,2475 ,2351 
E02000727,2003,Newham 014,Newham,E09000025,4517 ,2467 ,2050 
E02000728,2003,Newham 015,Newham,E09000025,6159 ,3594 ,2565 
E02000729,2003,Newham 016,Newham,E09000025,4201 ,2248 ,1953 
E02000730,2003,Newham 017,Newham,E09000025,5370 ,2837 ,2533 
E02000731,2003,Newham 018,Newham,E09000025,5506 ,3094 ,2412 
E02000732,2003,Newham 019,Newham,E09000025,4012 ,2100 ,1912 
E02000733,2003,Newham 020,Newham,E09000025,5793 ,2871 ,2922 
E02000734,2003,Newham 021,Newham,E09000025,3985 ,1979 ,2006 
E02000735,2003,Newham 022,Newham,E09000025,4095 ,2177 ,1918 
E02000736,2003,Newham 023,Newham,E09000025,4735 ,2445 ,2290 
E02000737,2003,Newham 024,Newham,E09000025,5092 ,2621 ,2471 
E02000738,2003,Newham 025,Newham,E09000025,4375 ,2227 ,2148 
E02000739,2003,Newham 026,Newham,E09000025,3987 ,2048 ,1939 
E02000740,2003,Newham 027,Newham,E09000025,4191 ,1991 ,2200 
E02000741,2003,Newham 028,Newham,E09000025,4478 ,2193 ,2285 
E02000742,2003,Newham 029,Newham,E09000025,4188 ,2125 ,2063 
E02000743,2003,Newham 030,Newham,E09000025,4174 ,2057 ,2117 
E02000744,2003,Newham 031,Newham,E09000025,4202 ,2086 ,2116 
E02000745,2003,Newham 032,Newham,E09000025,5287 ,2637 ,2650 
E02000746,2003,Newham 033,Newham,E09000025,3879 ,1876 ,2003 
E02000747,2003,Newham 034,Newham,E09000025,5546 ,2675 ,2871 
E02000748,2003,Newham 035,Newham,E09000025,4209 ,2128 ,2081 
E02000749,2003,Newham 036,Newham,E09000025,4911 ,2345 ,2566 
E02000750,2003,Newham 037,Newham,E09000025,5090 ,2629 ,2461 
E02000751,2003,Redbridge 001,Redbridge,E09000026,6497 ,3197 ,3300 
E02000752,2003,Redbridge 002,Redbridge,E09000026,3586 ,1750 ,1836 
E02000753,2003,Redbridge 003,Redbridge,E09000026,3561 ,1692 ,1869 
E02000754,2003,Redbridge 004,Redbridge,E09000026,4220 ,2023 ,2197 
E02000755,2003,Redbridge 005,Redbridge,E09000026,3426 ,1658 ,1768 
E02000756,2003,Redbridge 006,Redbridge,E09000026,7335 ,3518 ,3817 
E02000757,2003,Redbridge 007,Redbridge,E09000026,7228 ,3660 ,3568 
E02000758,2003,Redbridge 008,Redbridge,E09000026,3670 ,1826 ,1844 
E02000759,2003,Redbridge 009,Redbridge,E09000026,7515 ,3752 ,3763 
E02000760,2003,Redbridge 010,Redbridge,E09000026,3662 ,1778 ,1884 
E02000762,2003,Redbridge 012,Redbridge,E09000026,3670 ,1853 ,1817 
E02000763,2003,Redbridge 013,Redbridge,E09000026,3976 ,1941 ,2035 
E02000764,2003,Redbridge 014,Redbridge,E09000026,7347 ,3632 ,3715 
E02000765,2003,Redbridge 015,Redbridge,E09000026,3787 ,1909 ,1878 
E02000767,2003,Redbridge 017,Redbridge,E09000026,3948 ,1960 ,1988 
E02000768,2003,Redbridge 018,Redbridge,E09000026,3784 ,1893 ,1891 
E02000769,2003,Redbridge 019,Redbridge,E09000026,7223 ,3521 ,3702 
E02000770,2003,Redbridge 020,Redbridge,E09000026,4421 ,2205 ,2216 
E02000772,2003,Redbridge 022,Redbridge,E09000026,4114 ,2064 ,2050 
E02000773,2003,Redbridge 023,Redbridge,E09000026,4838 ,2446 ,2392 
E02000774,2003,Redbridge 024,Redbridge,E09000026,4569 ,2338 ,2231 
E02000776,2003,Redbridge 026,Redbridge,E09000026,4013 ,2066 ,1947 
E02000777,2003,Redbridge 027,Redbridge,E09000026,3876 ,1927 ,1949 
E02000779,2003,Redbridge 029,Redbridge,E09000026,4747 ,2537 ,2210 
E02000780,2003,Redbridge 030,Redbridge,E09000026,7866 ,4093 ,3773 
E02000781,2003,Redbridge 031,Redbridge,E09000026,7520 ,3867 ,3653 
E02000782,2003,Redbridge 032,Redbridge,E09000026,5152 ,2663 ,2489 
E02000783,2003,Redbridge 033,Redbridge,E09000026,3931 ,1966 ,1965 
E02006800,2003,Redbridge 034,Redbridge,E09000026,7933 ,4020 ,3913 
E02006924,2003,Redbridge 035,Redbridge,E09000026,8160 ,4197 ,3963 
E02006925,2003,Redbridge 036,Redbridge,E09000026,7876 ,3933 ,3943 
E02000784,2003,Richmond upon Thames 001,Richmond upon Thames,E09000027,6981 ,3475 ,3506 
E02000785,2003,Richmond upon Thames 002,Richmond upon Thames,E09000027,6665 ,3319 ,3346 
E02000786,2003,Richmond upon Thames 003,Richmond upon Thames,E09000027,7423 ,3698 ,3725 
E02000787,2003,Richmond upon Thames 004,Richmond upon Thames,E09000027,6208 ,3177 ,3031 
E02000788,2003,Richmond upon Thames 005,Richmond upon Thames,E09000027,5701 ,2798 ,2903 
E02000789,2003,Richmond upon Thames 006,Richmond upon Thames,E09000027,4433 ,2295 ,2138 
E02000790,2003,Richmond upon Thames 007,Richmond upon Thames,E09000027,4103 ,2041 ,2062 
E02000791,2003,Richmond upon Thames 008,Richmond upon Thames,E09000027,4589 ,2391 ,2198 
E02000792,2003,Richmond upon Thames 009,Richmond upon Thames,E09000027,4940 ,2499 ,2441 
E02000793,2003,Richmond upon Thames 010,Richmond upon Thames,E09000027,5066 ,2563 ,2503 
E02000794,2003,Richmond upon Thames 011,Richmond upon Thames,E09000027,4131 ,2033 ,2098 
E02000795,2003,Richmond upon Thames 012,Richmond upon Thames,E09000027,4212 ,2168 ,2044 
E02000796,2003,Richmond upon Thames 013,Richmond upon Thames,E09000027,6292 ,3151 ,3141 
E02000797,2003,Richmond upon Thames 014,Richmond upon Thames,E09000027,4806 ,2431 ,2375 
E02000798,2003,Richmond upon Thames 015,Richmond upon Thames,E09000027,7138 ,3517 ,3621 
E02000799,2003,Richmond upon Thames 016,Richmond upon Thames,E09000027,4273 ,2085 ,2188 
E02000800,2003,Richmond upon Thames 017,Richmond upon Thames,E09000027,3400 ,1688 ,1712 
E02000801,2003,Richmond upon Thames 018,Richmond upon Thames,E09000027,4574 ,2229 ,2345 
E02000802,2003,Richmond upon Thames 019,Richmond upon Thames,E09000027,4155 ,2063 ,2092 
E02000803,2003,Richmond upon Thames 020,Richmond upon Thames,E09000027,6068 ,2967 ,3101 
E02000804,2003,Richmond upon Thames 021,Richmond upon Thames,E09000027,4627 ,2282 ,2345 
E02000805,2003,Richmond upon Thames 022,Richmond upon Thames,E09000027,6193 ,3034 ,3159 
E02000806,2003,Richmond upon Thames 023,Richmond upon Thames,E09000027,6140 ,3036 ,3104 
E02000807,2003,Southwark 001,Southwark,E09000028,5807 ,3176 ,2631 
E02000808,2003,Southwark 002,Southwark,E09000028,5923 ,3131 ,2792 
E02000809,2003,Southwark 003,Southwark,E09000028,7085 ,4052 ,3033 
E02000810,2003,Southwark 004,Southwark,E09000028,5199 ,2728 ,2471 
E02000812,2003,Southwark 006,Southwark,E09000028,6210 ,3297 ,2913 
E02000813,2003,Southwark 007,Southwark,E09000028,5158 ,2724 ,2434 
E02000814,2003,Southwark 008,Southwark,E09000028,5742 ,3230 ,2512 
E02000815,2003,Southwark 009,Southwark,E09000028,6319 ,3426 ,2893 
E02000816,2003,Southwark 010,Southwark,E09000028,5266 ,2617 ,2649 
E02000817,2003,Southwark 011,Southwark,E09000028,3956 ,1861 ,2095 
E02000818,2003,Southwark 012,Southwark,E09000028,5164 ,2598 ,2566 
E02000819,2003,Southwark 013,Southwark,E09000028,4829 ,2475 ,2354 
E02000820,2003,Southwark 014,Southwark,E09000028,5047 ,2582 ,2465 
E02000821,2003,Southwark 015,Southwark,E09000028,5405 ,2713 ,2692 
E02000822,2003,Southwark 016,Southwark,E09000028,5585 ,2798 ,2787 
E02000823,2003,Southwark 017,Southwark,E09000028,4966 ,2535 ,2431 
E02000824,2003,Southwark 018,Southwark,E09000028,5730 ,2756 ,2974 
E02000825,2003,Southwark 019,Southwark,E09000028,4908 ,2323 ,2585 
E02000826,2003,Southwark 020,Southwark,E09000028,5367 ,2583 ,2784 
E02000827,2003,Southwark 021,Southwark,E09000028,6218 ,3104 ,3114 
E02000828,2003,Southwark 022,Southwark,E09000028,5353 ,2704 ,2649 
E02000829,2003,Southwark 023,Southwark,E09000028,5861 ,2969 ,2892 
E02000830,2003,Southwark 024,Southwark,E09000028,5597 ,2820 ,2777 
E02000831,2003,Southwark 025,Southwark,E09000028,5556 ,2779 ,2777 
E02000832,2003,Southwark 026,Southwark,E09000028,5392 ,2598 ,2794 
E02000833,2003,Southwark 027,Southwark,E09000028,5353 ,2531 ,2822 
E02000834,2003,Southwark 028,Southwark,E09000028,6149 ,3021 ,3128 
E02000835,2003,Southwark 029,Southwark,E09000028,4537 ,2223 ,2314 
E02000836,2003,Southwark 030,Southwark,E09000028,5585 ,2738 ,2847 
E02000837,2003,Southwark 031,Southwark,E09000028,5019 ,2447 ,2572 
E02000838,2003,Southwark 032,Southwark,E09000028,5703 ,2743 ,2960 
E02000839,2003,Southwark 033,Southwark,E09000028,5248 ,2642 ,2606 
E02006802,2003,Southwark 034,Southwark,E09000028,5523 ,2725 ,2798 
E02000840,2003,Sutton 001,Sutton,E09000029,4850 ,2301 ,2549 
E02000841,2003,Sutton 002,Sutton,E09000029,4933 ,2423 ,2510 
E02000842,2003,Sutton 003,Sutton,E09000029,4902 ,2441 ,2461 
E02000843,2003,Sutton 004,Sutton,E09000029,5212 ,2526 ,2686 
E02000844,2003,Sutton 005,Sutton,E09000029,4844 ,2358 ,2486 
E02000845,2003,Sutton 006,Sutton,E09000029,4735 ,2271 ,2464 
E02000846,2003,Sutton 007,Sutton,E09000029,4356 ,2153 ,2203 
E02000847,2003,Sutton 008,Sutton,E09000029,5491 ,2706 ,2785 
E02000848,2003,Sutton 009,Sutton,E09000029,4817 ,2375 ,2442 
E02000849,2003,Sutton 010,Sutton,E09000029,4920 ,2457 ,2463 
E02000850,2003,Sutton 011,Sutton,E09000029,6660 ,3361 ,3299 
E02000851,2003,Sutton 012,Sutton,E09000029,5081 ,2665 ,2416 
E02000852,2003,Sutton 013,Sutton,E09000029,4941 ,2477 ,2464 
E02000853,2003,Sutton 014,Sutton,E09000029,4988 ,2486 ,2502 
E02000854,2003,Sutton 015,Sutton,E09000029,4510 ,2239 ,2271 
E02000855,2003,Sutton 016,Sutton,E09000029,4617 ,2267 ,2350 
E02000856,2003,Sutton 017,Sutton,E09000029,5354 ,2661 ,2693 
E02000857,2003,Sutton 018,Sutton,E09000029,5105 ,2606 ,2499 
E02000858,2003,Sutton 019,Sutton,E09000029,4704 ,2290 ,2414 
E02000859,2003,Sutton 020,Sutton,E09000029,5224 ,2579 ,2645 
E02000860,2003,Sutton 021,Sutton,E09000029,4912 ,2560 ,2352 
E02000861,2003,Sutton 022,Sutton,E09000029,4935 ,2439 ,2496 
E02000863,2003,Sutton 024,Sutton,E09000029,4112 ,2047 ,2065 
E02006836,2003,Sutton 025,Sutton,E09000029,5150 ,2537 ,2613 
E02000864,2003,Tower Hamlets 001,Tower Hamlets,E09000030,4414 ,2126 ,2288 
E02000865,2003,Tower Hamlets 002,Tower Hamlets,E09000030,4364 ,2158 ,2206 
E02000866,2003,Tower Hamlets 003,Tower Hamlets,E09000030,6019 ,3050 ,2969 
E02000867,2003,Tower Hamlets 004,Tower Hamlets,E09000030,4439 ,2244 ,2195 
E02000868,2003,Tower Hamlets 005,Tower Hamlets,E09000030,4125 ,2065 ,2060 
E02000869,2003,Tower Hamlets 006,Tower Hamlets,E09000030,3434 ,1814 ,1620 
E02000870,2003,Tower Hamlets 007,Tower Hamlets,E09000030,3855 ,1936 ,1919 
E02000871,2003,Tower Hamlets 008,Tower Hamlets,E09000030,4786 ,2391 ,2395 
E02000872,2003,Tower Hamlets 009,Tower Hamlets,E09000030,4300 ,2305 ,1995 
E02000873,2003,Tower Hamlets 010,Tower Hamlets,E09000030,4135 ,2033 ,2102 
E02000874,2003,Tower Hamlets 011,Tower Hamlets,E09000030,4907 ,2472 ,2435 
E02000875,2003,Tower Hamlets 012,Tower Hamlets,E09000030,5109 ,2620 ,2489 
E02000876,2003,Tower Hamlets 013,Tower Hamlets,E09000030,4668 ,2473 ,2195 
E02000877,2003,Tower Hamlets 014,Tower Hamlets,E09000030,5873 ,2941 ,2932 
E02000878,2003,Tower Hamlets 015,Tower Hamlets,E09000030,7046 ,3916 ,3130 
E02000879,2003,Tower Hamlets 016,Tower Hamlets,E09000030,4307 ,2164 ,2143 
E02000880,2003,Tower Hamlets 017,Tower Hamlets,E09000030,4196 ,2132 ,2064 
E02000881,2003,Tower Hamlets 018,Tower Hamlets,E09000030,3755 ,1882 ,1873 
E02000882,2003,Tower Hamlets 019,Tower Hamlets,E09000030,4475 ,2259 ,2216 
E02000883,2003,Tower Hamlets 020,Tower Hamlets,E09000030,4013 ,1999 ,2014 
E02000884,2003,Tower Hamlets 021,Tower Hamlets,E09000030,5537 ,3054 ,2483 
E02000885,2003,Tower Hamlets 022,Tower Hamlets,E09000030,3900 ,2075 ,1825 
E02000886,2003,Tower Hamlets 023,Tower Hamlets,E09000030,4420 ,2403 ,2017 
E02000887,2003,Tower Hamlets 024,Tower Hamlets,E09000030,4621 ,2344 ,2277 
E02000888,2003,Tower Hamlets 025,Tower Hamlets,E09000030,4635 ,2574 ,2061 
E02000889,2003,Tower Hamlets 026,Tower Hamlets,E09000030,4732 ,2638 ,2094 
E02000890,2003,Tower Hamlets 027,Tower Hamlets,E09000030,4383 ,2453 ,1930 
E02000891,2003,Tower Hamlets 028,Tower Hamlets,E09000030,5590 ,3085 ,2505 
E02000893,2003,Tower Hamlets 030,Tower Hamlets,E09000030,4904 ,2608 ,2296 
E02000894,2003,Tower Hamlets 031,Tower Hamlets,E09000030,6558 ,3518 ,3040 
E02006853,2003,Tower Hamlets 032,Tower Hamlets,E09000030,2209 ,1190 ,1019 
E02006854,2003,Tower Hamlets 033,Tower Hamlets,E09000030,2364 ,1354 ,1010 
E02000895,2003,Waltham Forest 001,Waltham Forest,E09000031,4571 ,2229 ,2342 
E02000896,2003,Waltham Forest 002,Waltham Forest,E09000031,5125 ,2530 ,2595 
E02000897,2003,Waltham Forest 003,Waltham Forest,E09000031,4463 ,2088 ,2375 
E02000898,2003,Waltham Forest 004,Waltham Forest,E09000031,4726 ,2292 ,2434 
E02000899,2003,Waltham Forest 005,Waltham Forest,E09000031,4760 ,2327 ,2433 
E02000900,2003,Waltham Forest 006,Waltham Forest,E09000031,4939 ,2394 ,2545 
E02000901,2003,Waltham Forest 007,Waltham Forest,E09000031,5696 ,2832 ,2864 
E02000902,2003,Waltham Forest 008,Waltham Forest,E09000031,4993 ,2450 ,2543 
E02000903,2003,Waltham Forest 009,Waltham Forest,E09000031,5437 ,2664 ,2773 
E02000904,2003,Waltham Forest 010,Waltham Forest,E09000031,4391 ,2176 ,2215 
E02000905,2003,Waltham Forest 011,Waltham Forest,E09000031,5526 ,2755 ,2771 
E02000906,2003,Waltham Forest 012,Waltham Forest,E09000031,5790 ,2918 ,2872 
E02000907,2003,Waltham Forest 013,Waltham Forest,E09000031,5662 ,2795 ,2867 
E02000908,2003,Waltham Forest 014,Waltham Forest,E09000031,6063 ,3140 ,2923 
E02000909,2003,Waltham Forest 015,Waltham Forest,E09000031,5236 ,2667 ,2569 
E02000910,2003,Waltham Forest 016,Waltham Forest,E09000031,6607 ,3427 ,3180 
E02000911,2003,Waltham Forest 017,Waltham Forest,E09000031,6209 ,3131 ,3078 
E02000912,2003,Waltham Forest 018,Waltham Forest,E09000031,5376 ,2690 ,2686 
E02000913,2003,Waltham Forest 019,Waltham Forest,E09000031,5482 ,2813 ,2669 
E02000914,2003,Waltham Forest 020,Waltham Forest,E09000031,6240 ,3191 ,3049 
E02000915,2003,Waltham Forest 021,Waltham Forest,E09000031,5805 ,3042 ,2763 
E02000916,2003,Waltham Forest 022,Waltham Forest,E09000031,5502 ,2792 ,2710 
E02000917,2003,Waltham Forest 023,Waltham Forest,E09000031,5303 ,2758 ,2545 
E02000918,2003,Waltham Forest 024,Waltham Forest,E09000031,5539 ,2867 ,2672 
E02000919,2003,Waltham Forest 025,Waltham Forest,E09000031,5620 ,2956 ,2664 
E02000920,2003,Waltham Forest 026,Waltham Forest,E09000031,5663 ,2883 ,2780 
E02000921,2003,Waltham Forest 027,Waltham Forest,E09000031,6455 ,3263 ,3192 
E02000922,2003,Waltham Forest 028,Waltham Forest,E09000031,6115 ,3144 ,2971 
E02000923,2003,Wandsworth 001,Wandsworth,E09000032,5171 ,2685 ,2486 
E02000924,2003,Wandsworth 002,Wandsworth,E09000032,6464 ,3126 ,3338 
E02000925,2003,Wandsworth 003,Wandsworth,E09000032,4991 ,2451 ,2540 
E02000926,2003,Wandsworth 004,Wandsworth,E09000032,5235 ,2640 ,2595 
E02000927,2003,Wandsworth 005,Wandsworth,E09000032,5212 ,2543 ,2669 
E02000928,2003,Wandsworth 006,Wandsworth,E09000032,6112 ,3062 ,3050 
E02000929,2003,Wandsworth 007,Wandsworth,E09000032,4488 ,2201 ,2287 
E02000930,2003,Wandsworth 008,Wandsworth,E09000032,6877 ,3408 ,3469 
E02000931,2003,Wandsworth 009,Wandsworth,E09000032,6450 ,3328 ,3122 
E02000932,2003,Wandsworth 010,Wandsworth,E09000032,6759 ,3397 ,3362 
E02000933,2003,Wandsworth 011,Wandsworth,E09000032,5784 ,2786 ,2998 
E02000934,2003,Wandsworth 012,Wandsworth,E09000032,6436 ,3219 ,3217 
E02000935,2003,Wandsworth 013,Wandsworth,E09000032,4080 ,1604 ,2476 
E02000936,2003,Wandsworth 014,Wandsworth,E09000032,6007 ,2997 ,3010 
E02000937,2003,Wandsworth 015,Wandsworth,E09000032,5478 ,2715 ,2763 
E02000938,2003,Wandsworth 016,Wandsworth,E09000032,5671 ,2663 ,3008 
E02000939,2003,Wandsworth 017,Wandsworth,E09000032,5228 ,2575 ,2653 
E02000940,2003,Wandsworth 018,Wandsworth,E09000032,4935 ,2387 ,2548 
E02000941,2003,Wandsworth 019,Wandsworth,E09000032,7618 ,4155 ,3463 
E02000942,2003,Wandsworth 020,Wandsworth,E09000032,6634 ,3295 ,3339 
E02000943,2003,Wandsworth 021,Wandsworth,E09000032,5879 ,2966 ,2913 
E02000944,2003,Wandsworth 022,Wandsworth,E09000032,4710 ,2184 ,2526 
E02000945,2003,Wandsworth 023,Wandsworth,E09000032,4162 ,1869 ,2293 
E02000946,2003,Wandsworth 024,Wandsworth,E09000032,5294 ,2620 ,2674 
E02000947,2003,Wandsworth 025,Wandsworth,E09000032,6413 ,3041 ,3372 
E02000948,2003,Wandsworth 026,Wandsworth,E09000032,7448 ,3804 ,3644 
E02000949,2003,Wandsworth 027,Wandsworth,E09000032,7069 ,3498 ,3571 
E02000950,2003,Wandsworth 028,Wandsworth,E09000032,5510 ,2742 ,2768 
E02000951,2003,Wandsworth 029,Wandsworth,E09000032,4892 ,2459 ,2433 
E02000952,2003,Wandsworth 030,Wandsworth,E09000032,4444 ,2292 ,2152 
E02000953,2003,Wandsworth 031,Wandsworth,E09000032,4914 ,2223 ,2691 
E02000954,2003,Wandsworth 032,Wandsworth,E09000032,4457 ,2216 ,2241 
E02000955,2003,Wandsworth 033,Wandsworth,E09000032,4554 ,2227 ,2327 
E02000956,2003,Wandsworth 034,Wandsworth,E09000032,4990 ,2352 ,2638 
E02000957,2003,Wandsworth 035,Wandsworth,E09000032,7226 ,3567 ,3659 
E02000958,2003,Wandsworth 036,Wandsworth,E09000032,5425 ,2576 ,2849 
E02000959,2003,Wandsworth 037,Wandsworth,E09000032,4534 ,2233 ,2301 
E02000960,2003,Westminster 001,Westminster,E09000033,4760 ,2265 ,2495 
E02000961,2003,Westminster 002,Westminster,E09000033,6086 ,2942 ,3144 
E02000962,2003,Westminster 003,Westminster,E09000033,6205 ,2989 ,3216 
E02000963,2003,Westminster 004,Westminster,E09000033,6117 ,2831 ,3286 
E02000964,2003,Westminster 005,Westminster,E09000033,7469 ,3547 ,3922 
E02000965,2003,Westminster 006,Westminster,E09000033,6808 ,3380 ,3428 
E02000966,2003,Westminster 007,Westminster,E09000033,6645 ,3360 ,3285 
E02000967,2003,Westminster 008,Westminster,E09000033,6024 ,3186 ,2838 
E02000968,2003,Westminster 009,Westminster,E09000033,9721 ,4647 ,5074 
E02000969,2003,Westminster 010,Westminster,E09000033,5980 ,2805 ,3175 
E02000970,2003,Westminster 011,Westminster,E09000033,6845 ,3584 ,3261 
E02000971,2003,Westminster 012,Westminster,E09000033,7100 ,3868 ,3232 
E02000972,2003,Westminster 013,Westminster,E09000033,6320 ,3339 ,2981 
E02000973,2003,Westminster 014,Westminster,E09000033,7023 ,3499 ,3524 
E02000974,2003,Westminster 015,Westminster,E09000033,6674 ,3617 ,3057 
E02000975,2003,Westminster 016,Westminster,E09000033,7181 ,3907 ,3274 
E02000976,2003,Westminster 017,Westminster,E09000033,8336 ,4383 ,3953 
E02000977,2003,Westminster 018,Westminster,E09000033,5569 ,3160 ,2409 
E02000978,2003,Westminster 019,Westminster,E09000033,8765 ,4487 ,4278 
E02000979,2003,Westminster 020,Westminster,E09000033,6171 ,3195 ,2976 
E02000980,2003,Westminster 021,Westminster,E09000033,5459 ,2727 ,2732 
E02000981,2003,Westminster 022,Westminster,E09000033,7245 ,3818 ,3427 
E02000982,2003,Westminster 023,Westminster,E09000033,5621 ,2910 ,2711 
E02000983,2003,Westminster 024,Westminster,E09000033,6358 ,3132 ,3226 
E02000001,2004,City of London 001,City of London,E09000001,5632 ,3129 ,2503 
E02000002,2004,Barking and Dagenham 001,Barking and Dagenham,E09000002,3662 ,1755 ,1907 
E02000003,2004,Barking and Dagenham 002,Barking and Dagenham,E09000002,5996 ,2887 ,3109 
E02000004,2004,Barking and Dagenham 003,Barking and Dagenham,E09000002,3903 ,1895 ,2008 
E02000005,2004,Barking and Dagenham 004,Barking and Dagenham,E09000002,5014 ,2395 ,2619 
E02000007,2004,Barking and Dagenham 006,Barking and Dagenham,E09000002,4697 ,2195 ,2502 
E02000008,2004,Barking and Dagenham 007,Barking and Dagenham,E09000002,6480 ,3093 ,3387 
E02000009,2004,Barking and Dagenham 008,Barking and Dagenham,E09000002,5555 ,2658 ,2897 
E02000010,2004,Barking and Dagenham 009,Barking and Dagenham,E09000002,4769 ,2273 ,2496 
E02000011,2004,Barking and Dagenham 010,Barking and Dagenham,E09000002,3711 ,1881 ,1830 
E02000012,2004,Barking and Dagenham 011,Barking and Dagenham,E09000002,5072 ,2529 ,2543 
E02000013,2004,Barking and Dagenham 012,Barking and Dagenham,E09000002,4748 ,2265 ,2483 
E02000014,2004,Barking and Dagenham 013,Barking and Dagenham,E09000002,5547 ,2718 ,2829 
E02000015,2004,Barking and Dagenham 014,Barking and Dagenham,E09000002,4149 ,1971 ,2178 
E02000016,2004,Barking and Dagenham 015,Barking and Dagenham,E09000002,3975 ,2111 ,1864 
E02000017,2004,Barking and Dagenham 016,Barking and Dagenham,E09000002,5368 ,2879 ,2489 
E02000018,2004,Barking and Dagenham 017,Barking and Dagenham,E09000002,4752 ,2270 ,2482 
E02000019,2004,Barking and Dagenham 018,Barking and Dagenham,E09000002,4623 ,2241 ,2382 
E02000020,2004,Barking and Dagenham 019,Barking and Dagenham,E09000002,4991 ,2459 ,2532 
E02000021,2004,Barking and Dagenham 020,Barking and Dagenham,E09000002,4829 ,2392 ,2437 
E02000022,2004,Barking and Dagenham 021,Barking and Dagenham,E09000002,4382 ,2124 ,2258 
E02000023,2004,Barking and Dagenham 022,Barking and Dagenham,E09000002,3964 ,1911 ,2053 
E02006799,2004,Barking and Dagenham 023,Barking and Dagenham,E09000002,5497 ,2627 ,2870 
E02000024,2004,Barnet 001,Barnet,E09000003,6043 ,2858 ,3185 
E02000025,2004,Barnet 002,Barnet,E09000003,5119 ,2472 ,2647 
E02000026,2004,Barnet 003,Barnet,E09000003,3954 ,1872 ,2082 
E02000027,2004,Barnet 004,Barnet,E09000003,6077 ,2759 ,3318 
E02000028,2004,Barnet 005,Barnet,E09000003,3739 ,1823 ,1916 
E02000029,2004,Barnet 006,Barnet,E09000003,5381 ,2591 ,2790 
E02000030,2004,Barnet 007,Barnet,E09000003,5640 ,2692 ,2948 
E02000031,2004,Barnet 008,Barnet,E09000003,4485 ,2226 ,2259 
E02000032,2004,Barnet 009,Barnet,E09000003,4756 ,2259 ,2497 
E02000033,2004,Barnet 010,Barnet,E09000003,4900 ,2288 ,2612 
E02000034,2004,Barnet 011,Barnet,E09000003,5255 ,2484 ,2771 
E02000035,2004,Barnet 012,Barnet,E09000003,5389 ,2681 ,2708 
E02000036,2004,Barnet 013,Barnet,E09000003,6319 ,2981 ,3338 
E02000037,2004,Barnet 014,Barnet,E09000003,5744 ,2676 ,3068 
E02000038,2004,Barnet 015,Barnet,E09000003,6356 ,3079 ,3277 
E02000039,2004,Barnet 016,Barnet,E09000003,4135 ,1991 ,2144 
E02000040,2004,Barnet 017,Barnet,E09000003,3913 ,1877 ,2036 
E02000041,2004,Barnet 018,Barnet,E09000003,5175 ,2568 ,2607 
E02000042,2004,Barnet 019,Barnet,E09000003,6664 ,3398 ,3266 
E02000043,2004,Barnet 020,Barnet,E09000003,4823 ,2377 ,2446 
E02000044,2004,Barnet 021,Barnet,E09000003,5113 ,2439 ,2674 
E02000045,2004,Barnet 022,Barnet,E09000003,6450 ,3140 ,3310 
E02000046,2004,Barnet 023,Barnet,E09000003,4581 ,2339 ,2242 
E02000047,2004,Barnet 024,Barnet,E09000003,6214 ,2924 ,3290 
E02000048,2004,Barnet 025,Barnet,E09000003,5408 ,2681 ,2727 
E02000049,2004,Barnet 026,Barnet,E09000003,5042 ,2323 ,2719 
E02000050,2004,Barnet 027,Barnet,E09000003,6186 ,2994 ,3192 
E02000051,2004,Barnet 028,Barnet,E09000003,5264 ,2669 ,2595 
E02000052,2004,Barnet 029,Barnet,E09000003,6234 ,2989 ,3245 
E02000053,2004,Barnet 030,Barnet,E09000003,4895 ,2519 ,2376 
E02000054,2004,Barnet 031,Barnet,E09000003,4398 ,2204 ,2194 
E02000055,2004,Barnet 032,Barnet,E09000003,6405 ,3289 ,3116 
E02000056,2004,Barnet 033,Barnet,E09000003,5687 ,2706 ,2981 
E02000057,2004,Barnet 034,Barnet,E09000003,4112 ,2018 ,2094 
E02000058,2004,Barnet 035,Barnet,E09000003,6177 ,3037 ,3140 
E02000059,2004,Barnet 036,Barnet,E09000003,6423 ,3250 ,3173 
E02000060,2004,Barnet 037,Barnet,E09000003,5867 ,2904 ,2963 
E02000061,2004,Barnet 038,Barnet,E09000003,5120 ,2620 ,2500 
E02000062,2004,Barnet 039,Barnet,E09000003,3900 ,1896 ,2004 
E02000063,2004,Barnet 040,Barnet,E09000003,4291 ,2147 ,2144 
E02000064,2004,Barnet 041,Barnet,E09000003,3789 ,1728 ,2061 
E02000065,2004,Bexley 001,Bexley,E09000004,4477 ,2187 ,2290 
E02000066,2004,Bexley 002,Bexley,E09000004,6241 ,2914 ,3327 
E02000067,2004,Bexley 003,Bexley,E09000004,5246 ,2548 ,2698 
E02000068,2004,Bexley 004,Bexley,E09000004,4008 ,1952 ,2056 
E02000069,2004,Bexley 005,Bexley,E09000004,3658 ,1821 ,1837 
E02000070,2004,Bexley 006,Bexley,E09000004,4952 ,2376 ,2576 
E02000071,2004,Bexley 007,Bexley,E09000004,4734 ,2329 ,2405 
E02000072,2004,Bexley 008,Bexley,E09000004,6893 ,3252 ,3641 
E02000073,2004,Bexley 009,Bexley,E09000004,6496 ,3210 ,3286 
E02000074,2004,Bexley 010,Bexley,E09000004,4675 ,2232 ,2443 
E02000075,2004,Bexley 011,Bexley,E09000004,4843 ,2360 ,2483 
E02000077,2004,Bexley 013,Bexley,E09000004,4745 ,2314 ,2431 
E02000078,2004,Bexley 014,Bexley,E09000004,5065 ,2459 ,2606 
E02000079,2004,Bexley 015,Bexley,E09000004,4834 ,2382 ,2452 
E02000080,2004,Bexley 016,Bexley,E09000004,5693 ,2798 ,2895 
E02000081,2004,Bexley 017,Bexley,E09000004,4664 ,2286 ,2378 
E02000082,2004,Bexley 018,Bexley,E09000004,5677 ,2856 ,2821 
E02000083,2004,Bexley 019,Bexley,E09000004,5977 ,2906 ,3071 
E02000084,2004,Bexley 020,Bexley,E09000004,6697 ,3288 ,3409 
E02000085,2004,Bexley 021,Bexley,E09000004,4871 ,2400 ,2471 
E02000086,2004,Bexley 022,Bexley,E09000004,4820 ,2359 ,2461 
E02000087,2004,Bexley 023,Bexley,E09000004,4523 ,2300 ,2223 
E02000088,2004,Bexley 024,Bexley,E09000004,4775 ,2372 ,2403 
E02000089,2004,Bexley 025,Bexley,E09000004,4693 ,2275 ,2418 
E02000090,2004,Bexley 026,Bexley,E09000004,5086 ,2480 ,2606 
E02000091,2004,Bexley 027,Bexley,E09000004,5655 ,2745 ,2910 
E02000092,2004,Bexley 028,Bexley,E09000004,3661 ,1723 ,1938 
E02006785,2004,Bexley 029,Bexley,E09000004,3872 ,1909 ,1963 
E02000093,2004,Brent 001,Brent,E09000005,6089 ,3043 ,3046 
E02000094,2004,Brent 002,Brent,E09000005,4775 ,2387 ,2388 
E02000095,2004,Brent 003,Brent,E09000005,5803 ,2855 ,2948 
E02000096,2004,Brent 004,Brent,E09000005,4444 ,2259 ,2185 
E02000097,2004,Brent 005,Brent,E09000005,5228 ,2661 ,2567 
E02000098,2004,Brent 006,Brent,E09000005,4464 ,2261 ,2203 
E02000099,2004,Brent 007,Brent,E09000005,4298 ,2147 ,2151 
E02000100,2004,Brent 008,Brent,E09000005,5237 ,2521 ,2716 
E02000101,2004,Brent 009,Brent,E09000005,4834 ,2295 ,2539 
E02000102,2004,Brent 010,Brent,E09000005,4648 ,2362 ,2286 
E02000103,2004,Brent 011,Brent,E09000005,4991 ,2547 ,2444 
E02000104,2004,Brent 012,Brent,E09000005,3855 ,1993 ,1862 
E02000105,2004,Brent 013,Brent,E09000005,4888 ,2553 ,2335 
E02000106,2004,Brent 014,Brent,E09000005,6098 ,3097 ,3001 
E02000107,2004,Brent 015,Brent,E09000005,7624 ,4021 ,3603 
E02000108,2004,Brent 016,Brent,E09000005,3807 ,1965 ,1842 
E02000109,2004,Brent 017,Brent,E09000005,5290 ,2760 ,2530 
E02000110,2004,Brent 018,Brent,E09000005,5386 ,2643 ,2743 
E02000111,2004,Brent 019,Brent,E09000005,5368 ,2798 ,2570 
E02000112,2004,Brent 020,Brent,E09000005,5520 ,2893 ,2627 
E02000113,2004,Brent 021,Brent,E09000005,5432 ,2517 ,2915 
E02000114,2004,Brent 022,Brent,E09000005,5986 ,3051 ,2935 
E02000115,2004,Brent 023,Brent,E09000005,5858 ,2974 ,2884 
E02000116,2004,Brent 024,Brent,E09000005,4642 ,2410 ,2232 
E02000117,2004,Brent 025,Brent,E09000005,7174 ,3466 ,3708 
E02000118,2004,Brent 026,Brent,E09000005,5670 ,2996 ,2674 
E02000119,2004,Brent 027,Brent,E09000005,4350 ,2157 ,2193 
E02000120,2004,Brent 028,Brent,E09000005,6468 ,3206 ,3262 
E02000121,2004,Brent 029,Brent,E09000005,5422 ,2843 ,2579 
E02000122,2004,Brent 030,Brent,E09000005,5447 ,2763 ,2684 
E02000123,2004,Brent 031,Brent,E09000005,8640 ,4388 ,4252 
E02000124,2004,Brent 032,Brent,E09000005,6791 ,3428 ,3363 
E02000125,2004,Brent 033,Brent,E09000005,6665 ,3305 ,3360 
E02000126,2004,Brent 034,Brent,E09000005,4650 ,2263 ,2387 
E02000127,2004,Bromley 001,Bromley,E09000006,5254 ,2437 ,2817 
E02000128,2004,Bromley 002,Bromley,E09000006,4774 ,2349 ,2425 
E02000130,2004,Bromley 004,Bromley,E09000006,5237 ,2512 ,2725 
E02000131,2004,Bromley 005,Bromley,E09000006,6152 ,3015 ,3137 
E02000132,2004,Bromley 006,Bromley,E09000006,5472 ,2720 ,2752 
E02000133,2004,Bromley 007,Bromley,E09000006,5521 ,2713 ,2808 
E02000134,2004,Bromley 008,Bromley,E09000006,7008 ,3473 ,3535 
E02000135,2004,Bromley 009,Bromley,E09000006,6138 ,2867 ,3271 
E02000136,2004,Bromley 010,Bromley,E09000006,3347 ,1636 ,1711 
E02000137,2004,Bromley 011,Bromley,E09000006,4979 ,2429 ,2550 
E02000138,2004,Bromley 012,Bromley,E09000006,4996 ,2535 ,2461 
E02000139,2004,Bromley 013,Bromley,E09000006,4952 ,2399 ,2553 
E02000140,2004,Bromley 014,Bromley,E09000006,4486 ,2110 ,2376 
E02000141,2004,Bromley 015,Bromley,E09000006,5042 ,2499 ,2543 
E02000142,2004,Bromley 016,Bromley,E09000006,5107 ,2554 ,2553 
E02000144,2004,Bromley 018,Bromley,E09000006,5245 ,2612 ,2633 
E02000145,2004,Bromley 019,Bromley,E09000006,4765 ,2248 ,2517 
E02000146,2004,Bromley 020,Bromley,E09000006,4983 ,2433 ,2550 
E02000147,2004,Bromley 021,Bromley,E09000006,4777 ,2392 ,2385 
E02000148,2004,Bromley 022,Bromley,E09000006,3790 ,1883 ,1907 
E02000149,2004,Bromley 023,Bromley,E09000006,4705 ,2273 ,2432 
E02000150,2004,Bromley 024,Bromley,E09000006,4878 ,2372 ,2506 
E02000151,2004,Bromley 025,Bromley,E09000006,4639 ,2271 ,2368 
E02000152,2004,Bromley 026,Bromley,E09000006,3866 ,1817 ,2049 
E02000153,2004,Bromley 027,Bromley,E09000006,4692 ,2246 ,2446 
E02000154,2004,Bromley 028,Bromley,E09000006,4876 ,2437 ,2439 
E02000155,2004,Bromley 029,Bromley,E09000006,4280 ,2089 ,2191 
E02000156,2004,Bromley 030,Bromley,E09000006,7166 ,3545 ,3621 
E02000157,2004,Bromley 031,Bromley,E09000006,4718 ,2300 ,2418 
E02000158,2004,Bromley 032,Bromley,E09000006,4392 ,2107 ,2285 
E02000159,2004,Bromley 033,Bromley,E09000006,3831 ,1888 ,1943 
E02000160,2004,Bromley 034,Bromley,E09000006,4660 ,2318 ,2342 
E02000161,2004,Bromley 035,Bromley,E09000006,5185 ,2524 ,2661 
E02000162,2004,Bromley 036,Bromley,E09000006,3894 ,1858 ,2036 
E02000163,2004,Bromley 037,Bromley,E09000006,4862 ,2399 ,2463 
E02000165,2004,Bromley 039,Bromley,E09000006,4892 ,2411 ,2481 
E02006782,2004,Bromley 040,Bromley,E09000006,4625 ,2191 ,2434 
E02006787,2004,Bromley 041,Bromley,E09000006,4855 ,2368 ,2487 
E02006789,2004,Bromley 042,Bromley,E09000006,3912 ,1965 ,1947 
E02000166,2004,Camden 001,Camden,E09000007,5845 ,2629 ,3216 
E02000167,2004,Camden 002,Camden,E09000007,5278 ,2546 ,2732 
E02000168,2004,Camden 003,Camden,E09000007,5738 ,2823 ,2915 
E02000169,2004,Camden 004,Camden,E09000007,4713 ,2259 ,2454 
E02000170,2004,Camden 005,Camden,E09000007,6050 ,2981 ,3069 
E02000171,2004,Camden 006,Camden,E09000007,5275 ,2472 ,2803 
E02000172,2004,Camden 007,Camden,E09000007,6463 ,3191 ,3272 
E02000173,2004,Camden 008,Camden,E09000007,5223 ,2533 ,2690 
E02000174,2004,Camden 009,Camden,E09000007,6305 ,3109 ,3196 
E02000175,2004,Camden 010,Camden,E09000007,7200 ,3576 ,3624 
E02000176,2004,Camden 011,Camden,E09000007,4523 ,2258 ,2265 
E02000177,2004,Camden 012,Camden,E09000007,5752 ,2793 ,2959 
E02000178,2004,Camden 013,Camden,E09000007,6697 ,3270 ,3427 
E02000179,2004,Camden 014,Camden,E09000007,4185 ,2065 ,2120 
E02000180,2004,Camden 015,Camden,E09000007,5671 ,2941 ,2730 
E02000181,2004,Camden 016,Camden,E09000007,6251 ,3097 ,3154 
E02000182,2004,Camden 017,Camden,E09000007,3794 ,1786 ,2008 
E02000183,2004,Camden 018,Camden,E09000007,5613 ,2754 ,2859 
E02000184,2004,Camden 019,Camden,E09000007,5753 ,2875 ,2878 
E02000185,2004,Camden 020,Camden,E09000007,5605 ,2853 ,2752 
E02000186,2004,Camden 021,Camden,E09000007,5148 ,2828 ,2320 
E02000187,2004,Camden 022,Camden,E09000007,5116 ,2462 ,2654 
E02000188,2004,Camden 023,Camden,E09000007,4952 ,2459 ,2493 
E02000189,2004,Camden 024,Camden,E09000007,4324 ,2167 ,2157 
E02000190,2004,Camden 025,Camden,E09000007,5931 ,3037 ,2894 
E02000191,2004,Camden 026,Camden,E09000007,5857 ,2902 ,2955 
E02000192,2004,Camden 027,Camden,E09000007,4902 ,2680 ,2222 
E02000193,2004,Camden 028,Camden,E09000007,5631 ,2897 ,2734 
E02000194,2004,Croydon 001,Croydon,E09000008,5331 ,2578 ,2753 
E02000195,2004,Croydon 002,Croydon,E09000008,5524 ,2765 ,2759 
E02000196,2004,Croydon 003,Croydon,E09000008,4293 ,2085 ,2208 
E02000197,2004,Croydon 004,Croydon,E09000008,5418 ,2660 ,2758 
E02000198,2004,Croydon 005,Croydon,E09000008,5244 ,2455 ,2789 
E02000199,2004,Croydon 006,Croydon,E09000008,5276 ,2478 ,2798 
E02000200,2004,Croydon 007,Croydon,E09000008,5346 ,2637 ,2709 
E02000201,2004,Croydon 008,Croydon,E09000008,5313 ,2618 ,2695 
E02000202,2004,Croydon 009,Croydon,E09000008,5778 ,2857 ,2921 
E02000203,2004,Croydon 010,Croydon,E09000008,5139 ,2548 ,2591 
E02000204,2004,Croydon 011,Croydon,E09000008,6405 ,3182 ,3223 
E02000206,2004,Croydon 013,Croydon,E09000008,6013 ,2879 ,3134 
E02000207,2004,Croydon 014,Croydon,E09000008,5423 ,2540 ,2883 
E02000208,2004,Croydon 015,Croydon,E09000008,5003 ,2532 ,2471 
E02000209,2004,Croydon 016,Croydon,E09000008,5288 ,2621 ,2667 
E02000210,2004,Croydon 017,Croydon,E09000008,5518 ,2748 ,2770 
E02000211,2004,Croydon 018,Croydon,E09000008,5044 ,2500 ,2544 
E02000212,2004,Croydon 019,Croydon,E09000008,4928 ,2479 ,2449 
E02000213,2004,Croydon 020,Croydon,E09000008,5738 ,2926 ,2812 
E02000214,2004,Croydon 021,Croydon,E09000008,3987 ,2049 ,1938 
E02000215,2004,Croydon 022,Croydon,E09000008,6972 ,3611 ,3361 
E02000216,2004,Croydon 023,Croydon,E09000008,4058 ,2135 ,1923 
E02000217,2004,Croydon 024,Croydon,E09000008,5413 ,2728 ,2685 
E02000218,2004,Croydon 025,Croydon,E09000008,3955 ,1836 ,2119 
E02000219,2004,Croydon 026,Croydon,E09000008,4686 ,2298 ,2388 
E02000220,2004,Croydon 027,Croydon,E09000008,6078 ,3234 ,2844 
E02000221,2004,Croydon 028,Croydon,E09000008,5325 ,2498 ,2827 
E02000222,2004,Croydon 029,Croydon,E09000008,5262 ,2598 ,2664 
E02000223,2004,Croydon 030,Croydon,E09000008,4688 ,2075 ,2613 
E02000224,2004,Croydon 031,Croydon,E09000008,5106 ,2584 ,2522 
E02000225,2004,Croydon 032,Croydon,E09000008,4556 ,2133 ,2423 
E02000226,2004,Croydon 033,Croydon,E09000008,4896 ,2416 ,2480 
E02000227,2004,Croydon 034,Croydon,E09000008,7753 ,3733 ,4020 
E02000228,2004,Croydon 035,Croydon,E09000008,4577 ,2248 ,2329 
E02000229,2004,Croydon 036,Croydon,E09000008,3488 ,1602 ,1886 
E02000230,2004,Croydon 037,Croydon,E09000008,5822 ,2955 ,2867 
E02000231,2004,Croydon 038,Croydon,E09000008,4824 ,2439 ,2385 
E02000232,2004,Croydon 039,Croydon,E09000008,3668 ,1742 ,1926 
E02000233,2004,Croydon 040,Croydon,E09000008,3728 ,1819 ,1909 
E02000234,2004,Croydon 041,Croydon,E09000008,5000 ,2423 ,2577 
E02000235,2004,Croydon 042,Croydon,E09000008,4375 ,2114 ,2261 
E02000236,2004,Croydon 043,Croydon,E09000008,4907 ,2415 ,2492 
E02000237,2004,Croydon 044,Croydon,E09000008,4546 ,2213 ,2333 
E02006788,2004,Croydon 045,Croydon,E09000008,4827 ,2184 ,2643 
E02000238,2004,Ealing 001,Ealing,E09000009,5842 ,2946 ,2896 
E02000239,2004,Ealing 002,Ealing,E09000009,5765 ,2970 ,2795 
E02000240,2004,Ealing 003,Ealing,E09000009,5788 ,2734 ,3054 
E02000241,2004,Ealing 004,Ealing,E09000009,4173 ,2112 ,2061 
E02000242,2004,Ealing 005,Ealing,E09000009,4209 ,2217 ,1992 
E02000243,2004,Ealing 006,Ealing,E09000009,5595 ,2806 ,2789 
E02000244,2004,Ealing 007,Ealing,E09000009,4426 ,2326 ,2100 
E02000245,2004,Ealing 008,Ealing,E09000009,4988 ,2416 ,2572 
E02000246,2004,Ealing 009,Ealing,E09000009,5055 ,2432 ,2623 
E02000247,2004,Ealing 010,Ealing,E09000009,5023 ,2434 ,2589 
E02000248,2004,Ealing 011,Ealing,E09000009,4826 ,2601 ,2225 
E02000249,2004,Ealing 012,Ealing,E09000009,4476 ,2252 ,2224 
E02000250,2004,Ealing 013,Ealing,E09000009,4371 ,2190 ,2181 
E02000251,2004,Ealing 014,Ealing,E09000009,5092 ,2575 ,2517 
E02000252,2004,Ealing 015,Ealing,E09000009,5851 ,3044 ,2807 
E02000253,2004,Ealing 016,Ealing,E09000009,5907 ,2809 ,3098 
E02000254,2004,Ealing 017,Ealing,E09000009,5868 ,3070 ,2798 
E02000255,2004,Ealing 018,Ealing,E09000009,6446 ,3149 ,3297 
E02000256,2004,Ealing 019,Ealing,E09000009,5969 ,3101 ,2868 
E02000257,2004,Ealing 020,Ealing,E09000009,9683 ,5091 ,4592 
E02000258,2004,Ealing 021,Ealing,E09000009,4341 ,2191 ,2150 
E02000259,2004,Ealing 022,Ealing,E09000009,4214 ,2046 ,2168 
E02000260,2004,Ealing 023,Ealing,E09000009,5732 ,3069 ,2663 
E02000261,2004,Ealing 024,Ealing,E09000009,6499 ,3205 ,3294 
E02000262,2004,Ealing 025,Ealing,E09000009,5602 ,2858 ,2744 
E02000263,2004,Ealing 026,Ealing,E09000009,7637 ,4249 ,3388 
E02000264,2004,Ealing 027,Ealing,E09000009,5378 ,2724 ,2654 
E02000265,2004,Ealing 028,Ealing,E09000009,7245 ,3707 ,3538 
E02000266,2004,Ealing 029,Ealing,E09000009,7827 ,3959 ,3868 
E02000267,2004,Ealing 030,Ealing,E09000009,4573 ,2252 ,2321 
E02000268,2004,Ealing 031,Ealing,E09000009,6574 ,3315 ,3259 
E02000269,2004,Ealing 032,Ealing,E09000009,5790 ,2921 ,2869 
E02000270,2004,Ealing 033,Ealing,E09000009,5149 ,2429 ,2720 
E02000271,2004,Ealing 034,Ealing,E09000009,4914 ,2436 ,2478 
E02000272,2004,Ealing 035,Ealing,E09000009,4509 ,2257 ,2252 
E02000274,2004,Ealing 037,Ealing,E09000009,7821 ,4209 ,3612 
E02000275,2004,Ealing 038,Ealing,E09000009,4290 ,2258 ,2032 
E02000276,2004,Ealing 039,Ealing,E09000009,4701 ,2400 ,2301 
E02006791,2004,Ealing 040,Ealing,E09000009,5320 ,2742 ,2578 
E02000277,2004,Enfield 001,Enfield,E09000010,4325 ,2098 ,2227 
E02000278,2004,Enfield 002,Enfield,E09000010,4779 ,2300 ,2479 
E02000279,2004,Enfield 003,Enfield,E09000010,6282 ,3000 ,3282 
E02000280,2004,Enfield 004,Enfield,E09000010,5165 ,2500 ,2665 
E02000281,2004,Enfield 005,Enfield,E09000010,5096 ,2420 ,2676 
E02000282,2004,Enfield 006,Enfield,E09000010,5296 ,2574 ,2722 
E02000283,2004,Enfield 007,Enfield,E09000010,5095 ,2521 ,2574 
E02000284,2004,Enfield 008,Enfield,E09000010,5096 ,2489 ,2607 
E02000285,2004,Enfield 009,Enfield,E09000010,4196 ,2046 ,2150 
E02000286,2004,Enfield 010,Enfield,E09000010,5083 ,2569 ,2514 
E02000287,2004,Enfield 011,Enfield,E09000010,3933 ,1977 ,1956 
E02000288,2004,Enfield 012,Enfield,E09000010,5766 ,2864 ,2902 
E02000289,2004,Enfield 013,Enfield,E09000010,4032 ,1955 ,2077 
E02000290,2004,Enfield 014,Enfield,E09000010,4252 ,2023 ,2229 
E02000291,2004,Enfield 015,Enfield,E09000010,5278 ,2657 ,2621 
E02000292,2004,Enfield 016,Enfield,E09000010,5924 ,2987 ,2937 
E02000293,2004,Enfield 017,Enfield,E09000010,3913 ,1929 ,1984 
E02000294,2004,Enfield 018,Enfield,E09000010,5197 ,2551 ,2646 
E02000295,2004,Enfield 019,Enfield,E09000010,5302 ,2624 ,2678 
E02000296,2004,Enfield 020,Enfield,E09000010,5362 ,2658 ,2704 
E02000297,2004,Enfield 021,Enfield,E09000010,6187 ,3117 ,3070 
E02000298,2004,Enfield 022,Enfield,E09000010,5264 ,2607 ,2657 
E02000299,2004,Enfield 023,Enfield,E09000010,5343 ,2639 ,2704 
E02000300,2004,Enfield 024,Enfield,E09000010,5155 ,2490 ,2665 
E02000301,2004,Enfield 025,Enfield,E09000010,5821 ,2822 ,2999 
E02000302,2004,Enfield 026,Enfield,E09000010,5204 ,2608 ,2596 
E02000303,2004,Enfield 027,Enfield,E09000010,5051 ,2423 ,2628 
E02000304,2004,Enfield 028,Enfield,E09000010,5008 ,2500 ,2508 
E02000305,2004,Enfield 029,Enfield,E09000010,5441 ,2768 ,2673 
E02000306,2004,Enfield 030,Enfield,E09000010,4426 ,2083 ,2343 
E02000307,2004,Enfield 031,Enfield,E09000010,5901 ,2901 ,3000 
E02000308,2004,Enfield 032,Enfield,E09000010,4931 ,2517 ,2414 
E02000309,2004,Enfield 033,Enfield,E09000010,6027 ,2916 ,3111 
E02000311,2004,Enfield 035,Enfield,E09000010,6045 ,2947 ,3098 
E02000312,2004,Enfield 036,Enfield,E09000010,6402 ,3316 ,3086 
E02006793,2004,Enfield 037,Enfield,E09000010,5334 ,2530 ,2804 
E02000313,2004,Greenwich 001,Greenwich,E09000011,3981 ,1957 ,2024 
E02000314,2004,Greenwich 002,Greenwich,E09000011,6209 ,3372 ,2837 
E02000315,2004,Greenwich 003,Greenwich,E09000011,4775 ,2255 ,2520 
E02000316,2004,Greenwich 004,Greenwich,E09000011,4526 ,2362 ,2164 
E02000317,2004,Greenwich 005,Greenwich,E09000011,5310 ,2610 ,2700 
E02000318,2004,Greenwich 006,Greenwich,E09000011,5634 ,2867 ,2767 
E02000319,2004,Greenwich 007,Greenwich,E09000011,5813 ,2941 ,2872 
E02000320,2004,Greenwich 008,Greenwich,E09000011,4022 ,1930 ,2092 
E02000321,2004,Greenwich 009,Greenwich,E09000011,4340 ,2172 ,2168 
E02000323,2004,Greenwich 011,Greenwich,E09000011,6434 ,3201 ,3233 
E02000324,2004,Greenwich 012,Greenwich,E09000011,4310 ,2129 ,2181 
E02000326,2004,Greenwich 014,Greenwich,E09000011,4643 ,2247 ,2396 
E02000327,2004,Greenwich 015,Greenwich,E09000011,4121 ,2114 ,2007 
E02000328,2004,Greenwich 016,Greenwich,E09000011,4281 ,2124 ,2157 
E02000329,2004,Greenwich 017,Greenwich,E09000011,4039 ,1991 ,2048 
E02000331,2004,Greenwich 019,Greenwich,E09000011,4734 ,2330 ,2404 
E02000332,2004,Greenwich 020,Greenwich,E09000011,4804 ,2362 ,2442 
E02000333,2004,Greenwich 021,Greenwich,E09000011,4304 ,2250 ,2054 
E02000334,2004,Greenwich 022,Greenwich,E09000011,3944 ,1990 ,1954 
E02000335,2004,Greenwich 023,Greenwich,E09000011,4096 ,2022 ,2074 
E02000337,2004,Greenwich 025,Greenwich,E09000011,4991 ,2386 ,2605 
E02000339,2004,Greenwich 027,Greenwich,E09000011,3835 ,1917 ,1918 
E02000340,2004,Greenwich 028,Greenwich,E09000011,3751 ,1861 ,1890 
E02000341,2004,Greenwich 029,Greenwich,E09000011,4760 ,2267 ,2493 
E02000342,2004,Greenwich 030,Greenwich,E09000011,3910 ,1796 ,2114 
E02000343,2004,Greenwich 031,Greenwich,E09000011,3991 ,1970 ,2021 
E02000344,2004,Greenwich 032,Greenwich,E09000011,4063 ,1976 ,2087 
E02006786,2004,Greenwich 033,Greenwich,E09000011,4204 ,2029 ,2175 
E02006927,2004,Greenwich 034,Greenwich,E09000011,7612 ,3653 ,3959 
E02006928,2004,Greenwich 035,Greenwich,E09000011,3833 ,1978 ,1855 
E02006929,2004,Greenwich 036,Greenwich,E09000011,3975 ,2005 ,1970 
E02006930,2004,Greenwich 037,Greenwich,E09000011,4538 ,2322 ,2216 
E02006931,2004,Greenwich 038,Greenwich,E09000011,5946 ,3019 ,2927 
E02000345,2004,Hackney 001,Hackney,E09000012,4597 ,2391 ,2206 
E02000346,2004,Hackney 002,Hackney,E09000012,4917 ,2465 ,2452 
E02000347,2004,Hackney 003,Hackney,E09000012,4601 ,2360 ,2241 
E02000348,2004,Hackney 004,Hackney,E09000012,4770 ,2360 ,2410 
E02000350,2004,Hackney 006,Hackney,E09000012,6304 ,3127 ,3177 
E02000351,2004,Hackney 007,Hackney,E09000012,6001 ,3073 ,2928 
E02000352,2004,Hackney 008,Hackney,E09000012,4122 ,1980 ,2142 
E02000353,2004,Hackney 009,Hackney,E09000012,5303 ,2585 ,2718 
E02000354,2004,Hackney 010,Hackney,E09000012,5556 ,2720 ,2836 
E02000355,2004,Hackney 011,Hackney,E09000012,5518 ,2717 ,2801 
E02000356,2004,Hackney 012,Hackney,E09000012,5070 ,2501 ,2569 
E02000357,2004,Hackney 013,Hackney,E09000012,4059 ,1868 ,2191 
E02000358,2004,Hackney 014,Hackney,E09000012,7322 ,3611 ,3711 
E02000359,2004,Hackney 015,Hackney,E09000012,4128 ,1959 ,2169 
E02000360,2004,Hackney 016,Hackney,E09000012,6564 ,3257 ,3307 
E02000361,2004,Hackney 017,Hackney,E09000012,4758 ,2391 ,2367 
E02000362,2004,Hackney 018,Hackney,E09000012,3360 ,1573 ,1787 
E02000363,2004,Hackney 019,Hackney,E09000012,6511 ,3084 ,3427 
E02000364,2004,Hackney 020,Hackney,E09000012,5652 ,2805 ,2847 
E02000365,2004,Hackney 021,Hackney,E09000012,7259 ,3650 ,3609 
E02000366,2004,Hackney 022,Hackney,E09000012,5037 ,2400 ,2637 
E02000367,2004,Hackney 023,Hackney,E09000012,5351 ,2561 ,2790 
E02000368,2004,Hackney 024,Hackney,E09000012,6137 ,3009 ,3128 
E02000369,2004,Hackney 025,Hackney,E09000012,6394 ,3230 ,3164 
E02000370,2004,Hackney 026,Hackney,E09000012,4493 ,2283 ,2210 
E02000371,2004,Hackney 027,Hackney,E09000012,6332 ,3359 ,2973 
E02006918,2004,Hackney 028,Hackney,E09000012,3450 ,1733 ,1717 
E02006921,2004,Hackney 029,Hackney,E09000012,4380 ,2119 ,2261 
E02000372,2004,Hammersmith and Fulham 001,Hammersmith and Fulham,E09000013,5918 ,2850 ,3068 
E02000373,2004,Hammersmith and Fulham 002,Hammersmith and Fulham,E09000013,4199 ,1953 ,2246 
E02000374,2004,Hammersmith and Fulham 003,Hammersmith and Fulham,E09000013,4553 ,2211 ,2342 
E02000375,2004,Hammersmith and Fulham 004,Hammersmith and Fulham,E09000013,5046 ,2610 ,2436 
E02000376,2004,Hammersmith and Fulham 005,Hammersmith and Fulham,E09000013,5082 ,2535 ,2547 
E02000377,2004,Hammersmith and Fulham 006,Hammersmith and Fulham,E09000013,5823 ,2862 ,2961 
E02000378,2004,Hammersmith and Fulham 007,Hammersmith and Fulham,E09000013,5108 ,2497 ,2611 
E02000379,2004,Hammersmith and Fulham 008,Hammersmith and Fulham,E09000013,4538 ,2305 ,2233 
E02000380,2004,Hammersmith and Fulham 009,Hammersmith and Fulham,E09000013,4459 ,2199 ,2260 
E02000381,2004,Hammersmith and Fulham 010,Hammersmith and Fulham,E09000013,6049 ,2927 ,3122 
E02000382,2004,Hammersmith and Fulham 011,Hammersmith and Fulham,E09000013,4243 ,2098 ,2145 
E02000383,2004,Hammersmith and Fulham 012,Hammersmith and Fulham,E09000013,7100 ,3713 ,3387 
E02000384,2004,Hammersmith and Fulham 013,Hammersmith and Fulham,E09000013,5493 ,2732 ,2761 
E02000385,2004,Hammersmith and Fulham 014,Hammersmith and Fulham,E09000013,5246 ,2782 ,2464 
E02000386,2004,Hammersmith and Fulham 015,Hammersmith and Fulham,E09000013,5934 ,3051 ,2883 
E02000387,2004,Hammersmith and Fulham 016,Hammersmith and Fulham,E09000013,4298 ,2095 ,2203 
E02000388,2004,Hammersmith and Fulham 017,Hammersmith and Fulham,E09000013,5791 ,2925 ,2866 
E02000389,2004,Hammersmith and Fulham 018,Hammersmith and Fulham,E09000013,5550 ,2632 ,2918 
E02000390,2004,Hammersmith and Fulham 019,Hammersmith and Fulham,E09000013,4742 ,2361 ,2381 
E02000391,2004,Hammersmith and Fulham 020,Hammersmith and Fulham,E09000013,5269 ,2555 ,2714 
E02000392,2004,Hammersmith and Fulham 021,Hammersmith and Fulham,E09000013,6951 ,3452 ,3499 
E02000393,2004,Hammersmith and Fulham 022,Hammersmith and Fulham,E09000013,4372 ,2127 ,2245 
E02000394,2004,Hammersmith and Fulham 023,Hammersmith and Fulham,E09000013,3946 ,1878 ,2068 
E02000395,2004,Hammersmith and Fulham 024,Hammersmith and Fulham,E09000013,4258 ,2056 ,2202 
E02000396,2004,Hammersmith and Fulham 025,Hammersmith and Fulham,E09000013,4362 ,2056 ,2306 
E02000397,2004,Haringey 001,Haringey,E09000014,4703 ,2326 ,2377 
E02000398,2004,Haringey 002,Haringey,E09000014,4635 ,2270 ,2365 
E02000400,2004,Haringey 004,Haringey,E09000014,4162 ,1993 ,2169 
E02000401,2004,Haringey 005,Haringey,E09000014,3947 ,1878 ,2069 
E02000402,2004,Haringey 006,Haringey,E09000014,4109 ,1915 ,2194 
E02000403,2004,Haringey 007,Haringey,E09000014,4571 ,2338 ,2233 
E02000404,2004,Haringey 008,Haringey,E09000014,4155 ,2015 ,2140 
E02000405,2004,Haringey 009,Haringey,E09000014,4164 ,2004 ,2160 
E02000406,2004,Haringey 010,Haringey,E09000014,4384 ,2120 ,2264 
E02000407,2004,Haringey 011,Haringey,E09000014,4173 ,2169 ,2004 
E02000408,2004,Haringey 012,Haringey,E09000014,4194 ,2056 ,2138 
E02000409,2004,Haringey 013,Haringey,E09000014,4264 ,2129 ,2135 
E02000410,2004,Haringey 014,Haringey,E09000014,4610 ,2294 ,2316 
E02000411,2004,Haringey 015,Haringey,E09000014,4658 ,2344 ,2314 
E02000412,2004,Haringey 016,Haringey,E09000014,4278 ,2171 ,2107 
E02000413,2004,Haringey 017,Haringey,E09000014,4342 ,2068 ,2274 
E02000414,2004,Haringey 018,Haringey,E09000014,4620 ,2364 ,2256 
E02000415,2004,Haringey 019,Haringey,E09000014,4528 ,2427 ,2101 
E02000416,2004,Haringey 020,Haringey,E09000014,4212 ,2064 ,2148 
E02000417,2004,Haringey 021,Haringey,E09000014,4448 ,2217 ,2231 
E02000418,2004,Haringey 022,Haringey,E09000014,3504 ,1658 ,1846 
E02000419,2004,Haringey 023,Haringey,E09000014,5681 ,3032 ,2649 
E02000420,2004,Haringey 024,Haringey,E09000014,4456 ,2210 ,2246 
E02000421,2004,Haringey 025,Haringey,E09000014,4480 ,2192 ,2288 
E02000422,2004,Haringey 026,Haringey,E09000014,4699 ,2383 ,2316 
E02000423,2004,Haringey 027,Haringey,E09000014,4972 ,2778 ,2194 
E02000424,2004,Haringey 028,Haringey,E09000014,5038 ,2524 ,2514 
E02000425,2004,Haringey 029,Haringey,E09000014,3835 ,1971 ,1864 
E02000426,2004,Haringey 030,Haringey,E09000014,4095 ,2008 ,2087 
E02000427,2004,Haringey 031,Haringey,E09000014,5231 ,2801 ,2430 
E02000428,2004,Haringey 032,Haringey,E09000014,4336 ,2231 ,2105 
E02000429,2004,Haringey 033,Haringey,E09000014,4511 ,2204 ,2307 
E02000430,2004,Haringey 034,Haringey,E09000014,4962 ,2463 ,2499 
E02000431,2004,Haringey 035,Haringey,E09000014,4484 ,2216 ,2268 
E02000432,2004,Haringey 036,Haringey,E09000014,4523 ,2263 ,2260 
E02006794,2004,Haringey 037,Haringey,E09000014,4426 ,2236 ,2190 
E02000433,2004,Harrow 001,Harrow,E09000015,3827 ,1808 ,2019 
E02000434,2004,Harrow 002,Harrow,E09000015,4787 ,2342 ,2445 
E02000435,2004,Harrow 003,Harrow,E09000015,4383 ,2097 ,2286 
E02000436,2004,Harrow 004,Harrow,E09000015,3663 ,1775 ,1888 
E02000437,2004,Harrow 005,Harrow,E09000015,4970 ,2391 ,2579 
E02000438,2004,Harrow 006,Harrow,E09000015,4493 ,2136 ,2357 
E02000439,2004,Harrow 007,Harrow,E09000015,4909 ,2555 ,2354 
E02000440,2004,Harrow 008,Harrow,E09000015,5633 ,2734 ,2899 
E02000441,2004,Harrow 009,Harrow,E09000015,4247 ,2033 ,2214 
E02000442,2004,Harrow 010,Harrow,E09000015,5252 ,2709 ,2543 
E02000443,2004,Harrow 011,Harrow,E09000015,5445 ,2762 ,2683 
E02000444,2004,Harrow 012,Harrow,E09000015,4956 ,2438 ,2518 
E02000445,2004,Harrow 013,Harrow,E09000015,5652 ,2838 ,2814 
E02000447,2004,Harrow 015,Harrow,E09000015,4436 ,2180 ,2256 
E02000448,2004,Harrow 016,Harrow,E09000015,4013 ,1971 ,2042 
E02000449,2004,Harrow 017,Harrow,E09000015,5059 ,2539 ,2520 
E02000451,2004,Harrow 019,Harrow,E09000015,4189 ,2122 ,2067 
E02000452,2004,Harrow 020,Harrow,E09000015,4953 ,2536 ,2417 
E02000453,2004,Harrow 021,Harrow,E09000015,4530 ,2313 ,2217 
E02000454,2004,Harrow 022,Harrow,E09000015,4351 ,2169 ,2182 
E02000455,2004,Harrow 023,Harrow,E09000015,4856 ,2374 ,2482 
E02000456,2004,Harrow 024,Harrow,E09000015,4491 ,2198 ,2293 
E02000457,2004,Harrow 025,Harrow,E09000015,4005 ,2048 ,1957 
E02000459,2004,Harrow 027,Harrow,E09000015,4583 ,2358 ,2225 
E02000460,2004,Harrow 028,Harrow,E09000015,4259 ,2132 ,2127 
E02000461,2004,Harrow 029,Harrow,E09000015,4513 ,2446 ,2067 
E02000462,2004,Harrow 030,Harrow,E09000015,4149 ,2125 ,2024 
E02000463,2004,Harrow 031,Harrow,E09000015,5371 ,2638 ,2733 
E02006795,2004,Harrow 032,Harrow,E09000015,5114 ,2580 ,2534 
E02006882,2004,Harrow 033,Harrow,E09000015,9027 ,4496 ,4531 
E02000464,2004,Havering 001,Havering,E09000016,3581 ,1761 ,1820 
E02000465,2004,Havering 002,Havering,E09000016,4690 ,2255 ,2435 
E02000466,2004,Havering 003,Havering,E09000016,4902 ,2352 ,2550 
E02000467,2004,Havering 004,Havering,E09000016,5500 ,2606 ,2894 
E02000468,2004,Havering 005,Havering,E09000016,4819 ,2338 ,2481 
E02000469,2004,Havering 006,Havering,E09000016,3847 ,1843 ,2004 
E02000470,2004,Havering 007,Havering,E09000016,5181 ,2520 ,2661 
E02000471,2004,Havering 008,Havering,E09000016,4664 ,2289 ,2375 
E02000472,2004,Havering 009,Havering,E09000016,5653 ,2815 ,2838 
E02000473,2004,Havering 010,Havering,E09000016,5778 ,2817 ,2961 
E02000474,2004,Havering 011,Havering,E09000016,4798 ,2370 ,2428 
E02000475,2004,Havering 012,Havering,E09000016,5463 ,2684 ,2779 
E02000476,2004,Havering 013,Havering,E09000016,4178 ,2109 ,2069 
E02000477,2004,Havering 014,Havering,E09000016,5885 ,2899 ,2986 
E02000478,2004,Havering 015,Havering,E09000016,3525 ,1745 ,1780 
E02000479,2004,Havering 016,Havering,E09000016,5239 ,2595 ,2644 
E02000480,2004,Havering 017,Havering,E09000016,5766 ,2918 ,2848 
E02000481,2004,Havering 018,Havering,E09000016,4485 ,2168 ,2317 
E02000482,2004,Havering 019,Havering,E09000016,3810 ,1864 ,1946 
E02000483,2004,Havering 020,Havering,E09000016,4549 ,2232 ,2317 
E02000484,2004,Havering 021,Havering,E09000016,5356 ,2647 ,2709 
E02000485,2004,Havering 022,Havering,E09000016,4767 ,2374 ,2393 
E02000486,2004,Havering 023,Havering,E09000016,4758 ,2389 ,2369 
E02000487,2004,Havering 024,Havering,E09000016,5000 ,2474 ,2526 
E02000488,2004,Havering 025,Havering,E09000016,4914 ,2456 ,2458 
E02000489,2004,Havering 026,Havering,E09000016,4719 ,2288 ,2431 
E02000490,2004,Havering 027,Havering,E09000016,4635 ,2237 ,2398 
E02000491,2004,Havering 028,Havering,E09000016,5384 ,2657 ,2727 
E02000492,2004,Havering 029,Havering,E09000016,3900 ,1932 ,1968 
E02000493,2004,Havering 030,Havering,E09000016,3912 ,1888 ,2024 
E02000494,2004,Hillingdon 001,Hillingdon,E09000017,4914 ,2364 ,2550 
E02000495,2004,Hillingdon 002,Hillingdon,E09000017,6093 ,2913 ,3180 
E02000496,2004,Hillingdon 003,Hillingdon,E09000017,4644 ,2270 ,2374 
E02000497,2004,Hillingdon 004,Hillingdon,E09000017,5005 ,2379 ,2626 
E02000498,2004,Hillingdon 005,Hillingdon,E09000017,3790 ,1793 ,1997 
E02000499,2004,Hillingdon 006,Hillingdon,E09000017,4693 ,2270 ,2423 
E02000500,2004,Hillingdon 007,Hillingdon,E09000017,4587 ,2300 ,2287 
E02000501,2004,Hillingdon 008,Hillingdon,E09000017,5203 ,2516 ,2687 
E02000502,2004,Hillingdon 009,Hillingdon,E09000017,4582 ,2275 ,2307 
E02000503,2004,Hillingdon 010,Hillingdon,E09000017,5474 ,2743 ,2731 
E02000504,2004,Hillingdon 011,Hillingdon,E09000017,4419 ,2203 ,2216 
E02000506,2004,Hillingdon 013,Hillingdon,E09000017,4597 ,2271 ,2326 
E02000507,2004,Hillingdon 014,Hillingdon,E09000017,5057 ,2514 ,2543 
E02000508,2004,Hillingdon 015,Hillingdon,E09000017,5492 ,2838 ,2654 
E02000509,2004,Hillingdon 016,Hillingdon,E09000017,6000 ,3137 ,2863 
E02000510,2004,Hillingdon 017,Hillingdon,E09000017,5220 ,2572 ,2648 
E02000511,2004,Hillingdon 018,Hillingdon,E09000017,5731 ,2820 ,2911 
E02000512,2004,Hillingdon 019,Hillingdon,E09000017,4907 ,2373 ,2534 
E02000513,2004,Hillingdon 020,Hillingdon,E09000017,5240 ,2487 ,2753 
E02000514,2004,Hillingdon 021,Hillingdon,E09000017,6058 ,3020 ,3038 
E02000515,2004,Hillingdon 022,Hillingdon,E09000017,6047 ,2984 ,3063 
E02000516,2004,Hillingdon 023,Hillingdon,E09000017,5246 ,2597 ,2649 
E02000517,2004,Hillingdon 024,Hillingdon,E09000017,4932 ,2418 ,2514 
E02000518,2004,Hillingdon 025,Hillingdon,E09000017,5287 ,2575 ,2712 
E02000519,2004,Hillingdon 026,Hillingdon,E09000017,4970 ,2464 ,2506 
E02000520,2004,Hillingdon 027,Hillingdon,E09000017,6235 ,3197 ,3038 
E02000521,2004,Hillingdon 028,Hillingdon,E09000017,5074 ,2501 ,2573 
E02000522,2004,Hillingdon 029,Hillingdon,E09000017,5011 ,2506 ,2505 
E02000523,2004,Hillingdon 030,Hillingdon,E09000017,5616 ,2942 ,2674 
E02000524,2004,Hillingdon 031,Hillingdon,E09000017,4338 ,2351 ,1987 
E02000525,2004,Hillingdon 032,Hillingdon,E09000017,5282 ,2651 ,2631 
E02006796,2004,Hillingdon 033,Hillingdon,E09000017,5337 ,2626 ,2711 
E02000526,2004,Hounslow 001,Hounslow,E09000018,5988 ,2973 ,3015 
E02000528,2004,Hounslow 003,Hounslow,E09000018,6162 ,3000 ,3162 
E02000529,2004,Hounslow 004,Hounslow,E09000018,5241 ,2647 ,2594 
E02000530,2004,Hounslow 005,Hounslow,E09000018,4196 ,2088 ,2108 
E02000531,2004,Hounslow 006,Hounslow,E09000018,5748 ,2763 ,2985 
E02000532,2004,Hounslow 007,Hounslow,E09000018,6353 ,3126 ,3227 
E02000533,2004,Hounslow 008,Hounslow,E09000018,5961 ,3069 ,2892 
E02000534,2004,Hounslow 009,Hounslow,E09000018,4450 ,2264 ,2186 
E02000535,2004,Hounslow 010,Hounslow,E09000018,5660 ,2921 ,2739 
E02000536,2004,Hounslow 011,Hounslow,E09000018,5772 ,2930 ,2842 
E02000537,2004,Hounslow 012,Hounslow,E09000018,5712 ,3028 ,2684 
E02000538,2004,Hounslow 013,Hounslow,E09000018,5437 ,2910 ,2527 
E02000539,2004,Hounslow 014,Hounslow,E09000018,5866 ,2848 ,3018 
E02000540,2004,Hounslow 015,Hounslow,E09000018,5577 ,2866 ,2711 
E02000541,2004,Hounslow 016,Hounslow,E09000018,5296 ,2735 ,2561 
E02000542,2004,Hounslow 017,Hounslow,E09000018,5355 ,2787 ,2568 
E02000543,2004,Hounslow 018,Hounslow,E09000018,5855 ,3041 ,2814 
E02000544,2004,Hounslow 019,Hounslow,E09000018,5094 ,2530 ,2564 
E02000545,2004,Hounslow 020,Hounslow,E09000018,5474 ,2601 ,2873 
E02000546,2004,Hounslow 021,Hounslow,E09000018,5712 ,3021 ,2691 
E02000547,2004,Hounslow 022,Hounslow,E09000018,5335 ,2693 ,2642 
E02000548,2004,Hounslow 023,Hounslow,E09000018,4791 ,2384 ,2407 
E02000549,2004,Hounslow 024,Hounslow,E09000018,6315 ,3229 ,3086 
E02000550,2004,Hounslow 025,Hounslow,E09000018,5135 ,2504 ,2631 
E02000551,2004,Hounslow 026,Hounslow,E09000018,5032 ,2390 ,2642 
E02000552,2004,Hounslow 027,Hounslow,E09000018,4782 ,2520 ,2262 
E02000553,2004,Hounslow 028,Hounslow,E09000018,4198 ,2071 ,2127 
E02006792,2004,Hounslow 029,Hounslow,E09000018,5969 ,3033 ,2936 
E02000554,2004,Islington 001,Islington,E09000019,6565 ,3146 ,3419 
E02000555,2004,Islington 002,Islington,E09000019,6434 ,3059 ,3375 
E02000556,2004,Islington 003,Islington,E09000019,7094 ,3445 ,3649 
E02000557,2004,Islington 004,Islington,E09000019,5825 ,2796 ,3029 
E02000558,2004,Islington 005,Islington,E09000019,5426 ,2565 ,2861 
E02000559,2004,Islington 006,Islington,E09000019,5609 ,2793 ,2816 
E02000560,2004,Islington 007,Islington,E09000019,5406 ,2654 ,2752 
E02000561,2004,Islington 008,Islington,E09000019,5053 ,2487 ,2566 
E02000562,2004,Islington 009,Islington,E09000019,5259 ,2553 ,2706 
E02000563,2004,Islington 010,Islington,E09000019,5754 ,2670 ,3084 
E02000564,2004,Islington 011,Islington,E09000019,5254 ,2595 ,2659 
E02000565,2004,Islington 012,Islington,E09000019,5056 ,2456 ,2600 
E02000566,2004,Islington 013,Islington,E09000019,5430 ,2677 ,2753 
E02000567,2004,Islington 014,Islington,E09000019,6888 ,3375 ,3513 
E02000568,2004,Islington 015,Islington,E09000019,5566 ,2950 ,2616 
E02000569,2004,Islington 016,Islington,E09000019,6480 ,3074 ,3406 
E02000570,2004,Islington 017,Islington,E09000019,5899 ,2935 ,2964 
E02000571,2004,Islington 018,Islington,E09000019,5269 ,2556 ,2713 
E02000572,2004,Islington 019,Islington,E09000019,5131 ,2492 ,2639 
E02000573,2004,Islington 020,Islington,E09000019,5750 ,2937 ,2813 
E02000574,2004,Islington 021,Islington,E09000019,5854 ,2924 ,2930 
E02000575,2004,Islington 022,Islington,E09000019,7177 ,3732 ,3445 
E02000576,2004,Islington 023,Islington,E09000019,5208 ,2593 ,2615 
E02000577,2004,Kensington and Chelsea 001,Kensington and Chelsea,E09000020,5111 ,2534 ,2577 
E02000578,2004,Kensington and Chelsea 002,Kensington and Chelsea,E09000020,4014 ,1924 ,2090 
E02000579,2004,Kensington and Chelsea 003,Kensington and Chelsea,E09000020,5487 ,2547 ,2940 
E02000580,2004,Kensington and Chelsea 004,Kensington and Chelsea,E09000020,6403 ,3177 ,3226 
E02000581,2004,Kensington and Chelsea 005,Kensington and Chelsea,E09000020,4973 ,2409 ,2564 
E02000582,2004,Kensington and Chelsea 006,Kensington and Chelsea,E09000020,6435 ,3200 ,3235 
E02000583,2004,Kensington and Chelsea 007,Kensington and Chelsea,E09000020,5620 ,2716 ,2904 
E02000584,2004,Kensington and Chelsea 008,Kensington and Chelsea,E09000020,6204 ,3058 ,3146 
E02000585,2004,Kensington and Chelsea 009,Kensington and Chelsea,E09000020,6699 ,3242 ,3457 
E02000586,2004,Kensington and Chelsea 010,Kensington and Chelsea,E09000020,6346 ,3176 ,3170 
E02000587,2004,Kensington and Chelsea 011,Kensington and Chelsea,E09000020,5584 ,2774 ,2810 
E02000588,2004,Kensington and Chelsea 012,Kensington and Chelsea,E09000020,6248 ,3029 ,3219 
E02000589,2004,Kensington and Chelsea 013,Kensington and Chelsea,E09000020,7088 ,3899 ,3189 
E02000590,2004,Kensington and Chelsea 014,Kensington and Chelsea,E09000020,5690 ,2654 ,3036 
E02000591,2004,Kensington and Chelsea 015,Kensington and Chelsea,E09000020,5485 ,2947 ,2538 
E02000592,2004,Kensington and Chelsea 016,Kensington and Chelsea,E09000020,6034 ,2987 ,3047 
E02000593,2004,Kensington and Chelsea 017,Kensington and Chelsea,E09000020,6084 ,3222 ,2862 
E02000594,2004,Kensington and Chelsea 018,Kensington and Chelsea,E09000020,5192 ,2437 ,2755 
E02000595,2004,Kensington and Chelsea 019,Kensington and Chelsea,E09000020,5465 ,2561 ,2904 
E02000596,2004,Kensington and Chelsea 020,Kensington and Chelsea,E09000020,6132 ,3029 ,3103 
E02000597,2004,Kensington and Chelsea 021,Kensington and Chelsea,E09000020,5747 ,2750 ,2997 
E02000598,2004,Kingston upon Thames 001,Kingston upon Thames,E09000021,4710 ,2298 ,2412 
E02000599,2004,Kingston upon Thames 002,Kingston upon Thames,E09000021,4828 ,2394 ,2434 
E02000600,2004,Kingston upon Thames 003,Kingston upon Thames,E09000021,5711 ,2874 ,2837 
E02000601,2004,Kingston upon Thames 004,Kingston upon Thames,E09000021,5973 ,2926 ,3047 
E02000602,2004,Kingston upon Thames 005,Kingston upon Thames,E09000021,5820 ,3018 ,2802 
E02000603,2004,Kingston upon Thames 006,Kingston upon Thames,E09000021,5143 ,2544 ,2599 
E02000604,2004,Kingston upon Thames 007,Kingston upon Thames,E09000021,5573 ,2854 ,2719 
E02000605,2004,Kingston upon Thames 008,Kingston upon Thames,E09000021,5212 ,2605 ,2607 
E02000606,2004,Kingston upon Thames 009,Kingston upon Thames,E09000021,6581 ,3531 ,3050 
E02000607,2004,Kingston upon Thames 010,Kingston upon Thames,E09000021,4764 ,2466 ,2298 
E02000608,2004,Kingston upon Thames 011,Kingston upon Thames,E09000021,5249 ,2763 ,2486 
E02000609,2004,Kingston upon Thames 012,Kingston upon Thames,E09000021,4739 ,2380 ,2359 
E02000610,2004,Kingston upon Thames 013,Kingston upon Thames,E09000021,5581 ,2930 ,2651 
E02000611,2004,Kingston upon Thames 014,Kingston upon Thames,E09000021,4956 ,2482 ,2474 
E02000612,2004,Kingston upon Thames 015,Kingston upon Thames,E09000021,5221 ,2601 ,2620 
E02000613,2004,Kingston upon Thames 016,Kingston upon Thames,E09000021,5211 ,2588 ,2623 
E02000614,2004,Kingston upon Thames 017,Kingston upon Thames,E09000021,5682 ,2858 ,2824 
E02000615,2004,Kingston upon Thames 018,Kingston upon Thames,E09000021,4968 ,2482 ,2486 
E02000616,2004,Kingston upon Thames 019,Kingston upon Thames,E09000021,4041 ,1997 ,2044 
E02000617,2004,Kingston upon Thames 020,Kingston upon Thames,E09000021,5307 ,2530 ,2777 
E02000619,2004,Lambeth 002,Lambeth,E09000022,5425 ,2806 ,2619 
E02000620,2004,Lambeth 003,Lambeth,E09000022,5679 ,2963 ,2716 
E02000621,2004,Lambeth 004,Lambeth,E09000022,6395 ,3478 ,2917 
E02000622,2004,Lambeth 005,Lambeth,E09000022,5651 ,3015 ,2636 
E02000623,2004,Lambeth 006,Lambeth,E09000022,5424 ,2824 ,2600 
E02000624,2004,Lambeth 007,Lambeth,E09000022,5447 ,2715 ,2732 
E02000625,2004,Lambeth 008,Lambeth,E09000022,5763 ,2920 ,2843 
E02000626,2004,Lambeth 009,Lambeth,E09000022,5613 ,2770 ,2843 
E02000627,2004,Lambeth 010,Lambeth,E09000022,6329 ,3329 ,3000 
E02000628,2004,Lambeth 011,Lambeth,E09000022,6613 ,3381 ,3232 
E02000629,2004,Lambeth 012,Lambeth,E09000022,6223 ,3255 ,2968 
E02000630,2004,Lambeth 013,Lambeth,E09000022,4938 ,2516 ,2422 
E02000631,2004,Lambeth 014,Lambeth,E09000022,6213 ,3132 ,3081 
E02000632,2004,Lambeth 015,Lambeth,E09000022,6996 ,3648 ,3348 
E02000633,2004,Lambeth 016,Lambeth,E09000022,5721 ,2992 ,2729 
E02000634,2004,Lambeth 017,Lambeth,E09000022,4703 ,2481 ,2222 
E02000635,2004,Lambeth 018,Lambeth,E09000022,6208 ,3201 ,3007 
E02000636,2004,Lambeth 019,Lambeth,E09000022,5175 ,2698 ,2477 
E02000637,2004,Lambeth 020,Lambeth,E09000022,6257 ,3347 ,2910 
E02000638,2004,Lambeth 021,Lambeth,E09000022,6011 ,3078 ,2933 
E02000639,2004,Lambeth 022,Lambeth,E09000022,5632 ,2745 ,2887 
E02000640,2004,Lambeth 023,Lambeth,E09000022,6332 ,3288 ,3044 
E02000641,2004,Lambeth 024,Lambeth,E09000022,5673 ,2753 ,2920 
E02000642,2004,Lambeth 025,Lambeth,E09000022,6323 ,3136 ,3187 
E02000643,2004,Lambeth 026,Lambeth,E09000022,5547 ,2881 ,2666 
E02000644,2004,Lambeth 027,Lambeth,E09000022,5449 ,2797 ,2652 
E02000645,2004,Lambeth 028,Lambeth,E09000022,5569 ,2806 ,2763 
E02000646,2004,Lambeth 029,Lambeth,E09000022,5686 ,2939 ,2747 
E02000647,2004,Lambeth 030,Lambeth,E09000022,5206 ,2596 ,2610 
E02000648,2004,Lambeth 031,Lambeth,E09000022,4451 ,2116 ,2335 
E02000649,2004,Lambeth 032,Lambeth,E09000022,6894 ,3506 ,3388 
E02000650,2004,Lambeth 033,Lambeth,E09000022,5202 ,2481 ,2721 
E02000651,2004,Lambeth 034,Lambeth,E09000022,5307 ,2708 ,2599 
E02000652,2004,Lambeth 035,Lambeth,E09000022,4247 ,2059 ,2188 
E02006801,2004,Lambeth 036,Lambeth,E09000022,5845 ,3042 ,2803 
E02000653,2004,Lewisham 001,Lewisham,E09000023,4782 ,2474 ,2308 
E02000654,2004,Lewisham 002,Lewisham,E09000023,4910 ,2331 ,2579 
E02000655,2004,Lewisham 003,Lewisham,E09000023,5045 ,2596 ,2449 
E02000657,2004,Lewisham 005,Lewisham,E09000023,6221 ,3029 ,3192 
E02000658,2004,Lewisham 006,Lewisham,E09000023,5329 ,2696 ,2633 
E02000659,2004,Lewisham 007,Lewisham,E09000023,5343 ,2659 ,2684 
E02000660,2004,Lewisham 008,Lewisham,E09000023,5212 ,2712 ,2500 
E02000661,2004,Lewisham 009,Lewisham,E09000023,4239 ,2197 ,2042 
E02000662,2004,Lewisham 010,Lewisham,E09000023,5433 ,2721 ,2712 
E02000663,2004,Lewisham 011,Lewisham,E09000023,5133 ,2631 ,2502 
E02000664,2004,Lewisham 012,Lewisham,E09000023,5940 ,3086 ,2854 
E02000665,2004,Lewisham 013,Lewisham,E09000023,5012 ,2491 ,2521 
E02000666,2004,Lewisham 014,Lewisham,E09000023,5000 ,2489 ,2511 
E02000667,2004,Lewisham 015,Lewisham,E09000023,4491 ,2264 ,2227 
E02000668,2004,Lewisham 016,Lewisham,E09000023,4227 ,2110 ,2117 
E02000669,2004,Lewisham 017,Lewisham,E09000023,4465 ,2343 ,2122 
E02000670,2004,Lewisham 018,Lewisham,E09000023,3961 ,1945 ,2016 
E02000671,2004,Lewisham 019,Lewisham,E09000023,5411 ,2721 ,2690 
E02000672,2004,Lewisham 020,Lewisham,E09000023,4949 ,2516 ,2433 
E02000673,2004,Lewisham 021,Lewisham,E09000023,5215 ,2676 ,2539 
E02000674,2004,Lewisham 022,Lewisham,E09000023,5167 ,2498 ,2669 
E02000675,2004,Lewisham 023,Lewisham,E09000023,5284 ,2617 ,2667 
E02000676,2004,Lewisham 024,Lewisham,E09000023,5014 ,2504 ,2510 
E02000677,2004,Lewisham 025,Lewisham,E09000023,4532 ,2298 ,2234 
E02000678,2004,Lewisham 026,Lewisham,E09000023,3722 ,1790 ,1932 
E02000679,2004,Lewisham 027,Lewisham,E09000023,5100 ,2524 ,2576 
E02000680,2004,Lewisham 028,Lewisham,E09000023,4326 ,2170 ,2156 
E02000681,2004,Lewisham 029,Lewisham,E09000023,5005 ,2399 ,2606 
E02000682,2004,Lewisham 030,Lewisham,E09000023,4658 ,2239 ,2419 
E02000683,2004,Lewisham 031,Lewisham,E09000023,4023 ,1938 ,2085 
E02000685,2004,Lewisham 033,Lewisham,E09000023,5032 ,2351 ,2681 
E02000686,2004,Lewisham 034,Lewisham,E09000023,4252 ,1977 ,2275 
E02000687,2004,Lewisham 035,Lewisham,E09000023,5166 ,2548 ,2618 
E02006783,2004,Lewisham 037,Lewisham,E09000023,4362 ,2094 ,2268 
E02006784,2004,Lewisham 038,Lewisham,E09000023,4285 ,2138 ,2147 
E02006798,2004,Lewisham 039,Lewisham,E09000023,5522 ,2746 ,2776 
E02000689,2004,Merton 001,Merton,E09000024,5099 ,2606 ,2493 
E02000690,2004,Merton 002,Merton,E09000024,3591 ,1777 ,1814 
E02000691,2004,Merton 003,Merton,E09000024,5352 ,2747 ,2605 
E02000692,2004,Merton 004,Merton,E09000024,5428 ,2901 ,2527 
E02000693,2004,Merton 005,Merton,E09000024,6205 ,3148 ,3057 
E02000694,2004,Merton 006,Merton,E09000024,6395 ,3199 ,3196 
E02000695,2004,Merton 007,Merton,E09000024,5799 ,3046 ,2753 
E02000696,2004,Merton 008,Merton,E09000024,5620 ,2838 ,2782 
E02000697,2004,Merton 009,Merton,E09000024,6313 ,3226 ,3087 
E02000698,2004,Merton 010,Merton,E09000024,5229 ,2612 ,2617 
E02000699,2004,Merton 011,Merton,E09000024,5648 ,2897 ,2751 
E02000700,2004,Merton 012,Merton,E09000024,5659 ,2757 ,2902 
E02000701,2004,Merton 013,Merton,E09000024,4865 ,2482 ,2383 
E02000702,2004,Merton 014,Merton,E09000024,4853 ,2329 ,2524 
E02000703,2004,Merton 015,Merton,E09000024,5174 ,2619 ,2555 
E02000704,2004,Merton 016,Merton,E09000024,5366 ,2719 ,2647 
E02000705,2004,Merton 017,Merton,E09000024,5015 ,2443 ,2572 
E02000706,2004,Merton 018,Merton,E09000024,4923 ,2392 ,2531 
E02000707,2004,Merton 019,Merton,E09000024,4629 ,2259 ,2370 
E02000708,2004,Merton 020,Merton,E09000024,5456 ,2725 ,2731 
E02000709,2004,Merton 021,Merton,E09000024,4923 ,2467 ,2456 
E02000710,2004,Merton 022,Merton,E09000024,4916 ,2390 ,2526 
E02000711,2004,Merton 023,Merton,E09000024,5048 ,2550 ,2498 
E02000712,2004,Merton 024,Merton,E09000024,4747 ,2299 ,2448 
E02000713,2004,Merton 025,Merton,E09000024,4477 ,2215 ,2262 
E02000714,2004,Newham 001,Newham,E09000025,4496 ,2268 ,2228 
E02000715,2004,Newham 002,Newham,E09000025,3958 ,2009 ,1949 
E02000716,2004,Newham 003,Newham,E09000025,4084 ,2141 ,1943 
E02000717,2004,Newham 004,Newham,E09000025,4404 ,2310 ,2094 
E02000718,2004,Newham 005,Newham,E09000025,3709 ,1812 ,1897 
E02000719,2004,Newham 006,Newham,E09000025,4552 ,2325 ,2227 
E02000720,2004,Newham 007,Newham,E09000025,4353 ,2352 ,2001 
E02000721,2004,Newham 008,Newham,E09000025,5474 ,2924 ,2550 
E02000722,2004,Newham 009,Newham,E09000025,4785 ,2466 ,2319 
E02000723,2004,Newham 010,Newham,E09000025,6059 ,3391 ,2668 
E02000724,2004,Newham 011,Newham,E09000025,5356 ,2979 ,2377 
E02000725,2004,Newham 012,Newham,E09000025,4623 ,2359 ,2264 
E02000726,2004,Newham 013,Newham,E09000025,5099 ,2627 ,2472 
E02000727,2004,Newham 014,Newham,E09000025,4600 ,2533 ,2067 
E02000728,2004,Newham 015,Newham,E09000025,5784 ,3283 ,2501 
E02000729,2004,Newham 016,Newham,E09000025,4142 ,2195 ,1947 
E02000730,2004,Newham 017,Newham,E09000025,5175 ,2794 ,2381 
E02000731,2004,Newham 018,Newham,E09000025,5550 ,3159 ,2391 
E02000732,2004,Newham 019,Newham,E09000025,3942 ,2080 ,1862 
E02000733,2004,Newham 020,Newham,E09000025,5721 ,2839 ,2882 
E02000734,2004,Newham 021,Newham,E09000025,3917 ,1946 ,1971 
E02000735,2004,Newham 022,Newham,E09000025,4005 ,2144 ,1861 
E02000736,2004,Newham 023,Newham,E09000025,4802 ,2447 ,2355 
E02000737,2004,Newham 024,Newham,E09000025,5036 ,2573 ,2463 
E02000738,2004,Newham 025,Newham,E09000025,4449 ,2274 ,2175 
E02000739,2004,Newham 026,Newham,E09000025,4012 ,2053 ,1959 
E02000740,2004,Newham 027,Newham,E09000025,4041 ,1936 ,2105 
E02000741,2004,Newham 028,Newham,E09000025,4502 ,2192 ,2310 
E02000742,2004,Newham 029,Newham,E09000025,4104 ,2088 ,2016 
E02000743,2004,Newham 030,Newham,E09000025,4224 ,2092 ,2132 
E02000744,2004,Newham 031,Newham,E09000025,4238 ,2114 ,2124 
E02000745,2004,Newham 032,Newham,E09000025,5131 ,2552 ,2579 
E02000746,2004,Newham 033,Newham,E09000025,3894 ,1849 ,2045 
E02000747,2004,Newham 034,Newham,E09000025,5484 ,2686 ,2798 
E02000748,2004,Newham 035,Newham,E09000025,4038 ,2001 ,2037 
E02000749,2004,Newham 036,Newham,E09000025,4727 ,2265 ,2462 
E02000750,2004,Newham 037,Newham,E09000025,5464 ,2810 ,2654 
E02000751,2004,Redbridge 001,Redbridge,E09000026,6423 ,3130 ,3293 
E02000752,2004,Redbridge 002,Redbridge,E09000026,3706 ,1791 ,1915 
E02000753,2004,Redbridge 003,Redbridge,E09000026,3505 ,1673 ,1832 
E02000754,2004,Redbridge 004,Redbridge,E09000026,4126 ,2004 ,2122 
E02000755,2004,Redbridge 005,Redbridge,E09000026,3419 ,1649 ,1770 
E02000756,2004,Redbridge 006,Redbridge,E09000026,7440 ,3599 ,3841 
E02000757,2004,Redbridge 007,Redbridge,E09000026,6665 ,3369 ,3296 
E02000758,2004,Redbridge 008,Redbridge,E09000026,3636 ,1779 ,1857 
E02000759,2004,Redbridge 009,Redbridge,E09000026,7507 ,3716 ,3791 
E02000760,2004,Redbridge 010,Redbridge,E09000026,3697 ,1802 ,1895 
E02000762,2004,Redbridge 012,Redbridge,E09000026,3735 ,1857 ,1878 
E02000763,2004,Redbridge 013,Redbridge,E09000026,4100 ,2012 ,2088 
E02000764,2004,Redbridge 014,Redbridge,E09000026,7425 ,3628 ,3797 
E02000765,2004,Redbridge 015,Redbridge,E09000026,3776 ,1898 ,1878 
E02000767,2004,Redbridge 017,Redbridge,E09000026,4088 ,1999 ,2089 
E02000768,2004,Redbridge 018,Redbridge,E09000026,3775 ,1867 ,1908 
E02000769,2004,Redbridge 019,Redbridge,E09000026,7505 ,3603 ,3902 
E02000770,2004,Redbridge 020,Redbridge,E09000026,4430 ,2260 ,2170 
E02000772,2004,Redbridge 022,Redbridge,E09000026,4243 ,2166 ,2077 
E02000773,2004,Redbridge 023,Redbridge,E09000026,4953 ,2478 ,2475 
E02000774,2004,Redbridge 024,Redbridge,E09000026,4515 ,2352 ,2163 
E02000776,2004,Redbridge 026,Redbridge,E09000026,3953 ,2008 ,1945 
E02000777,2004,Redbridge 027,Redbridge,E09000026,3880 ,1946 ,1934 
E02000779,2004,Redbridge 029,Redbridge,E09000026,4774 ,2553 ,2221 
E02000780,2004,Redbridge 030,Redbridge,E09000026,8023 ,4190 ,3833 
E02000781,2004,Redbridge 031,Redbridge,E09000026,7679 ,3943 ,3736 
E02000782,2004,Redbridge 032,Redbridge,E09000026,5317 ,2772 ,2545 
E02000783,2004,Redbridge 033,Redbridge,E09000026,3903 ,1946 ,1957 
E02006800,2004,Redbridge 034,Redbridge,E09000026,8014 ,4091 ,3923 
E02006924,2004,Redbridge 035,Redbridge,E09000026,8109 ,4188 ,3921 
E02006925,2004,Redbridge 036,Redbridge,E09000026,7969 ,3952 ,4017 
E02000784,2004,Richmond upon Thames 001,Richmond upon Thames,E09000027,7012 ,3444 ,3568 
E02000785,2004,Richmond upon Thames 002,Richmond upon Thames,E09000027,6715 ,3353 ,3362 
E02000786,2004,Richmond upon Thames 003,Richmond upon Thames,E09000027,7666 ,3827 ,3839 
E02000787,2004,Richmond upon Thames 004,Richmond upon Thames,E09000027,6460 ,3242 ,3218 
E02000788,2004,Richmond upon Thames 005,Richmond upon Thames,E09000027,5697 ,2789 ,2908 
E02000789,2004,Richmond upon Thames 006,Richmond upon Thames,E09000027,4425 ,2321 ,2104 
E02000790,2004,Richmond upon Thames 007,Richmond upon Thames,E09000027,4158 ,2088 ,2070 
E02000791,2004,Richmond upon Thames 008,Richmond upon Thames,E09000027,4733 ,2502 ,2231 
E02000792,2004,Richmond upon Thames 009,Richmond upon Thames,E09000027,5098 ,2604 ,2494 
E02000793,2004,Richmond upon Thames 010,Richmond upon Thames,E09000027,5096 ,2574 ,2522 
E02000794,2004,Richmond upon Thames 011,Richmond upon Thames,E09000027,4199 ,2064 ,2135 
E02000795,2004,Richmond upon Thames 012,Richmond upon Thames,E09000027,4187 ,2176 ,2011 
E02000796,2004,Richmond upon Thames 013,Richmond upon Thames,E09000027,6346 ,3209 ,3137 
E02000797,2004,Richmond upon Thames 014,Richmond upon Thames,E09000027,4987 ,2524 ,2463 
E02000798,2004,Richmond upon Thames 015,Richmond upon Thames,E09000027,7229 ,3568 ,3661 
E02000799,2004,Richmond upon Thames 016,Richmond upon Thames,E09000027,4367 ,2143 ,2224 
E02000800,2004,Richmond upon Thames 017,Richmond upon Thames,E09000027,3454 ,1719 ,1735 
E02000801,2004,Richmond upon Thames 018,Richmond upon Thames,E09000027,4650 ,2252 ,2398 
E02000802,2004,Richmond upon Thames 019,Richmond upon Thames,E09000027,4238 ,2088 ,2150 
E02000803,2004,Richmond upon Thames 020,Richmond upon Thames,E09000027,6058 ,2947 ,3111 
E02000804,2004,Richmond upon Thames 021,Richmond upon Thames,E09000027,4675 ,2283 ,2392 
E02000805,2004,Richmond upon Thames 022,Richmond upon Thames,E09000027,6405 ,3128 ,3277 
E02000806,2004,Richmond upon Thames 023,Richmond upon Thames,E09000027,6250 ,3030 ,3220 
E02000807,2004,Southwark 001,Southwark,E09000028,5959 ,3214 ,2745 
E02000808,2004,Southwark 002,Southwark,E09000028,6049 ,3205 ,2844 
E02000809,2004,Southwark 003,Southwark,E09000028,7476 ,4227 ,3249 
E02000810,2004,Southwark 004,Southwark,E09000028,5280 ,2761 ,2519 
E02000812,2004,Southwark 006,Southwark,E09000028,6515 ,3417 ,3098 
E02000813,2004,Southwark 007,Southwark,E09000028,5248 ,2733 ,2515 
E02000814,2004,Southwark 008,Southwark,E09000028,5951 ,3283 ,2668 
E02000815,2004,Southwark 009,Southwark,E09000028,6211 ,3418 ,2793 
E02000816,2004,Southwark 010,Southwark,E09000028,5355 ,2684 ,2671 
E02000817,2004,Southwark 011,Southwark,E09000028,4000 ,1897 ,2103 
E02000818,2004,Southwark 012,Southwark,E09000028,5201 ,2604 ,2597 
E02000819,2004,Southwark 013,Southwark,E09000028,4926 ,2537 ,2389 
E02000820,2004,Southwark 014,Southwark,E09000028,4991 ,2521 ,2470 
E02000821,2004,Southwark 015,Southwark,E09000028,5321 ,2611 ,2710 
E02000822,2004,Southwark 016,Southwark,E09000028,5482 ,2718 ,2764 
E02000823,2004,Southwark 017,Southwark,E09000028,4915 ,2481 ,2434 
E02000824,2004,Southwark 018,Southwark,E09000028,5729 ,2763 ,2966 
E02000825,2004,Southwark 019,Southwark,E09000028,5053 ,2399 ,2654 
E02000826,2004,Southwark 020,Southwark,E09000028,5448 ,2634 ,2814 
E02000827,2004,Southwark 021,Southwark,E09000028,6291 ,3137 ,3154 
E02000828,2004,Southwark 022,Southwark,E09000028,5451 ,2722 ,2729 
E02000829,2004,Southwark 023,Southwark,E09000028,6006 ,3055 ,2951 
E02000830,2004,Southwark 024,Southwark,E09000028,5616 ,2790 ,2826 
E02000831,2004,Southwark 025,Southwark,E09000028,5687 ,2846 ,2841 
E02000832,2004,Southwark 026,Southwark,E09000028,5666 ,2740 ,2926 
E02000833,2004,Southwark 027,Southwark,E09000028,5101 ,2344 ,2757 
E02000834,2004,Southwark 028,Southwark,E09000028,6298 ,3073 ,3225 
E02000835,2004,Southwark 029,Southwark,E09000028,4616 ,2248 ,2368 
E02000836,2004,Southwark 030,Southwark,E09000028,5661 ,2750 ,2911 
E02000837,2004,Southwark 031,Southwark,E09000028,5087 ,2451 ,2636 
E02000838,2004,Southwark 032,Southwark,E09000028,5908 ,2867 ,3041 
E02000839,2004,Southwark 033,Southwark,E09000028,5238 ,2620 ,2618 
E02006802,2004,Southwark 034,Southwark,E09000028,5528 ,2760 ,2768 
E02000840,2004,Sutton 001,Sutton,E09000029,4852 ,2321 ,2531 
E02000841,2004,Sutton 002,Sutton,E09000029,4940 ,2408 ,2532 
E02000842,2004,Sutton 003,Sutton,E09000029,4892 ,2441 ,2451 
E02000843,2004,Sutton 004,Sutton,E09000029,5329 ,2603 ,2726 
E02000844,2004,Sutton 005,Sutton,E09000029,4896 ,2381 ,2515 
E02000845,2004,Sutton 006,Sutton,E09000029,4837 ,2310 ,2527 
E02000846,2004,Sutton 007,Sutton,E09000029,4325 ,2134 ,2191 
E02000847,2004,Sutton 008,Sutton,E09000029,5530 ,2733 ,2797 
E02000848,2004,Sutton 009,Sutton,E09000029,4901 ,2417 ,2484 
E02000849,2004,Sutton 010,Sutton,E09000029,4900 ,2416 ,2484 
E02000850,2004,Sutton 011,Sutton,E09000029,6659 ,3325 ,3334 
E02000851,2004,Sutton 012,Sutton,E09000029,5072 ,2690 ,2382 
E02000852,2004,Sutton 013,Sutton,E09000029,4966 ,2468 ,2498 
E02000853,2004,Sutton 014,Sutton,E09000029,4916 ,2462 ,2454 
E02000854,2004,Sutton 015,Sutton,E09000029,4561 ,2218 ,2343 
E02000855,2004,Sutton 016,Sutton,E09000029,4670 ,2294 ,2376 
E02000856,2004,Sutton 017,Sutton,E09000029,5376 ,2715 ,2661 
E02000857,2004,Sutton 018,Sutton,E09000029,5170 ,2634 ,2536 
E02000858,2004,Sutton 019,Sutton,E09000029,4607 ,2220 ,2387 
E02000859,2004,Sutton 020,Sutton,E09000029,5195 ,2579 ,2616 
E02000860,2004,Sutton 021,Sutton,E09000029,4970 ,2594 ,2376 
E02000861,2004,Sutton 022,Sutton,E09000029,5012 ,2496 ,2516 
E02000863,2004,Sutton 024,Sutton,E09000029,4113 ,2035 ,2078 
E02006836,2004,Sutton 025,Sutton,E09000029,5097 ,2525 ,2572 
E02000864,2004,Tower Hamlets 001,Tower Hamlets,E09000030,4321 ,2073 ,2248 
E02000865,2004,Tower Hamlets 002,Tower Hamlets,E09000030,4389 ,2174 ,2215 
E02000866,2004,Tower Hamlets 003,Tower Hamlets,E09000030,6070 ,3056 ,3014 
E02000867,2004,Tower Hamlets 004,Tower Hamlets,E09000030,4621 ,2321 ,2300 
E02000868,2004,Tower Hamlets 005,Tower Hamlets,E09000030,4161 ,2055 ,2106 
E02000869,2004,Tower Hamlets 006,Tower Hamlets,E09000030,3605 ,1897 ,1708 
E02000870,2004,Tower Hamlets 007,Tower Hamlets,E09000030,3882 ,1943 ,1939 
E02000871,2004,Tower Hamlets 008,Tower Hamlets,E09000030,4756 ,2376 ,2380 
E02000872,2004,Tower Hamlets 009,Tower Hamlets,E09000030,4509 ,2395 ,2114 
E02000873,2004,Tower Hamlets 010,Tower Hamlets,E09000030,4492 ,2206 ,2286 
E02000874,2004,Tower Hamlets 011,Tower Hamlets,E09000030,4817 ,2433 ,2384 
E02000875,2004,Tower Hamlets 012,Tower Hamlets,E09000030,5170 ,2628 ,2542 
E02000876,2004,Tower Hamlets 013,Tower Hamlets,E09000030,4746 ,2550 ,2196 
E02000877,2004,Tower Hamlets 014,Tower Hamlets,E09000030,5907 ,2968 ,2939 
E02000878,2004,Tower Hamlets 015,Tower Hamlets,E09000030,7098 ,4035 ,3063 
E02000879,2004,Tower Hamlets 016,Tower Hamlets,E09000030,4322 ,2159 ,2163 
E02000880,2004,Tower Hamlets 017,Tower Hamlets,E09000030,4014 ,2018 ,1996 
E02000881,2004,Tower Hamlets 018,Tower Hamlets,E09000030,3781 ,1878 ,1903 
E02000882,2004,Tower Hamlets 019,Tower Hamlets,E09000030,4637 ,2325 ,2312 
E02000883,2004,Tower Hamlets 020,Tower Hamlets,E09000030,4080 ,2005 ,2075 
E02000884,2004,Tower Hamlets 021,Tower Hamlets,E09000030,5730 ,3167 ,2563 
E02000885,2004,Tower Hamlets 022,Tower Hamlets,E09000030,3821 ,2021 ,1800 
E02000886,2004,Tower Hamlets 023,Tower Hamlets,E09000030,4378 ,2376 ,2002 
E02000887,2004,Tower Hamlets 024,Tower Hamlets,E09000030,4660 ,2333 ,2327 
E02000888,2004,Tower Hamlets 025,Tower Hamlets,E09000030,4692 ,2607 ,2085 
E02000889,2004,Tower Hamlets 026,Tower Hamlets,E09000030,4815 ,2655 ,2160 
E02000890,2004,Tower Hamlets 027,Tower Hamlets,E09000030,4527 ,2491 ,2036 
E02000891,2004,Tower Hamlets 028,Tower Hamlets,E09000030,6133 ,3386 ,2747 
E02000893,2004,Tower Hamlets 030,Tower Hamlets,E09000030,4880 ,2531 ,2349 
E02000894,2004,Tower Hamlets 031,Tower Hamlets,E09000030,6778 ,3632 ,3146 
E02006853,2004,Tower Hamlets 032,Tower Hamlets,E09000030,2550 ,1361 ,1189 
E02006854,2004,Tower Hamlets 033,Tower Hamlets,E09000030,2484 ,1404 ,1080 
E02000895,2004,Waltham Forest 001,Waltham Forest,E09000031,4522 ,2186 ,2336 
E02000896,2004,Waltham Forest 002,Waltham Forest,E09000031,5164 ,2570 ,2594 
E02000897,2004,Waltham Forest 003,Waltham Forest,E09000031,4471 ,2119 ,2352 
E02000898,2004,Waltham Forest 004,Waltham Forest,E09000031,4686 ,2268 ,2418 
E02000899,2004,Waltham Forest 005,Waltham Forest,E09000031,4772 ,2328 ,2444 
E02000900,2004,Waltham Forest 006,Waltham Forest,E09000031,4864 ,2375 ,2489 
E02000901,2004,Waltham Forest 007,Waltham Forest,E09000031,5775 ,2837 ,2938 
E02000902,2004,Waltham Forest 008,Waltham Forest,E09000031,4985 ,2432 ,2553 
E02000903,2004,Waltham Forest 009,Waltham Forest,E09000031,5312 ,2599 ,2713 
E02000904,2004,Waltham Forest 010,Waltham Forest,E09000031,4372 ,2171 ,2201 
E02000905,2004,Waltham Forest 011,Waltham Forest,E09000031,5612 ,2805 ,2807 
E02000906,2004,Waltham Forest 012,Waltham Forest,E09000031,5795 ,2948 ,2847 
E02000907,2004,Waltham Forest 013,Waltham Forest,E09000031,5712 ,2800 ,2912 
E02000908,2004,Waltham Forest 014,Waltham Forest,E09000031,6026 ,3177 ,2849 
E02000909,2004,Waltham Forest 015,Waltham Forest,E09000031,5236 ,2667 ,2569 
E02000910,2004,Waltham Forest 016,Waltham Forest,E09000031,6688 ,3425 ,3263 
E02000911,2004,Waltham Forest 017,Waltham Forest,E09000031,6158 ,3087 ,3071 
E02000912,2004,Waltham Forest 018,Waltham Forest,E09000031,5301 ,2641 ,2660 
E02000913,2004,Waltham Forest 019,Waltham Forest,E09000031,5441 ,2757 ,2684 
E02000914,2004,Waltham Forest 020,Waltham Forest,E09000031,6352 ,3264 ,3088 
E02000915,2004,Waltham Forest 021,Waltham Forest,E09000031,5792 ,3000 ,2792 
E02000916,2004,Waltham Forest 022,Waltham Forest,E09000031,5449 ,2756 ,2693 
E02000917,2004,Waltham Forest 023,Waltham Forest,E09000031,5382 ,2782 ,2600 
E02000918,2004,Waltham Forest 024,Waltham Forest,E09000031,5556 ,2866 ,2690 
E02000919,2004,Waltham Forest 025,Waltham Forest,E09000031,5666 ,2975 ,2691 
E02000920,2004,Waltham Forest 026,Waltham Forest,E09000031,5674 ,2858 ,2816 
E02000921,2004,Waltham Forest 027,Waltham Forest,E09000031,6483 ,3257 ,3226 
E02000922,2004,Waltham Forest 028,Waltham Forest,E09000031,6284 ,3219 ,3065 
E02000923,2004,Wandsworth 001,Wandsworth,E09000032,5174 ,2670 ,2504 
E02000924,2004,Wandsworth 002,Wandsworth,E09000032,6460 ,3192 ,3268 
E02000925,2004,Wandsworth 003,Wandsworth,E09000032,4921 ,2397 ,2524 
E02000926,2004,Wandsworth 004,Wandsworth,E09000032,5224 ,2631 ,2593 
E02000927,2004,Wandsworth 005,Wandsworth,E09000032,5271 ,2591 ,2680 
E02000928,2004,Wandsworth 006,Wandsworth,E09000032,6194 ,3066 ,3128 
E02000929,2004,Wandsworth 007,Wandsworth,E09000032,4412 ,2103 ,2309 
E02000930,2004,Wandsworth 008,Wandsworth,E09000032,6930 ,3390 ,3540 
E02000931,2004,Wandsworth 009,Wandsworth,E09000032,6482 ,3290 ,3192 
E02000932,2004,Wandsworth 010,Wandsworth,E09000032,6857 ,3407 ,3450 
E02000933,2004,Wandsworth 011,Wandsworth,E09000032,5918 ,2832 ,3086 
E02000934,2004,Wandsworth 012,Wandsworth,E09000032,6527 ,3253 ,3274 
E02000935,2004,Wandsworth 013,Wandsworth,E09000032,4065 ,1635 ,2430 
E02000936,2004,Wandsworth 014,Wandsworth,E09000032,6127 ,3014 ,3113 
E02000937,2004,Wandsworth 015,Wandsworth,E09000032,5533 ,2748 ,2785 
E02000938,2004,Wandsworth 016,Wandsworth,E09000032,5860 ,2739 ,3121 
E02000939,2004,Wandsworth 017,Wandsworth,E09000032,5335 ,2685 ,2650 
E02000940,2004,Wandsworth 018,Wandsworth,E09000032,5120 ,2475 ,2645 
E02000941,2004,Wandsworth 019,Wandsworth,E09000032,7462 ,3943 ,3519 
E02000942,2004,Wandsworth 020,Wandsworth,E09000032,6697 ,3326 ,3371 
E02000943,2004,Wandsworth 021,Wandsworth,E09000032,5968 ,3023 ,2945 
E02000944,2004,Wandsworth 022,Wandsworth,E09000032,4592 ,2122 ,2470 
E02000945,2004,Wandsworth 023,Wandsworth,E09000032,4357 ,1968 ,2389 
E02000946,2004,Wandsworth 024,Wandsworth,E09000032,5412 ,2737 ,2675 
E02000947,2004,Wandsworth 025,Wandsworth,E09000032,6470 ,3080 ,3390 
E02000948,2004,Wandsworth 026,Wandsworth,E09000032,7675 ,3871 ,3804 
E02000949,2004,Wandsworth 027,Wandsworth,E09000032,7096 ,3509 ,3587 
E02000950,2004,Wandsworth 028,Wandsworth,E09000032,5248 ,2545 ,2703 
E02000951,2004,Wandsworth 029,Wandsworth,E09000032,4966 ,2482 ,2484 
E02000952,2004,Wandsworth 030,Wandsworth,E09000032,4555 ,2343 ,2212 
E02000953,2004,Wandsworth 031,Wandsworth,E09000032,4719 ,2144 ,2575 
E02000954,2004,Wandsworth 032,Wandsworth,E09000032,4444 ,2219 ,2225 
E02000955,2004,Wandsworth 033,Wandsworth,E09000032,4546 ,2210 ,2336 
E02000956,2004,Wandsworth 034,Wandsworth,E09000032,5018 ,2363 ,2655 
E02000957,2004,Wandsworth 035,Wandsworth,E09000032,7288 ,3611 ,3677 
E02000958,2004,Wandsworth 036,Wandsworth,E09000032,5472 ,2588 ,2884 
E02000959,2004,Wandsworth 037,Wandsworth,E09000032,4567 ,2242 ,2325 
E02000960,2004,Westminster 001,Westminster,E09000033,4892 ,2324 ,2568 
E02000961,2004,Westminster 002,Westminster,E09000033,6152 ,2951 ,3201 
E02000962,2004,Westminster 003,Westminster,E09000033,6343 ,3108 ,3235 
E02000963,2004,Westminster 004,Westminster,E09000033,6330 ,2934 ,3396 
E02000964,2004,Westminster 005,Westminster,E09000033,7779 ,3673 ,4106 
E02000965,2004,Westminster 006,Westminster,E09000033,6971 ,3406 ,3565 
E02000966,2004,Westminster 007,Westminster,E09000033,6958 ,3443 ,3515 
E02000967,2004,Westminster 008,Westminster,E09000033,5983 ,3100 ,2883 
E02000968,2004,Westminster 009,Westminster,E09000033,9958 ,4791 ,5167 
E02000969,2004,Westminster 010,Westminster,E09000033,6158 ,2879 ,3279 
E02000970,2004,Westminster 011,Westminster,E09000033,7038 ,3628 ,3410 
E02000971,2004,Westminster 012,Westminster,E09000033,7256 ,3939 ,3317 
E02000972,2004,Westminster 013,Westminster,E09000033,6461 ,3408 ,3053 
E02000973,2004,Westminster 014,Westminster,E09000033,7361 ,3669 ,3692 
E02000974,2004,Westminster 015,Westminster,E09000033,6784 ,3690 ,3094 
E02000975,2004,Westminster 016,Westminster,E09000033,7757 ,4229 ,3528 
E02000976,2004,Westminster 017,Westminster,E09000033,8699 ,4611 ,4088 
E02000977,2004,Westminster 018,Westminster,E09000033,5580 ,3180 ,2400 
E02000978,2004,Westminster 019,Westminster,E09000033,8905 ,4527 ,4378 
E02000979,2004,Westminster 020,Westminster,E09000033,5918 ,2993 ,2925 
E02000980,2004,Westminster 021,Westminster,E09000033,5545 ,2789 ,2756 
E02000981,2004,Westminster 022,Westminster,E09000033,6985 ,3630 ,3355 
E02000982,2004,Westminster 023,Westminster,E09000033,5660 ,2982 ,2678 
E02000983,2004,Westminster 024,Westminster,E09000033,6361 ,3217 ,3144 
E02000001,2005,City of London 001,City of London,E09000001,5652 ,3129 ,2523 
E02000002,2005,Barking and Dagenham 001,Barking and Dagenham,E09000002,3679 ,1767 ,1912 
E02000003,2005,Barking and Dagenham 002,Barking and Dagenham,E09000002,5920 ,2864 ,3056 
E02000004,2005,Barking and Dagenham 003,Barking and Dagenham,E09000002,3869 ,1890 ,1979 
E02000005,2005,Barking and Dagenham 004,Barking and Dagenham,E09000002,5021 ,2419 ,2602 
E02000007,2005,Barking and Dagenham 006,Barking and Dagenham,E09000002,4717 ,2193 ,2524 
E02000008,2005,Barking and Dagenham 007,Barking and Dagenham,E09000002,6553 ,3092 ,3461 
E02000009,2005,Barking and Dagenham 008,Barking and Dagenham,E09000002,5528 ,2652 ,2876 
E02000010,2005,Barking and Dagenham 009,Barking and Dagenham,E09000002,4782 ,2278 ,2504 
E02000011,2005,Barking and Dagenham 010,Barking and Dagenham,E09000002,3699 ,1865 ,1834 
E02000012,2005,Barking and Dagenham 011,Barking and Dagenham,E09000002,5162 ,2585 ,2577 
E02000013,2005,Barking and Dagenham 012,Barking and Dagenham,E09000002,4721 ,2233 ,2488 
E02000014,2005,Barking and Dagenham 013,Barking and Dagenham,E09000002,5498 ,2692 ,2806 
E02000015,2005,Barking and Dagenham 014,Barking and Dagenham,E09000002,4133 ,1959 ,2174 
E02000016,2005,Barking and Dagenham 015,Barking and Dagenham,E09000002,3964 ,2130 ,1834 
E02000017,2005,Barking and Dagenham 016,Barking and Dagenham,E09000002,5300 ,2887 ,2413 
E02000018,2005,Barking and Dagenham 017,Barking and Dagenham,E09000002,4862 ,2333 ,2529 
E02000019,2005,Barking and Dagenham 018,Barking and Dagenham,E09000002,4585 ,2227 ,2358 
E02000020,2005,Barking and Dagenham 019,Barking and Dagenham,E09000002,5136 ,2521 ,2615 
E02000021,2005,Barking and Dagenham 020,Barking and Dagenham,E09000002,4837 ,2366 ,2471 
E02000022,2005,Barking and Dagenham 021,Barking and Dagenham,E09000002,4565 ,2209 ,2356 
E02000023,2005,Barking and Dagenham 022,Barking and Dagenham,E09000002,3953 ,1879 ,2074 
E02006799,2005,Barking and Dagenham 023,Barking and Dagenham,E09000002,5460 ,2626 ,2834 
E02000024,2005,Barnet 001,Barnet,E09000003,6177 ,2907 ,3270 
E02000025,2005,Barnet 002,Barnet,E09000003,5147 ,2512 ,2635 
E02000026,2005,Barnet 003,Barnet,E09000003,3943 ,1872 ,2071 
E02000027,2005,Barnet 004,Barnet,E09000003,6118 ,2797 ,3321 
E02000028,2005,Barnet 005,Barnet,E09000003,3814 ,1886 ,1928 
E02000029,2005,Barnet 006,Barnet,E09000003,5456 ,2635 ,2821 
E02000030,2005,Barnet 007,Barnet,E09000003,5706 ,2718 ,2988 
E02000031,2005,Barnet 008,Barnet,E09000003,4481 ,2195 ,2286 
E02000032,2005,Barnet 009,Barnet,E09000003,4812 ,2273 ,2539 
E02000033,2005,Barnet 010,Barnet,E09000003,4942 ,2311 ,2631 
E02000034,2005,Barnet 011,Barnet,E09000003,5411 ,2539 ,2872 
E02000035,2005,Barnet 012,Barnet,E09000003,5420 ,2639 ,2781 
E02000036,2005,Barnet 013,Barnet,E09000003,6405 ,3031 ,3374 
E02000037,2005,Barnet 014,Barnet,E09000003,5847 ,2730 ,3117 
E02000038,2005,Barnet 015,Barnet,E09000003,6545 ,3181 ,3364 
E02000039,2005,Barnet 016,Barnet,E09000003,4169 ,2020 ,2149 
E02000040,2005,Barnet 017,Barnet,E09000003,3897 ,1838 ,2059 
E02000041,2005,Barnet 018,Barnet,E09000003,5335 ,2658 ,2677 
E02000042,2005,Barnet 019,Barnet,E09000003,6810 ,3410 ,3400 
E02000043,2005,Barnet 020,Barnet,E09000003,4921 ,2394 ,2527 
E02000044,2005,Barnet 021,Barnet,E09000003,5071 ,2401 ,2670 
E02000045,2005,Barnet 022,Barnet,E09000003,6478 ,3128 ,3350 
E02000046,2005,Barnet 023,Barnet,E09000003,4637 ,2361 ,2276 
E02000047,2005,Barnet 024,Barnet,E09000003,6406 ,3024 ,3382 
E02000048,2005,Barnet 025,Barnet,E09000003,5646 ,2776 ,2870 
E02000049,2005,Barnet 026,Barnet,E09000003,4947 ,2213 ,2734 
E02000050,2005,Barnet 027,Barnet,E09000003,6404 ,3080 ,3324 
E02000051,2005,Barnet 028,Barnet,E09000003,5359 ,2713 ,2646 
E02000052,2005,Barnet 029,Barnet,E09000003,6379 ,3042 ,3337 
E02000053,2005,Barnet 030,Barnet,E09000003,4955 ,2528 ,2427 
E02000054,2005,Barnet 031,Barnet,E09000003,4514 ,2264 ,2250 
E02000055,2005,Barnet 032,Barnet,E09000003,6451 ,3372 ,3079 
E02000056,2005,Barnet 033,Barnet,E09000003,5541 ,2578 ,2963 
E02000057,2005,Barnet 034,Barnet,E09000003,4279 ,2081 ,2198 
E02000058,2005,Barnet 035,Barnet,E09000003,6086 ,2959 ,3127 
E02000059,2005,Barnet 036,Barnet,E09000003,6502 ,3257 ,3245 
E02000060,2005,Barnet 037,Barnet,E09000003,6035 ,2997 ,3038 
E02000061,2005,Barnet 038,Barnet,E09000003,5234 ,2648 ,2586 
E02000062,2005,Barnet 039,Barnet,E09000003,3908 ,1867 ,2041 
E02000063,2005,Barnet 040,Barnet,E09000003,4347 ,2154 ,2193 
E02000064,2005,Barnet 041,Barnet,E09000003,3811 ,1781 ,2030 
E02000065,2005,Bexley 001,Bexley,E09000004,4543 ,2197 ,2346 
E02000066,2005,Bexley 002,Bexley,E09000004,6276 ,2931 ,3345 
E02000067,2005,Bexley 003,Bexley,E09000004,5295 ,2554 ,2741 
E02000068,2005,Bexley 004,Bexley,E09000004,4148 ,2013 ,2135 
E02000069,2005,Bexley 005,Bexley,E09000004,3712 ,1834 ,1878 
E02000070,2005,Bexley 006,Bexley,E09000004,4966 ,2407 ,2559 
E02000071,2005,Bexley 007,Bexley,E09000004,4731 ,2297 ,2434 
E02000072,2005,Bexley 008,Bexley,E09000004,7168 ,3380 ,3788 
E02000073,2005,Bexley 009,Bexley,E09000004,6550 ,3226 ,3324 
E02000074,2005,Bexley 010,Bexley,E09000004,4717 ,2263 ,2454 
E02000075,2005,Bexley 011,Bexley,E09000004,4873 ,2386 ,2487 
E02000077,2005,Bexley 013,Bexley,E09000004,4782 ,2305 ,2477 
E02000078,2005,Bexley 014,Bexley,E09000004,5153 ,2494 ,2659 
E02000079,2005,Bexley 015,Bexley,E09000004,4876 ,2427 ,2449 
E02000080,2005,Bexley 016,Bexley,E09000004,5725 ,2826 ,2899 
E02000081,2005,Bexley 017,Bexley,E09000004,4675 ,2315 ,2360 
E02000082,2005,Bexley 018,Bexley,E09000004,5621 ,2821 ,2800 
E02000083,2005,Bexley 019,Bexley,E09000004,5983 ,2909 ,3074 
E02000084,2005,Bexley 020,Bexley,E09000004,6673 ,3278 ,3395 
E02000085,2005,Bexley 021,Bexley,E09000004,4879 ,2395 ,2484 
E02000086,2005,Bexley 022,Bexley,E09000004,4778 ,2320 ,2458 
E02000087,2005,Bexley 023,Bexley,E09000004,4487 ,2273 ,2214 
E02000088,2005,Bexley 024,Bexley,E09000004,4798 ,2354 ,2444 
E02000089,2005,Bexley 025,Bexley,E09000004,4670 ,2263 ,2407 
E02000090,2005,Bexley 026,Bexley,E09000004,5176 ,2509 ,2667 
E02000091,2005,Bexley 027,Bexley,E09000004,5707 ,2783 ,2924 
E02000092,2005,Bexley 028,Bexley,E09000004,3703 ,1728 ,1975 
E02006785,2005,Bexley 029,Bexley,E09000004,3885 ,1901 ,1984 
E02000093,2005,Brent 001,Brent,E09000005,6207 ,3085 ,3122 
E02000094,2005,Brent 002,Brent,E09000005,4747 ,2369 ,2378 
E02000095,2005,Brent 003,Brent,E09000005,5886 ,2915 ,2971 
E02000096,2005,Brent 004,Brent,E09000005,4510 ,2282 ,2228 
E02000097,2005,Brent 005,Brent,E09000005,5234 ,2646 ,2588 
E02000098,2005,Brent 006,Brent,E09000005,4572 ,2290 ,2282 
E02000099,2005,Brent 007,Brent,E09000005,4552 ,2267 ,2285 
E02000100,2005,Brent 008,Brent,E09000005,5259 ,2517 ,2742 
E02000101,2005,Brent 009,Brent,E09000005,5051 ,2404 ,2647 
E02000102,2005,Brent 010,Brent,E09000005,4699 ,2393 ,2306 
E02000103,2005,Brent 011,Brent,E09000005,5041 ,2563 ,2478 
E02000104,2005,Brent 012,Brent,E09000005,3895 ,2016 ,1879 
E02000105,2005,Brent 013,Brent,E09000005,4994 ,2577 ,2417 
E02000106,2005,Brent 014,Brent,E09000005,6183 ,3147 ,3036 
E02000107,2005,Brent 015,Brent,E09000005,7697 ,4068 ,3629 
E02000108,2005,Brent 016,Brent,E09000005,3896 ,2040 ,1856 
E02000109,2005,Brent 017,Brent,E09000005,5442 ,2856 ,2586 
E02000110,2005,Brent 018,Brent,E09000005,5390 ,2622 ,2768 
E02000111,2005,Brent 019,Brent,E09000005,5437 ,2851 ,2586 
E02000112,2005,Brent 020,Brent,E09000005,5630 ,2949 ,2681 
E02000113,2005,Brent 021,Brent,E09000005,5522 ,2562 ,2960 
E02000114,2005,Brent 022,Brent,E09000005,5752 ,2862 ,2890 
E02000115,2005,Brent 023,Brent,E09000005,5811 ,2973 ,2838 
E02000116,2005,Brent 024,Brent,E09000005,4467 ,2255 ,2212 
E02000117,2005,Brent 025,Brent,E09000005,7097 ,3435 ,3662 
E02000118,2005,Brent 026,Brent,E09000005,5763 ,3033 ,2730 
E02000119,2005,Brent 027,Brent,E09000005,4285 ,2109 ,2176 
E02000120,2005,Brent 028,Brent,E09000005,6410 ,3131 ,3279 
E02000121,2005,Brent 029,Brent,E09000005,5417 ,2832 ,2585 
E02000122,2005,Brent 030,Brent,E09000005,5376 ,2686 ,2690 
E02000123,2005,Brent 031,Brent,E09000005,8781 ,4501 ,4280 
E02000124,2005,Brent 032,Brent,E09000005,6882 ,3466 ,3416 
E02000125,2005,Brent 033,Brent,E09000005,6842 ,3376 ,3466 
E02000126,2005,Brent 034,Brent,E09000005,4599 ,2237 ,2362 
E02000127,2005,Bromley 001,Bromley,E09000006,5334 ,2452 ,2882 
E02000128,2005,Bromley 002,Bromley,E09000006,4881 ,2381 ,2500 
E02000130,2005,Bromley 004,Bromley,E09000006,5314 ,2554 ,2760 
E02000131,2005,Bromley 005,Bromley,E09000006,6189 ,3047 ,3142 
E02000132,2005,Bromley 006,Bromley,E09000006,5535 ,2730 ,2805 
E02000133,2005,Bromley 007,Bromley,E09000006,5636 ,2784 ,2852 
E02000134,2005,Bromley 008,Bromley,E09000006,7103 ,3467 ,3636 
E02000135,2005,Bromley 009,Bromley,E09000006,6155 ,2878 ,3277 
E02000136,2005,Bromley 010,Bromley,E09000006,3340 ,1624 ,1716 
E02000137,2005,Bromley 011,Bromley,E09000006,5038 ,2448 ,2590 
E02000138,2005,Bromley 012,Bromley,E09000006,5069 ,2578 ,2491 
E02000139,2005,Bromley 013,Bromley,E09000006,4930 ,2385 ,2545 
E02000140,2005,Bromley 014,Bromley,E09000006,4493 ,2100 ,2393 
E02000141,2005,Bromley 015,Bromley,E09000006,5062 ,2483 ,2579 
E02000142,2005,Bromley 016,Bromley,E09000006,5202 ,2568 ,2634 
E02000144,2005,Bromley 018,Bromley,E09000006,5392 ,2699 ,2693 
E02000145,2005,Bromley 019,Bromley,E09000006,4763 ,2252 ,2511 
E02000146,2005,Bromley 020,Bromley,E09000006,5052 ,2469 ,2583 
E02000147,2005,Bromley 021,Bromley,E09000006,4725 ,2349 ,2376 
E02000148,2005,Bromley 022,Bromley,E09000006,3824 ,1883 ,1941 
E02000149,2005,Bromley 023,Bromley,E09000006,4693 ,2247 ,2446 
E02000150,2005,Bromley 024,Bromley,E09000006,4962 ,2405 ,2557 
E02000151,2005,Bromley 025,Bromley,E09000006,4581 ,2252 ,2329 
E02000152,2005,Bromley 026,Bromley,E09000006,3971 ,1877 ,2094 
E02000153,2005,Bromley 027,Bromley,E09000006,4705 ,2227 ,2478 
E02000154,2005,Bromley 028,Bromley,E09000006,4865 ,2442 ,2423 
E02000155,2005,Bromley 029,Bromley,E09000006,4256 ,2075 ,2181 
E02000156,2005,Bromley 030,Bromley,E09000006,7265 ,3604 ,3661 
E02000157,2005,Bromley 031,Bromley,E09000006,4621 ,2261 ,2360 
E02000158,2005,Bromley 032,Bromley,E09000006,4384 ,2089 ,2295 
E02000159,2005,Bromley 033,Bromley,E09000006,3897 ,1905 ,1992 
E02000160,2005,Bromley 034,Bromley,E09000006,4734 ,2370 ,2364 
E02000161,2005,Bromley 035,Bromley,E09000006,5183 ,2523 ,2660 
E02000162,2005,Bromley 036,Bromley,E09000006,3928 ,1871 ,2057 
E02000163,2005,Bromley 037,Bromley,E09000006,4916 ,2412 ,2504 
E02000165,2005,Bromley 039,Bromley,E09000006,4948 ,2457 ,2491 
E02006782,2005,Bromley 040,Bromley,E09000006,4625 ,2205 ,2420 
E02006787,2005,Bromley 041,Bromley,E09000006,4907 ,2365 ,2542 
E02006789,2005,Bromley 042,Bromley,E09000006,3879 ,1949 ,1930 
E02000166,2005,Camden 001,Camden,E09000007,5828 ,2620 ,3208 
E02000167,2005,Camden 002,Camden,E09000007,5424 ,2599 ,2825 
E02000168,2005,Camden 003,Camden,E09000007,5780 ,2791 ,2989 
E02000169,2005,Camden 004,Camden,E09000007,4527 ,2061 ,2466 
E02000170,2005,Camden 005,Camden,E09000007,5986 ,2900 ,3086 
E02000171,2005,Camden 006,Camden,E09000007,5356 ,2524 ,2832 
E02000172,2005,Camden 007,Camden,E09000007,6749 ,3319 ,3430 
E02000173,2005,Camden 008,Camden,E09000007,5185 ,2528 ,2657 
E02000174,2005,Camden 009,Camden,E09000007,6416 ,3142 ,3274 
E02000175,2005,Camden 010,Camden,E09000007,7120 ,3498 ,3622 
E02000176,2005,Camden 011,Camden,E09000007,4670 ,2314 ,2356 
E02000177,2005,Camden 012,Camden,E09000007,6045 ,2899 ,3146 
E02000178,2005,Camden 013,Camden,E09000007,6809 ,3329 ,3480 
E02000179,2005,Camden 014,Camden,E09000007,4294 ,2104 ,2190 
E02000180,2005,Camden 015,Camden,E09000007,5932 ,3042 ,2890 
E02000181,2005,Camden 016,Camden,E09000007,6357 ,3149 ,3208 
E02000182,2005,Camden 017,Camden,E09000007,3970 ,1831 ,2139 
E02000183,2005,Camden 018,Camden,E09000007,5732 ,2847 ,2885 
E02000184,2005,Camden 019,Camden,E09000007,5996 ,2983 ,3013 
E02000185,2005,Camden 020,Camden,E09000007,5627 ,2825 ,2802 
E02000186,2005,Camden 021,Camden,E09000007,5343 ,2924 ,2419 
E02000187,2005,Camden 022,Camden,E09000007,5217 ,2500 ,2717 
E02000188,2005,Camden 023,Camden,E09000007,5263 ,2667 ,2596 
E02000189,2005,Camden 024,Camden,E09000007,4223 ,2035 ,2188 
E02000190,2005,Camden 025,Camden,E09000007,6036 ,3142 ,2894 
E02000191,2005,Camden 026,Camden,E09000007,5938 ,3030 ,2908 
E02000192,2005,Camden 027,Camden,E09000007,4954 ,2663 ,2291 
E02000193,2005,Camden 028,Camden,E09000007,6067 ,3076 ,2991 
E02000194,2005,Croydon 001,Croydon,E09000008,5361 ,2630 ,2731 
E02000195,2005,Croydon 002,Croydon,E09000008,5564 ,2797 ,2767 
E02000196,2005,Croydon 003,Croydon,E09000008,4310 ,2100 ,2210 
E02000197,2005,Croydon 004,Croydon,E09000008,5544 ,2686 ,2858 
E02000198,2005,Croydon 005,Croydon,E09000008,5162 ,2401 ,2761 
E02000199,2005,Croydon 006,Croydon,E09000008,5230 ,2470 ,2760 
E02000200,2005,Croydon 007,Croydon,E09000008,5388 ,2668 ,2720 
E02000201,2005,Croydon 008,Croydon,E09000008,5362 ,2611 ,2751 
E02000202,2005,Croydon 009,Croydon,E09000008,5744 ,2831 ,2913 
E02000203,2005,Croydon 010,Croydon,E09000008,5145 ,2534 ,2611 
E02000204,2005,Croydon 011,Croydon,E09000008,6420 ,3157 ,3263 
E02000206,2005,Croydon 013,Croydon,E09000008,6132 ,2897 ,3235 
E02000207,2005,Croydon 014,Croydon,E09000008,5437 ,2567 ,2870 
E02000208,2005,Croydon 015,Croydon,E09000008,5113 ,2565 ,2548 
E02000209,2005,Croydon 016,Croydon,E09000008,5364 ,2638 ,2726 
E02000210,2005,Croydon 017,Croydon,E09000008,5548 ,2719 ,2829 
E02000211,2005,Croydon 018,Croydon,E09000008,5072 ,2503 ,2569 
E02000212,2005,Croydon 019,Croydon,E09000008,5001 ,2465 ,2536 
E02000213,2005,Croydon 020,Croydon,E09000008,5833 ,2986 ,2847 
E02000214,2005,Croydon 021,Croydon,E09000008,3990 ,2053 ,1937 
E02000215,2005,Croydon 022,Croydon,E09000008,6987 ,3624 ,3363 
E02000216,2005,Croydon 023,Croydon,E09000008,4110 ,2165 ,1945 
E02000217,2005,Croydon 024,Croydon,E09000008,5539 ,2803 ,2736 
E02000218,2005,Croydon 025,Croydon,E09000008,3920 ,1809 ,2111 
E02000219,2005,Croydon 026,Croydon,E09000008,4642 ,2292 ,2350 
E02000220,2005,Croydon 027,Croydon,E09000008,6378 ,3354 ,3024 
E02000221,2005,Croydon 028,Croydon,E09000008,5444 ,2542 ,2902 
E02000222,2005,Croydon 029,Croydon,E09000008,5270 ,2649 ,2621 
E02000223,2005,Croydon 030,Croydon,E09000008,4736 ,2088 ,2648 
E02000224,2005,Croydon 031,Croydon,E09000008,5212 ,2650 ,2562 
E02000225,2005,Croydon 032,Croydon,E09000008,4553 ,2126 ,2427 
E02000226,2005,Croydon 033,Croydon,E09000008,4908 ,2453 ,2455 
E02000227,2005,Croydon 034,Croydon,E09000008,7689 ,3658 ,4031 
E02000228,2005,Croydon 035,Croydon,E09000008,4594 ,2235 ,2359 
E02000229,2005,Croydon 036,Croydon,E09000008,3504 ,1611 ,1893 
E02000230,2005,Croydon 037,Croydon,E09000008,5974 ,3048 ,2926 
E02000231,2005,Croydon 038,Croydon,E09000008,4864 ,2449 ,2415 
E02000232,2005,Croydon 039,Croydon,E09000008,3717 ,1757 ,1960 
E02000233,2005,Croydon 040,Croydon,E09000008,3777 ,1866 ,1911 
E02000234,2005,Croydon 041,Croydon,E09000008,4987 ,2413 ,2574 
E02000235,2005,Croydon 042,Croydon,E09000008,4432 ,2131 ,2301 
E02000236,2005,Croydon 043,Croydon,E09000008,4835 ,2380 ,2455 
E02000237,2005,Croydon 044,Croydon,E09000008,4521 ,2185 ,2336 
E02006788,2005,Croydon 045,Croydon,E09000008,4852 ,2180 ,2672 
E02000238,2005,Ealing 001,Ealing,E09000009,5924 ,2984 ,2940 
E02000239,2005,Ealing 002,Ealing,E09000009,5834 ,3002 ,2832 
E02000240,2005,Ealing 003,Ealing,E09000009,5885 ,2771 ,3114 
E02000241,2005,Ealing 004,Ealing,E09000009,4208 ,2149 ,2059 
E02000242,2005,Ealing 005,Ealing,E09000009,4371 ,2287 ,2084 
E02000243,2005,Ealing 006,Ealing,E09000009,5655 ,2871 ,2784 
E02000244,2005,Ealing 007,Ealing,E09000009,4453 ,2345 ,2108 
E02000245,2005,Ealing 008,Ealing,E09000009,4963 ,2377 ,2586 
E02000246,2005,Ealing 009,Ealing,E09000009,5223 ,2486 ,2737 
E02000247,2005,Ealing 010,Ealing,E09000009,5114 ,2451 ,2663 
E02000248,2005,Ealing 011,Ealing,E09000009,4904 ,2625 ,2279 
E02000249,2005,Ealing 012,Ealing,E09000009,4536 ,2296 ,2240 
E02000250,2005,Ealing 013,Ealing,E09000009,4448 ,2231 ,2217 
E02000251,2005,Ealing 014,Ealing,E09000009,5107 ,2577 ,2530 
E02000252,2005,Ealing 015,Ealing,E09000009,6028 ,3176 ,2852 
E02000253,2005,Ealing 016,Ealing,E09000009,5955 ,2801 ,3154 
E02000254,2005,Ealing 017,Ealing,E09000009,5780 ,2955 ,2825 
E02000255,2005,Ealing 018,Ealing,E09000009,6478 ,3169 ,3309 
E02000256,2005,Ealing 019,Ealing,E09000009,6038 ,3127 ,2911 
E02000257,2005,Ealing 020,Ealing,E09000009,9939 ,5227 ,4712 
E02000258,2005,Ealing 021,Ealing,E09000009,4359 ,2177 ,2182 
E02000259,2005,Ealing 022,Ealing,E09000009,4274 ,2055 ,2219 
E02000260,2005,Ealing 023,Ealing,E09000009,5676 ,3000 ,2676 
E02000261,2005,Ealing 024,Ealing,E09000009,6565 ,3250 ,3315 
E02000262,2005,Ealing 025,Ealing,E09000009,5720 ,2905 ,2815 
E02000263,2005,Ealing 026,Ealing,E09000009,7441 ,4088 ,3353 
E02000264,2005,Ealing 027,Ealing,E09000009,5414 ,2665 ,2749 
E02000265,2005,Ealing 028,Ealing,E09000009,7379 ,3731 ,3648 
E02000266,2005,Ealing 029,Ealing,E09000009,7849 ,3928 ,3921 
E02000267,2005,Ealing 030,Ealing,E09000009,4701 ,2337 ,2364 
E02000268,2005,Ealing 031,Ealing,E09000009,6576 ,3297 ,3279 
E02000269,2005,Ealing 032,Ealing,E09000009,5796 ,2932 ,2864 
E02000270,2005,Ealing 033,Ealing,E09000009,5203 ,2441 ,2762 
E02000271,2005,Ealing 034,Ealing,E09000009,4888 ,2426 ,2462 
E02000272,2005,Ealing 035,Ealing,E09000009,4545 ,2302 ,2243 
E02000274,2005,Ealing 037,Ealing,E09000009,7674 ,4099 ,3575 
E02000275,2005,Ealing 038,Ealing,E09000009,4354 ,2280 ,2074 
E02000276,2005,Ealing 039,Ealing,E09000009,4772 ,2400 ,2372 
E02006791,2005,Ealing 040,Ealing,E09000009,5296 ,2721 ,2575 
E02000277,2005,Enfield 001,Enfield,E09000010,4272 ,2074 ,2198 
E02000278,2005,Enfield 002,Enfield,E09000010,4797 ,2288 ,2509 
E02000279,2005,Enfield 003,Enfield,E09000010,6375 ,2979 ,3396 
E02000280,2005,Enfield 004,Enfield,E09000010,5187 ,2506 ,2681 
E02000281,2005,Enfield 005,Enfield,E09000010,5161 ,2445 ,2716 
E02000282,2005,Enfield 006,Enfield,E09000010,5389 ,2588 ,2801 
E02000283,2005,Enfield 007,Enfield,E09000010,5041 ,2480 ,2561 
E02000284,2005,Enfield 008,Enfield,E09000010,5149 ,2505 ,2644 
E02000285,2005,Enfield 009,Enfield,E09000010,4196 ,2042 ,2154 
E02000286,2005,Enfield 010,Enfield,E09000010,5122 ,2623 ,2499 
E02000287,2005,Enfield 011,Enfield,E09000010,3967 ,2039 ,1928 
E02000288,2005,Enfield 012,Enfield,E09000010,5883 ,2914 ,2969 
E02000289,2005,Enfield 013,Enfield,E09000010,3987 ,1924 ,2063 
E02000290,2005,Enfield 014,Enfield,E09000010,4313 ,2068 ,2245 
E02000291,2005,Enfield 015,Enfield,E09000010,5360 ,2702 ,2658 
E02000292,2005,Enfield 016,Enfield,E09000010,5938 ,2967 ,2971 
E02000293,2005,Enfield 017,Enfield,E09000010,3953 ,1948 ,2005 
E02000294,2005,Enfield 018,Enfield,E09000010,5320 ,2588 ,2732 
E02000295,2005,Enfield 019,Enfield,E09000010,5384 ,2651 ,2733 
E02000296,2005,Enfield 020,Enfield,E09000010,5566 ,2784 ,2782 
E02000297,2005,Enfield 021,Enfield,E09000010,6121 ,3091 ,3030 
E02000298,2005,Enfield 022,Enfield,E09000010,5230 ,2597 ,2633 
E02000299,2005,Enfield 023,Enfield,E09000010,5361 ,2619 ,2742 
E02000300,2005,Enfield 024,Enfield,E09000010,5147 ,2486 ,2661 
E02000301,2005,Enfield 025,Enfield,E09000010,5891 ,2838 ,3053 
E02000302,2005,Enfield 026,Enfield,E09000010,5263 ,2623 ,2640 
E02000303,2005,Enfield 027,Enfield,E09000010,5003 ,2375 ,2628 
E02000304,2005,Enfield 028,Enfield,E09000010,5017 ,2484 ,2533 
E02000305,2005,Enfield 029,Enfield,E09000010,5435 ,2770 ,2665 
E02000306,2005,Enfield 030,Enfield,E09000010,4495 ,2102 ,2393 
E02000307,2005,Enfield 031,Enfield,E09000010,5912 ,2878 ,3034 
E02000308,2005,Enfield 032,Enfield,E09000010,4988 ,2573 ,2415 
E02000309,2005,Enfield 033,Enfield,E09000010,6061 ,2966 ,3095 
E02000311,2005,Enfield 035,Enfield,E09000010,6155 ,2965 ,3190 
E02000312,2005,Enfield 036,Enfield,E09000010,6495 ,3377 ,3118 
E02006793,2005,Enfield 037,Enfield,E09000010,5401 ,2516 ,2885 
E02000313,2005,Greenwich 001,Greenwich,E09000011,3954 ,1938 ,2016 
E02000314,2005,Greenwich 002,Greenwich,E09000011,6627 ,3485 ,3142 
E02000315,2005,Greenwich 003,Greenwich,E09000011,5004 ,2314 ,2690 
E02000316,2005,Greenwich 004,Greenwich,E09000011,5003 ,2588 ,2415 
E02000317,2005,Greenwich 005,Greenwich,E09000011,5410 ,2647 ,2763 
E02000318,2005,Greenwich 006,Greenwich,E09000011,5728 ,2977 ,2751 
E02000319,2005,Greenwich 007,Greenwich,E09000011,6100 ,3075 ,3025 
E02000320,2005,Greenwich 008,Greenwich,E09000011,4079 ,1956 ,2123 
E02000321,2005,Greenwich 009,Greenwich,E09000011,4422 ,2229 ,2193 
E02000323,2005,Greenwich 011,Greenwich,E09000011,6559 ,3277 ,3282 
E02000324,2005,Greenwich 012,Greenwich,E09000011,4421 ,2165 ,2256 
E02000326,2005,Greenwich 014,Greenwich,E09000011,4623 ,2233 ,2390 
E02000327,2005,Greenwich 015,Greenwich,E09000011,4171 ,2158 ,2013 
E02000328,2005,Greenwich 016,Greenwich,E09000011,4290 ,2142 ,2148 
E02000329,2005,Greenwich 017,Greenwich,E09000011,4018 ,1973 ,2045 
E02000331,2005,Greenwich 019,Greenwich,E09000011,4760 ,2367 ,2393 
E02000332,2005,Greenwich 020,Greenwich,E09000011,4839 ,2419 ,2420 
E02000333,2005,Greenwich 021,Greenwich,E09000011,4254 ,2250 ,2004 
E02000334,2005,Greenwich 022,Greenwich,E09000011,4020 ,2012 ,2008 
E02000335,2005,Greenwich 023,Greenwich,E09000011,4077 ,2013 ,2064 
E02000337,2005,Greenwich 025,Greenwich,E09000011,5096 ,2422 ,2674 
E02000339,2005,Greenwich 027,Greenwich,E09000011,3822 ,1918 ,1904 
E02000340,2005,Greenwich 028,Greenwich,E09000011,3677 ,1850 ,1827 
E02000341,2005,Greenwich 029,Greenwich,E09000011,4720 ,2218 ,2502 
E02000342,2005,Greenwich 030,Greenwich,E09000011,3952 ,1861 ,2091 
E02000343,2005,Greenwich 031,Greenwich,E09000011,3996 ,1976 ,2020 
E02000344,2005,Greenwich 032,Greenwich,E09000011,4053 ,1971 ,2082 
E02006786,2005,Greenwich 033,Greenwich,E09000011,4276 ,2069 ,2207 
E02006927,2005,Greenwich 034,Greenwich,E09000011,7450 ,3588 ,3862 
E02006928,2005,Greenwich 035,Greenwich,E09000011,4150 ,2118 ,2032 
E02006929,2005,Greenwich 036,Greenwich,E09000011,4258 ,2131 ,2127 
E02006930,2005,Greenwich 037,Greenwich,E09000011,4661 ,2374 ,2287 
E02006931,2005,Greenwich 038,Greenwich,E09000011,6098 ,3070 ,3028 
E02000345,2005,Hackney 001,Hackney,E09000012,4691 ,2451 ,2240 
E02000346,2005,Hackney 002,Hackney,E09000012,4835 ,2424 ,2411 
E02000347,2005,Hackney 003,Hackney,E09000012,4634 ,2378 ,2256 
E02000348,2005,Hackney 004,Hackney,E09000012,4858 ,2387 ,2471 
E02000350,2005,Hackney 006,Hackney,E09000012,6305 ,3116 ,3189 
E02000351,2005,Hackney 007,Hackney,E09000012,5982 ,3042 ,2940 
E02000352,2005,Hackney 008,Hackney,E09000012,4129 ,2009 ,2120 
E02000353,2005,Hackney 009,Hackney,E09000012,5337 ,2606 ,2731 
E02000354,2005,Hackney 010,Hackney,E09000012,5595 ,2775 ,2820 
E02000355,2005,Hackney 011,Hackney,E09000012,5585 ,2747 ,2838 
E02000356,2005,Hackney 012,Hackney,E09000012,5130 ,2514 ,2616 
E02000357,2005,Hackney 013,Hackney,E09000012,4000 ,1855 ,2145 
E02000358,2005,Hackney 014,Hackney,E09000012,7335 ,3621 ,3714 
E02000359,2005,Hackney 015,Hackney,E09000012,4257 ,2012 ,2245 
E02000360,2005,Hackney 016,Hackney,E09000012,6704 ,3287 ,3417 
E02000361,2005,Hackney 017,Hackney,E09000012,4872 ,2467 ,2405 
E02000362,2005,Hackney 018,Hackney,E09000012,3578 ,1669 ,1909 
E02000363,2005,Hackney 019,Hackney,E09000012,6452 ,3046 ,3406 
E02000364,2005,Hackney 020,Hackney,E09000012,5880 ,2888 ,2992 
E02000365,2005,Hackney 021,Hackney,E09000012,7598 ,3813 ,3785 
E02000366,2005,Hackney 022,Hackney,E09000012,5178 ,2442 ,2736 
E02000367,2005,Hackney 023,Hackney,E09000012,5626 ,2661 ,2965 
E02000368,2005,Hackney 024,Hackney,E09000012,6235 ,3037 ,3198 
E02000369,2005,Hackney 025,Hackney,E09000012,6580 ,3291 ,3289 
E02000370,2005,Hackney 026,Hackney,E09000012,4617 ,2335 ,2282 
E02000371,2005,Hackney 027,Hackney,E09000012,6738 ,3581 ,3157 
E02006918,2005,Hackney 028,Hackney,E09000012,3588 ,1785 ,1803 
E02006921,2005,Hackney 029,Hackney,E09000012,4534 ,2188 ,2346 
E02000372,2005,Hammersmith and Fulham 001,Hammersmith and Fulham,E09000013,5721 ,2668 ,3053 
E02000373,2005,Hammersmith and Fulham 002,Hammersmith and Fulham,E09000013,4240 ,1938 ,2302 
E02000374,2005,Hammersmith and Fulham 003,Hammersmith and Fulham,E09000013,4430 ,2131 ,2299 
E02000375,2005,Hammersmith and Fulham 004,Hammersmith and Fulham,E09000013,5104 ,2606 ,2498 
E02000376,2005,Hammersmith and Fulham 005,Hammersmith and Fulham,E09000013,5134 ,2544 ,2590 
E02000377,2005,Hammersmith and Fulham 006,Hammersmith and Fulham,E09000013,5758 ,2784 ,2974 
E02000378,2005,Hammersmith and Fulham 007,Hammersmith and Fulham,E09000013,5078 ,2445 ,2633 
E02000379,2005,Hammersmith and Fulham 008,Hammersmith and Fulham,E09000013,4636 ,2347 ,2289 
E02000380,2005,Hammersmith and Fulham 009,Hammersmith and Fulham,E09000013,4491 ,2188 ,2303 
E02000381,2005,Hammersmith and Fulham 010,Hammersmith and Fulham,E09000013,6116 ,2990 ,3126 
E02000382,2005,Hammersmith and Fulham 011,Hammersmith and Fulham,E09000013,4400 ,2206 ,2194 
E02000383,2005,Hammersmith and Fulham 012,Hammersmith and Fulham,E09000013,7231 ,3750 ,3481 
E02000384,2005,Hammersmith and Fulham 013,Hammersmith and Fulham,E09000013,5615 ,2803 ,2812 
E02000385,2005,Hammersmith and Fulham 014,Hammersmith and Fulham,E09000013,5191 ,2724 ,2467 
E02000386,2005,Hammersmith and Fulham 015,Hammersmith and Fulham,E09000013,5993 ,3061 ,2932 
E02000387,2005,Hammersmith and Fulham 016,Hammersmith and Fulham,E09000013,4480 ,2161 ,2319 
E02000388,2005,Hammersmith and Fulham 017,Hammersmith and Fulham,E09000013,5972 ,3003 ,2969 
E02000389,2005,Hammersmith and Fulham 018,Hammersmith and Fulham,E09000013,5678 ,2688 ,2990 
E02000390,2005,Hammersmith and Fulham 019,Hammersmith and Fulham,E09000013,4781 ,2399 ,2382 
E02000391,2005,Hammersmith and Fulham 020,Hammersmith and Fulham,E09000013,5312 ,2561 ,2751 
E02000392,2005,Hammersmith and Fulham 021,Hammersmith and Fulham,E09000013,6992 ,3471 ,3521 
E02000393,2005,Hammersmith and Fulham 022,Hammersmith and Fulham,E09000013,4391 ,2129 ,2262 
E02000394,2005,Hammersmith and Fulham 023,Hammersmith and Fulham,E09000013,4136 ,1929 ,2207 
E02000395,2005,Hammersmith and Fulham 024,Hammersmith and Fulham,E09000013,4428 ,2134 ,2294 
E02000396,2005,Hammersmith and Fulham 025,Hammersmith and Fulham,E09000013,4345 ,2017 ,2328 
E02000397,2005,Haringey 001,Haringey,E09000014,4876 ,2435 ,2441 
E02000398,2005,Haringey 002,Haringey,E09000014,4548 ,2228 ,2320 
E02000400,2005,Haringey 004,Haringey,E09000014,4339 ,2076 ,2263 
E02000401,2005,Haringey 005,Haringey,E09000014,4053 ,1914 ,2139 
E02000402,2005,Haringey 006,Haringey,E09000014,4070 ,1898 ,2172 
E02000403,2005,Haringey 007,Haringey,E09000014,4713 ,2378 ,2335 
E02000404,2005,Haringey 008,Haringey,E09000014,4345 ,2101 ,2244 
E02000405,2005,Haringey 009,Haringey,E09000014,4180 ,2013 ,2167 
E02000406,2005,Haringey 010,Haringey,E09000014,4445 ,2159 ,2286 
E02000407,2005,Haringey 011,Haringey,E09000014,4286 ,2213 ,2073 
E02000408,2005,Haringey 012,Haringey,E09000014,4191 ,2067 ,2124 
E02000409,2005,Haringey 013,Haringey,E09000014,4239 ,2111 ,2128 
E02000410,2005,Haringey 014,Haringey,E09000014,4663 ,2269 ,2394 
E02000411,2005,Haringey 015,Haringey,E09000014,4643 ,2342 ,2301 
E02000412,2005,Haringey 016,Haringey,E09000014,4337 ,2225 ,2112 
E02000413,2005,Haringey 017,Haringey,E09000014,4467 ,2114 ,2353 
E02000414,2005,Haringey 018,Haringey,E09000014,4637 ,2343 ,2294 
E02000415,2005,Haringey 019,Haringey,E09000014,4540 ,2429 ,2111 
E02000416,2005,Haringey 020,Haringey,E09000014,4348 ,2105 ,2243 
E02000417,2005,Haringey 021,Haringey,E09000014,4508 ,2226 ,2282 
E02000418,2005,Haringey 022,Haringey,E09000014,3567 ,1670 ,1897 
E02000419,2005,Haringey 023,Haringey,E09000014,5627 ,2988 ,2639 
E02000420,2005,Haringey 024,Haringey,E09000014,4471 ,2212 ,2259 
E02000421,2005,Haringey 025,Haringey,E09000014,4551 ,2204 ,2347 
E02000422,2005,Haringey 026,Haringey,E09000014,4847 ,2464 ,2383 
E02000423,2005,Haringey 027,Haringey,E09000014,4930 ,2739 ,2191 
E02000424,2005,Haringey 028,Haringey,E09000014,5067 ,2521 ,2546 
E02000425,2005,Haringey 029,Haringey,E09000014,3781 ,1919 ,1862 
E02000426,2005,Haringey 030,Haringey,E09000014,4195 ,2019 ,2176 
E02000427,2005,Haringey 031,Haringey,E09000014,5158 ,2746 ,2412 
E02000428,2005,Haringey 032,Haringey,E09000014,4437 ,2266 ,2171 
E02000429,2005,Haringey 033,Haringey,E09000014,4625 ,2246 ,2379 
E02000430,2005,Haringey 034,Haringey,E09000014,5092 ,2542 ,2550 
E02000431,2005,Haringey 035,Haringey,E09000014,4601 ,2223 ,2378 
E02000432,2005,Haringey 036,Haringey,E09000014,4570 ,2244 ,2326 
E02006794,2005,Haringey 037,Haringey,E09000014,4399 ,2249 ,2150 
E02000433,2005,Harrow 001,Harrow,E09000015,3968 ,1889 ,2079 
E02000434,2005,Harrow 002,Harrow,E09000015,4937 ,2394 ,2543 
E02000435,2005,Harrow 003,Harrow,E09000015,4551 ,2173 ,2378 
E02000436,2005,Harrow 004,Harrow,E09000015,3683 ,1765 ,1918 
E02000437,2005,Harrow 005,Harrow,E09000015,5118 ,2455 ,2663 
E02000438,2005,Harrow 006,Harrow,E09000015,4579 ,2173 ,2406 
E02000439,2005,Harrow 007,Harrow,E09000015,5007 ,2548 ,2459 
E02000440,2005,Harrow 008,Harrow,E09000015,5793 ,2809 ,2984 
E02000441,2005,Harrow 009,Harrow,E09000015,4315 ,2056 ,2259 
E02000442,2005,Harrow 010,Harrow,E09000015,5393 ,2759 ,2634 
E02000443,2005,Harrow 011,Harrow,E09000015,5746 ,2920 ,2826 
E02000444,2005,Harrow 012,Harrow,E09000015,4998 ,2450 ,2548 
E02000445,2005,Harrow 013,Harrow,E09000015,5951 ,3001 ,2950 
E02000447,2005,Harrow 015,Harrow,E09000015,4468 ,2185 ,2283 
E02000448,2005,Harrow 016,Harrow,E09000015,4083 ,2012 ,2071 
E02000449,2005,Harrow 017,Harrow,E09000015,5213 ,2602 ,2611 
E02000451,2005,Harrow 019,Harrow,E09000015,4198 ,2107 ,2091 
E02000452,2005,Harrow 020,Harrow,E09000015,5043 ,2592 ,2451 
E02000453,2005,Harrow 021,Harrow,E09000015,4656 ,2361 ,2295 
E02000454,2005,Harrow 022,Harrow,E09000015,4417 ,2184 ,2233 
E02000455,2005,Harrow 023,Harrow,E09000015,5153 ,2545 ,2608 
E02000456,2005,Harrow 024,Harrow,E09000015,4635 ,2271 ,2364 
E02000457,2005,Harrow 025,Harrow,E09000015,4029 ,2035 ,1994 
E02000459,2005,Harrow 027,Harrow,E09000015,4777 ,2433 ,2344 
E02000460,2005,Harrow 028,Harrow,E09000015,4421 ,2216 ,2205 
E02000461,2005,Harrow 029,Harrow,E09000015,4617 ,2515 ,2102 
E02000462,2005,Harrow 030,Harrow,E09000015,4196 ,2147 ,2049 
E02000463,2005,Harrow 031,Harrow,E09000015,5519 ,2710 ,2809 
E02006795,2005,Harrow 032,Harrow,E09000015,5212 ,2628 ,2584 
E02006882,2005,Harrow 033,Harrow,E09000015,9246 ,4585 ,4661 
E02000464,2005,Havering 001,Havering,E09000016,3637 ,1808 ,1829 
E02000465,2005,Havering 002,Havering,E09000016,4775 ,2298 ,2477 
E02000466,2005,Havering 003,Havering,E09000016,4906 ,2349 ,2557 
E02000467,2005,Havering 004,Havering,E09000016,5598 ,2669 ,2929 
E02000468,2005,Havering 005,Havering,E09000016,4807 ,2323 ,2484 
E02000469,2005,Havering 006,Havering,E09000016,3839 ,1835 ,2004 
E02000470,2005,Havering 007,Havering,E09000016,5206 ,2526 ,2680 
E02000471,2005,Havering 008,Havering,E09000016,4711 ,2309 ,2402 
E02000472,2005,Havering 009,Havering,E09000016,5626 ,2800 ,2826 
E02000473,2005,Havering 010,Havering,E09000016,5813 ,2828 ,2985 
E02000474,2005,Havering 011,Havering,E09000016,4916 ,2407 ,2509 
E02000475,2005,Havering 012,Havering,E09000016,5577 ,2726 ,2851 
E02000476,2005,Havering 013,Havering,E09000016,4346 ,2189 ,2157 
E02000477,2005,Havering 014,Havering,E09000016,5973 ,2927 ,3046 
E02000478,2005,Havering 015,Havering,E09000016,3547 ,1776 ,1771 
E02000479,2005,Havering 016,Havering,E09000016,5247 ,2591 ,2656 
E02000480,2005,Havering 017,Havering,E09000016,5841 ,2920 ,2921 
E02000481,2005,Havering 018,Havering,E09000016,4492 ,2173 ,2319 
E02000482,2005,Havering 019,Havering,E09000016,3816 ,1895 ,1921 
E02000483,2005,Havering 020,Havering,E09000016,4585 ,2256 ,2329 
E02000484,2005,Havering 021,Havering,E09000016,5375 ,2674 ,2701 
E02000485,2005,Havering 022,Havering,E09000016,4771 ,2368 ,2403 
E02000486,2005,Havering 023,Havering,E09000016,4781 ,2387 ,2394 
E02000487,2005,Havering 024,Havering,E09000016,4970 ,2469 ,2501 
E02000488,2005,Havering 025,Havering,E09000016,4936 ,2480 ,2456 
E02000489,2005,Havering 026,Havering,E09000016,4753 ,2297 ,2456 
E02000490,2005,Havering 027,Havering,E09000016,4581 ,2207 ,2374 
E02000491,2005,Havering 028,Havering,E09000016,5442 ,2702 ,2740 
E02000492,2005,Havering 029,Havering,E09000016,3889 ,1918 ,1971 
E02000493,2005,Havering 030,Havering,E09000016,4005 ,1918 ,2087 
E02000494,2005,Hillingdon 001,Hillingdon,E09000017,4921 ,2365 ,2556 
E02000495,2005,Hillingdon 002,Hillingdon,E09000017,6079 ,2896 ,3183 
E02000496,2005,Hillingdon 003,Hillingdon,E09000017,4655 ,2256 ,2399 
E02000497,2005,Hillingdon 004,Hillingdon,E09000017,4963 ,2366 ,2597 
E02000498,2005,Hillingdon 005,Hillingdon,E09000017,3789 ,1800 ,1989 
E02000499,2005,Hillingdon 006,Hillingdon,E09000017,4691 ,2267 ,2424 
E02000500,2005,Hillingdon 007,Hillingdon,E09000017,4648 ,2342 ,2306 
E02000501,2005,Hillingdon 008,Hillingdon,E09000017,5179 ,2482 ,2697 
E02000502,2005,Hillingdon 009,Hillingdon,E09000017,4637 ,2317 ,2320 
E02000503,2005,Hillingdon 010,Hillingdon,E09000017,5557 ,2780 ,2777 
E02000504,2005,Hillingdon 011,Hillingdon,E09000017,4418 ,2202 ,2216 
E02000506,2005,Hillingdon 013,Hillingdon,E09000017,4643 ,2291 ,2352 
E02000507,2005,Hillingdon 014,Hillingdon,E09000017,5083 ,2528 ,2555 
E02000508,2005,Hillingdon 015,Hillingdon,E09000017,5537 ,2881 ,2656 
E02000509,2005,Hillingdon 016,Hillingdon,E09000017,6290 ,3301 ,2989 
E02000510,2005,Hillingdon 017,Hillingdon,E09000017,5390 ,2634 ,2756 
E02000511,2005,Hillingdon 018,Hillingdon,E09000017,5863 ,2882 ,2981 
E02000512,2005,Hillingdon 019,Hillingdon,E09000017,4994 ,2416 ,2578 
E02000513,2005,Hillingdon 020,Hillingdon,E09000017,5296 ,2515 ,2781 
E02000514,2005,Hillingdon 021,Hillingdon,E09000017,6187 ,3059 ,3128 
E02000515,2005,Hillingdon 022,Hillingdon,E09000017,6179 ,3055 ,3124 
E02000516,2005,Hillingdon 023,Hillingdon,E09000017,5280 ,2638 ,2642 
E02000517,2005,Hillingdon 024,Hillingdon,E09000017,4935 ,2418 ,2517 
E02000518,2005,Hillingdon 025,Hillingdon,E09000017,5369 ,2637 ,2732 
E02000519,2005,Hillingdon 026,Hillingdon,E09000017,5152 ,2565 ,2587 
E02000520,2005,Hillingdon 027,Hillingdon,E09000017,6474 ,3339 ,3135 
E02000521,2005,Hillingdon 028,Hillingdon,E09000017,5160 ,2544 ,2616 
E02000522,2005,Hillingdon 029,Hillingdon,E09000017,5041 ,2503 ,2538 
E02000523,2005,Hillingdon 030,Hillingdon,E09000017,5771 ,3027 ,2744 
E02000524,2005,Hillingdon 031,Hillingdon,E09000017,4397 ,2387 ,2010 
E02000525,2005,Hillingdon 032,Hillingdon,E09000017,5363 ,2693 ,2670 
E02006796,2005,Hillingdon 033,Hillingdon,E09000017,5391 ,2673 ,2718 
E02000526,2005,Hounslow 001,Hounslow,E09000018,6048 ,2998 ,3050 
E02000528,2005,Hounslow 003,Hounslow,E09000018,6350 ,3064 ,3286 
E02000529,2005,Hounslow 004,Hounslow,E09000018,5235 ,2629 ,2606 
E02000530,2005,Hounslow 005,Hounslow,E09000018,4209 ,2051 ,2158 
E02000531,2005,Hounslow 006,Hounslow,E09000018,5930 ,2856 ,3074 
E02000532,2005,Hounslow 007,Hounslow,E09000018,6360 ,3151 ,3209 
E02000533,2005,Hounslow 008,Hounslow,E09000018,5958 ,3085 ,2873 
E02000534,2005,Hounslow 009,Hounslow,E09000018,4531 ,2333 ,2198 
E02000535,2005,Hounslow 010,Hounslow,E09000018,5802 ,2938 ,2864 
E02000536,2005,Hounslow 011,Hounslow,E09000018,5880 ,2970 ,2910 
E02000537,2005,Hounslow 012,Hounslow,E09000018,5875 ,3035 ,2840 
E02000538,2005,Hounslow 013,Hounslow,E09000018,5438 ,2899 ,2539 
E02000539,2005,Hounslow 014,Hounslow,E09000018,6121 ,2947 ,3174 
E02000540,2005,Hounslow 015,Hounslow,E09000018,5921 ,3076 ,2845 
E02000541,2005,Hounslow 016,Hounslow,E09000018,5411 ,2798 ,2613 
E02000542,2005,Hounslow 017,Hounslow,E09000018,5657 ,2977 ,2680 
E02000543,2005,Hounslow 018,Hounslow,E09000018,6352 ,3290 ,3062 
E02000544,2005,Hounslow 019,Hounslow,E09000018,5253 ,2593 ,2660 
E02000545,2005,Hounslow 020,Hounslow,E09000018,5468 ,2625 ,2843 
E02000546,2005,Hounslow 021,Hounslow,E09000018,5867 ,3088 ,2779 
E02000547,2005,Hounslow 022,Hounslow,E09000018,5421 ,2692 ,2729 
E02000548,2005,Hounslow 023,Hounslow,E09000018,4952 ,2479 ,2473 
E02000549,2005,Hounslow 024,Hounslow,E09000018,6428 ,3257 ,3171 
E02000550,2005,Hounslow 025,Hounslow,E09000018,5209 ,2516 ,2693 
E02000551,2005,Hounslow 026,Hounslow,E09000018,5071 ,2414 ,2657 
E02000552,2005,Hounslow 027,Hounslow,E09000018,5005 ,2628 ,2377 
E02000553,2005,Hounslow 028,Hounslow,E09000018,4139 ,2038 ,2101 
E02006792,2005,Hounslow 029,Hounslow,E09000018,6082 ,3112 ,2970 
E02000554,2005,Islington 001,Islington,E09000019,6549 ,3075 ,3474 
E02000555,2005,Islington 002,Islington,E09000019,6513 ,3077 ,3436 
E02000556,2005,Islington 003,Islington,E09000019,7137 ,3428 ,3709 
E02000557,2005,Islington 004,Islington,E09000019,5923 ,2819 ,3104 
E02000558,2005,Islington 005,Islington,E09000019,5488 ,2601 ,2887 
E02000559,2005,Islington 006,Islington,E09000019,5638 ,2813 ,2825 
E02000560,2005,Islington 007,Islington,E09000019,5460 ,2710 ,2750 
E02000561,2005,Islington 008,Islington,E09000019,5076 ,2502 ,2574 
E02000562,2005,Islington 009,Islington,E09000019,5288 ,2546 ,2742 
E02000563,2005,Islington 010,Islington,E09000019,5852 ,2689 ,3163 
E02000564,2005,Islington 011,Islington,E09000019,5598 ,2769 ,2829 
E02000565,2005,Islington 012,Islington,E09000019,5154 ,2477 ,2677 
E02000566,2005,Islington 013,Islington,E09000019,5519 ,2716 ,2803 
E02000567,2005,Islington 014,Islington,E09000019,7131 ,3476 ,3655 
E02000568,2005,Islington 015,Islington,E09000019,5639 ,3012 ,2627 
E02000569,2005,Islington 016,Islington,E09000019,6625 ,3123 ,3502 
E02000570,2005,Islington 017,Islington,E09000019,5959 ,2933 ,3026 
E02000571,2005,Islington 018,Islington,E09000019,5258 ,2553 ,2705 
E02000572,2005,Islington 019,Islington,E09000019,5107 ,2466 ,2641 
E02000573,2005,Islington 020,Islington,E09000019,6087 ,3110 ,2977 
E02000574,2005,Islington 021,Islington,E09000019,6062 ,2996 ,3066 
E02000575,2005,Islington 022,Islington,E09000019,7528 ,3946 ,3582 
E02000576,2005,Islington 023,Islington,E09000019,5417 ,2712 ,2705 
E02000577,2005,Kensington and Chelsea 001,Kensington and Chelsea,E09000020,5303 ,2600 ,2703 
E02000578,2005,Kensington and Chelsea 002,Kensington and Chelsea,E09000020,4159 ,1952 ,2207 
E02000579,2005,Kensington and Chelsea 003,Kensington and Chelsea,E09000020,5651 ,2614 ,3037 
E02000580,2005,Kensington and Chelsea 004,Kensington and Chelsea,E09000020,6684 ,3303 ,3381 
E02000581,2005,Kensington and Chelsea 005,Kensington and Chelsea,E09000020,5176 ,2486 ,2690 
E02000582,2005,Kensington and Chelsea 006,Kensington and Chelsea,E09000020,6723 ,3306 ,3417 
E02000583,2005,Kensington and Chelsea 007,Kensington and Chelsea,E09000020,5667 ,2698 ,2969 
E02000584,2005,Kensington and Chelsea 008,Kensington and Chelsea,E09000020,6352 ,3051 ,3301 
E02000585,2005,Kensington and Chelsea 009,Kensington and Chelsea,E09000020,6920 ,3395 ,3525 
E02000586,2005,Kensington and Chelsea 010,Kensington and Chelsea,E09000020,6610 ,3290 ,3320 
E02000587,2005,Kensington and Chelsea 011,Kensington and Chelsea,E09000020,5810 ,2889 ,2921 
E02000588,2005,Kensington and Chelsea 012,Kensington and Chelsea,E09000020,6493 ,3178 ,3315 
E02000589,2005,Kensington and Chelsea 013,Kensington and Chelsea,E09000020,7154 ,3937 ,3217 
E02000590,2005,Kensington and Chelsea 014,Kensington and Chelsea,E09000020,5825 ,2712 ,3113 
E02000591,2005,Kensington and Chelsea 015,Kensington and Chelsea,E09000020,5374 ,2891 ,2483 
E02000592,2005,Kensington and Chelsea 016,Kensington and Chelsea,E09000020,5949 ,2983 ,2966 
E02000593,2005,Kensington and Chelsea 017,Kensington and Chelsea,E09000020,5860 ,3074 ,2786 
E02000594,2005,Kensington and Chelsea 018,Kensington and Chelsea,E09000020,5275 ,2496 ,2779 
E02000595,2005,Kensington and Chelsea 019,Kensington and Chelsea,E09000020,5495 ,2615 ,2880 
E02000596,2005,Kensington and Chelsea 020,Kensington and Chelsea,E09000020,6295 ,3153 ,3142 
E02000597,2005,Kensington and Chelsea 021,Kensington and Chelsea,E09000020,5902 ,2830 ,3072 
E02000598,2005,Kingston upon Thames 001,Kingston upon Thames,E09000021,4697 ,2258 ,2439 
E02000599,2005,Kingston upon Thames 002,Kingston upon Thames,E09000021,4910 ,2407 ,2503 
E02000600,2005,Kingston upon Thames 003,Kingston upon Thames,E09000021,5634 ,2855 ,2779 
E02000601,2005,Kingston upon Thames 004,Kingston upon Thames,E09000021,6138 ,2972 ,3166 
E02000602,2005,Kingston upon Thames 005,Kingston upon Thames,E09000021,5898 ,3049 ,2849 
E02000603,2005,Kingston upon Thames 006,Kingston upon Thames,E09000021,5263 ,2594 ,2669 
E02000604,2005,Kingston upon Thames 007,Kingston upon Thames,E09000021,5733 ,2898 ,2835 
E02000605,2005,Kingston upon Thames 008,Kingston upon Thames,E09000021,5225 ,2606 ,2619 
E02000606,2005,Kingston upon Thames 009,Kingston upon Thames,E09000021,6897 ,3685 ,3212 
E02000607,2005,Kingston upon Thames 010,Kingston upon Thames,E09000021,4826 ,2487 ,2339 
E02000608,2005,Kingston upon Thames 011,Kingston upon Thames,E09000021,5289 ,2782 ,2507 
E02000609,2005,Kingston upon Thames 012,Kingston upon Thames,E09000021,4694 ,2380 ,2314 
E02000610,2005,Kingston upon Thames 013,Kingston upon Thames,E09000021,5594 ,2895 ,2699 
E02000611,2005,Kingston upon Thames 014,Kingston upon Thames,E09000021,4949 ,2481 ,2468 
E02000612,2005,Kingston upon Thames 015,Kingston upon Thames,E09000021,5249 ,2580 ,2669 
E02000613,2005,Kingston upon Thames 016,Kingston upon Thames,E09000021,5267 ,2588 ,2679 
E02000614,2005,Kingston upon Thames 017,Kingston upon Thames,E09000021,5646 ,2802 ,2844 
E02000615,2005,Kingston upon Thames 018,Kingston upon Thames,E09000021,5039 ,2510 ,2529 
E02000616,2005,Kingston upon Thames 019,Kingston upon Thames,E09000021,4075 ,1992 ,2083 
E02000617,2005,Kingston upon Thames 020,Kingston upon Thames,E09000021,5410 ,2584 ,2826 
E02000619,2005,Lambeth 002,Lambeth,E09000022,5499 ,2830 ,2669 
E02000620,2005,Lambeth 003,Lambeth,E09000022,5783 ,2994 ,2789 
E02000621,2005,Lambeth 004,Lambeth,E09000022,6595 ,3585 ,3010 
E02000622,2005,Lambeth 005,Lambeth,E09000022,5701 ,3006 ,2695 
E02000623,2005,Lambeth 006,Lambeth,E09000022,5436 ,2824 ,2612 
E02000624,2005,Lambeth 007,Lambeth,E09000022,5446 ,2751 ,2695 
E02000625,2005,Lambeth 008,Lambeth,E09000022,5911 ,3016 ,2895 
E02000626,2005,Lambeth 009,Lambeth,E09000022,5741 ,2839 ,2902 
E02000627,2005,Lambeth 010,Lambeth,E09000022,6510 ,3400 ,3110 
E02000628,2005,Lambeth 011,Lambeth,E09000022,6588 ,3338 ,3250 
E02000629,2005,Lambeth 012,Lambeth,E09000022,6401 ,3348 ,3053 
E02000630,2005,Lambeth 013,Lambeth,E09000022,5083 ,2564 ,2519 
E02000631,2005,Lambeth 014,Lambeth,E09000022,6305 ,3186 ,3119 
E02000632,2005,Lambeth 015,Lambeth,E09000022,7242 ,3766 ,3476 
E02000633,2005,Lambeth 016,Lambeth,E09000022,5865 ,3041 ,2824 
E02000634,2005,Lambeth 017,Lambeth,E09000022,4842 ,2501 ,2341 
E02000635,2005,Lambeth 018,Lambeth,E09000022,6286 ,3279 ,3007 
E02000636,2005,Lambeth 019,Lambeth,E09000022,5244 ,2693 ,2551 
E02000637,2005,Lambeth 020,Lambeth,E09000022,6304 ,3331 ,2973 
E02000638,2005,Lambeth 021,Lambeth,E09000022,6273 ,3183 ,3090 
E02000639,2005,Lambeth 022,Lambeth,E09000022,5712 ,2801 ,2911 
E02000640,2005,Lambeth 023,Lambeth,E09000022,6457 ,3268 ,3189 
E02000641,2005,Lambeth 024,Lambeth,E09000022,5675 ,2729 ,2946 
E02000642,2005,Lambeth 025,Lambeth,E09000022,6414 ,3138 ,3276 
E02000643,2005,Lambeth 026,Lambeth,E09000022,5617 ,2892 ,2725 
E02000644,2005,Lambeth 027,Lambeth,E09000022,5511 ,2840 ,2671 
E02000645,2005,Lambeth 028,Lambeth,E09000022,5677 ,2856 ,2821 
E02000646,2005,Lambeth 029,Lambeth,E09000022,5961 ,3076 ,2885 
E02000647,2005,Lambeth 030,Lambeth,E09000022,5220 ,2568 ,2652 
E02000648,2005,Lambeth 031,Lambeth,E09000022,4456 ,2138 ,2318 
E02000649,2005,Lambeth 032,Lambeth,E09000022,7030 ,3563 ,3467 
E02000650,2005,Lambeth 033,Lambeth,E09000022,5296 ,2548 ,2748 
E02000651,2005,Lambeth 034,Lambeth,E09000022,5381 ,2779 ,2602 
E02000652,2005,Lambeth 035,Lambeth,E09000022,4424 ,2175 ,2249 
E02006801,2005,Lambeth 036,Lambeth,E09000022,5918 ,3045 ,2873 
E02000653,2005,Lewisham 001,Lewisham,E09000023,4775 ,2435 ,2340 
E02000654,2005,Lewisham 002,Lewisham,E09000023,4864 ,2346 ,2518 
E02000655,2005,Lewisham 003,Lewisham,E09000023,5272 ,2704 ,2568 
E02000657,2005,Lewisham 005,Lewisham,E09000023,6267 ,3111 ,3156 
E02000658,2005,Lewisham 006,Lewisham,E09000023,5569 ,2831 ,2738 
E02000659,2005,Lewisham 007,Lewisham,E09000023,5296 ,2611 ,2685 
E02000660,2005,Lewisham 008,Lewisham,E09000023,5465 ,2824 ,2641 
E02000661,2005,Lewisham 009,Lewisham,E09000023,4290 ,2200 ,2090 
E02000662,2005,Lewisham 010,Lewisham,E09000023,5539 ,2794 ,2745 
E02000663,2005,Lewisham 011,Lewisham,E09000023,5180 ,2695 ,2485 
E02000664,2005,Lewisham 012,Lewisham,E09000023,6034 ,3144 ,2890 
E02000665,2005,Lewisham 013,Lewisham,E09000023,5032 ,2531 ,2501 
E02000666,2005,Lewisham 014,Lewisham,E09000023,5063 ,2539 ,2524 
E02000667,2005,Lewisham 015,Lewisham,E09000023,4530 ,2258 ,2272 
E02000668,2005,Lewisham 016,Lewisham,E09000023,4198 ,2106 ,2092 
E02000669,2005,Lewisham 017,Lewisham,E09000023,4660 ,2395 ,2265 
E02000670,2005,Lewisham 018,Lewisham,E09000023,4012 ,1965 ,2047 
E02000671,2005,Lewisham 019,Lewisham,E09000023,5594 ,2746 ,2848 
E02000672,2005,Lewisham 020,Lewisham,E09000023,4947 ,2508 ,2439 
E02000673,2005,Lewisham 021,Lewisham,E09000023,5258 ,2650 ,2608 
E02000674,2005,Lewisham 022,Lewisham,E09000023,5287 ,2554 ,2733 
E02000675,2005,Lewisham 023,Lewisham,E09000023,5312 ,2623 ,2689 
E02000676,2005,Lewisham 024,Lewisham,E09000023,5027 ,2498 ,2529 
E02000677,2005,Lewisham 025,Lewisham,E09000023,4579 ,2305 ,2274 
E02000678,2005,Lewisham 026,Lewisham,E09000023,3750 ,1779 ,1971 
E02000679,2005,Lewisham 027,Lewisham,E09000023,5110 ,2524 ,2586 
E02000680,2005,Lewisham 028,Lewisham,E09000023,4276 ,2155 ,2121 
E02000681,2005,Lewisham 029,Lewisham,E09000023,5121 ,2436 ,2685 
E02000682,2005,Lewisham 030,Lewisham,E09000023,4818 ,2308 ,2510 
E02000683,2005,Lewisham 031,Lewisham,E09000023,3995 ,1916 ,2079 
E02000685,2005,Lewisham 033,Lewisham,E09000023,5031 ,2355 ,2676 
E02000686,2005,Lewisham 034,Lewisham,E09000023,4359 ,1993 ,2366 
E02000687,2005,Lewisham 035,Lewisham,E09000023,5381 ,2616 ,2765 
E02006783,2005,Lewisham 037,Lewisham,E09000023,4378 ,2056 ,2322 
E02006784,2005,Lewisham 038,Lewisham,E09000023,4377 ,2168 ,2209 
E02006798,2005,Lewisham 039,Lewisham,E09000023,5561 ,2790 ,2771 
E02000689,2005,Merton 001,Merton,E09000024,5198 ,2621 ,2577 
E02000690,2005,Merton 002,Merton,E09000024,3676 ,1855 ,1821 
E02000691,2005,Merton 003,Merton,E09000024,5466 ,2762 ,2704 
E02000692,2005,Merton 004,Merton,E09000024,5595 ,2953 ,2642 
E02000693,2005,Merton 005,Merton,E09000024,6455 ,3291 ,3164 
E02000694,2005,Merton 006,Merton,E09000024,6495 ,3242 ,3253 
E02000695,2005,Merton 007,Merton,E09000024,5819 ,3048 ,2771 
E02000696,2005,Merton 008,Merton,E09000024,5729 ,2889 ,2840 
E02000697,2005,Merton 009,Merton,E09000024,6360 ,3246 ,3114 
E02000698,2005,Merton 010,Merton,E09000024,5209 ,2595 ,2614 
E02000699,2005,Merton 011,Merton,E09000024,5679 ,2869 ,2810 
E02000700,2005,Merton 012,Merton,E09000024,5689 ,2750 ,2939 
E02000701,2005,Merton 013,Merton,E09000024,4966 ,2514 ,2452 
E02000702,2005,Merton 014,Merton,E09000024,4870 ,2330 ,2540 
E02000703,2005,Merton 015,Merton,E09000024,5242 ,2610 ,2632 
E02000704,2005,Merton 016,Merton,E09000024,5439 ,2733 ,2706 
E02000705,2005,Merton 017,Merton,E09000024,4998 ,2400 ,2598 
E02000706,2005,Merton 018,Merton,E09000024,5014 ,2425 ,2589 
E02000707,2005,Merton 019,Merton,E09000024,4679 ,2209 ,2470 
E02000708,2005,Merton 020,Merton,E09000024,5382 ,2669 ,2713 
E02000709,2005,Merton 021,Merton,E09000024,4926 ,2448 ,2478 
E02000710,2005,Merton 022,Merton,E09000024,4913 ,2393 ,2520 
E02000711,2005,Merton 023,Merton,E09000024,5182 ,2601 ,2581 
E02000712,2005,Merton 024,Merton,E09000024,4779 ,2321 ,2458 
E02000713,2005,Merton 025,Merton,E09000024,4515 ,2230 ,2285 
E02000714,2005,Newham 001,Newham,E09000025,4497 ,2243 ,2254 
E02000715,2005,Newham 002,Newham,E09000025,3907 ,1993 ,1914 
E02000716,2005,Newham 003,Newham,E09000025,4104 ,2145 ,1959 
E02000717,2005,Newham 004,Newham,E09000025,4370 ,2282 ,2088 
E02000718,2005,Newham 005,Newham,E09000025,3576 ,1721 ,1855 
E02000719,2005,Newham 006,Newham,E09000025,4610 ,2334 ,2276 
E02000720,2005,Newham 007,Newham,E09000025,4327 ,2322 ,2005 
E02000721,2005,Newham 008,Newham,E09000025,5405 ,2889 ,2516 
E02000722,2005,Newham 009,Newham,E09000025,4842 ,2526 ,2316 
E02000723,2005,Newham 010,Newham,E09000025,6012 ,3307 ,2705 
E02000724,2005,Newham 011,Newham,E09000025,5241 ,2935 ,2306 
E02000725,2005,Newham 012,Newham,E09000025,4693 ,2417 ,2276 
E02000726,2005,Newham 013,Newham,E09000025,5173 ,2707 ,2466 
E02000727,2005,Newham 014,Newham,E09000025,4659 ,2573 ,2086 
E02000728,2005,Newham 015,Newham,E09000025,5638 ,3208 ,2430 
E02000729,2005,Newham 016,Newham,E09000025,4031 ,2128 ,1903 
E02000730,2005,Newham 017,Newham,E09000025,4987 ,2694 ,2293 
E02000731,2005,Newham 018,Newham,E09000025,5519 ,3141 ,2378 
E02000732,2005,Newham 019,Newham,E09000025,3972 ,2098 ,1874 
E02000733,2005,Newham 020,Newham,E09000025,5461 ,2652 ,2809 
E02000734,2005,Newham 021,Newham,E09000025,3830 ,1879 ,1951 
E02000735,2005,Newham 022,Newham,E09000025,4049 ,2164 ,1885 
E02000736,2005,Newham 023,Newham,E09000025,4845 ,2462 ,2383 
E02000737,2005,Newham 024,Newham,E09000025,4991 ,2556 ,2435 
E02000738,2005,Newham 025,Newham,E09000025,4470 ,2323 ,2147 
E02000739,2005,Newham 026,Newham,E09000025,4009 ,2034 ,1975 
E02000740,2005,Newham 027,Newham,E09000025,3965 ,1915 ,2050 
E02000741,2005,Newham 028,Newham,E09000025,4514 ,2235 ,2279 
E02000742,2005,Newham 029,Newham,E09000025,4138 ,2081 ,2057 
E02000743,2005,Newham 030,Newham,E09000025,4215 ,2106 ,2109 
E02000744,2005,Newham 031,Newham,E09000025,4315 ,2133 ,2182 
E02000745,2005,Newham 032,Newham,E09000025,5098 ,2524 ,2574 
E02000746,2005,Newham 033,Newham,E09000025,3995 ,1881 ,2114 
E02000747,2005,Newham 034,Newham,E09000025,5569 ,2769 ,2800 
E02000748,2005,Newham 035,Newham,E09000025,3987 ,1968 ,2019 
E02000749,2005,Newham 036,Newham,E09000025,4632 ,2227 ,2405 
E02000750,2005,Newham 037,Newham,E09000025,5708 ,2970 ,2738 
E02000751,2005,Redbridge 001,Redbridge,E09000026,6412 ,3132 ,3280 
E02000752,2005,Redbridge 002,Redbridge,E09000026,3783 ,1807 ,1976 
E02000753,2005,Redbridge 003,Redbridge,E09000026,3602 ,1717 ,1885 
E02000754,2005,Redbridge 004,Redbridge,E09000026,4144 ,1984 ,2160 
E02000755,2005,Redbridge 005,Redbridge,E09000026,3441 ,1661 ,1780 
E02000756,2005,Redbridge 006,Redbridge,E09000026,7691 ,3710 ,3981 
E02000757,2005,Redbridge 007,Redbridge,E09000026,6813 ,3447 ,3366 
E02000758,2005,Redbridge 008,Redbridge,E09000026,3625 ,1760 ,1865 
E02000759,2005,Redbridge 009,Redbridge,E09000026,7517 ,3685 ,3832 
E02000760,2005,Redbridge 010,Redbridge,E09000026,3732 ,1800 ,1932 
E02000762,2005,Redbridge 012,Redbridge,E09000026,3833 ,1932 ,1901 
E02000763,2005,Redbridge 013,Redbridge,E09000026,4187 ,2039 ,2148 
E02000764,2005,Redbridge 014,Redbridge,E09000026,7490 ,3686 ,3804 
E02000765,2005,Redbridge 015,Redbridge,E09000026,3746 ,1857 ,1889 
E02000767,2005,Redbridge 017,Redbridge,E09000026,4284 ,2118 ,2166 
E02000768,2005,Redbridge 018,Redbridge,E09000026,3816 ,1873 ,1943 
E02000769,2005,Redbridge 019,Redbridge,E09000026,7774 ,3701 ,4073 
E02000770,2005,Redbridge 020,Redbridge,E09000026,4503 ,2289 ,2214 
E02000772,2005,Redbridge 022,Redbridge,E09000026,4346 ,2232 ,2114 
E02000773,2005,Redbridge 023,Redbridge,E09000026,5013 ,2475 ,2538 
E02000774,2005,Redbridge 024,Redbridge,E09000026,4482 ,2334 ,2148 
E02000776,2005,Redbridge 026,Redbridge,E09000026,3986 ,1998 ,1988 
E02000777,2005,Redbridge 027,Redbridge,E09000026,3945 ,1991 ,1954 
E02000779,2005,Redbridge 029,Redbridge,E09000026,4681 ,2496 ,2185 
E02000780,2005,Redbridge 030,Redbridge,E09000026,8014 ,4196 ,3818 
E02000781,2005,Redbridge 031,Redbridge,E09000026,7696 ,3932 ,3764 
E02000782,2005,Redbridge 032,Redbridge,E09000026,5412 ,2847 ,2565 
E02000783,2005,Redbridge 033,Redbridge,E09000026,4066 ,2013 ,2053 
E02006800,2005,Redbridge 034,Redbridge,E09000026,8108 ,4138 ,3970 
E02006924,2005,Redbridge 035,Redbridge,E09000026,7990 ,4066 ,3924 
E02006925,2005,Redbridge 036,Redbridge,E09000026,7965 ,3917 ,4048 
E02000784,2005,Richmond upon Thames 001,Richmond upon Thames,E09000027,7126 ,3529 ,3597 
E02000785,2005,Richmond upon Thames 002,Richmond upon Thames,E09000027,6890 ,3417 ,3473 
E02000786,2005,Richmond upon Thames 003,Richmond upon Thames,E09000027,7833 ,3915 ,3918 
E02000787,2005,Richmond upon Thames 004,Richmond upon Thames,E09000027,6921 ,3427 ,3494 
E02000788,2005,Richmond upon Thames 005,Richmond upon Thames,E09000027,5786 ,2820 ,2966 
E02000789,2005,Richmond upon Thames 006,Richmond upon Thames,E09000027,4393 ,2251 ,2142 
E02000790,2005,Richmond upon Thames 007,Richmond upon Thames,E09000027,4149 ,2098 ,2051 
E02000791,2005,Richmond upon Thames 008,Richmond upon Thames,E09000027,4659 ,2443 ,2216 
E02000792,2005,Richmond upon Thames 009,Richmond upon Thames,E09000027,5070 ,2607 ,2463 
E02000793,2005,Richmond upon Thames 010,Richmond upon Thames,E09000027,5144 ,2575 ,2569 
E02000794,2005,Richmond upon Thames 011,Richmond upon Thames,E09000027,4261 ,2106 ,2155 
E02000795,2005,Richmond upon Thames 012,Richmond upon Thames,E09000027,4166 ,2142 ,2024 
E02000796,2005,Richmond upon Thames 013,Richmond upon Thames,E09000027,6490 ,3275 ,3215 
E02000797,2005,Richmond upon Thames 014,Richmond upon Thames,E09000027,5122 ,2631 ,2491 
E02000798,2005,Richmond upon Thames 015,Richmond upon Thames,E09000027,7324 ,3622 ,3702 
E02000799,2005,Richmond upon Thames 016,Richmond upon Thames,E09000027,4385 ,2157 ,2228 
E02000800,2005,Richmond upon Thames 017,Richmond upon Thames,E09000027,3371 ,1619 ,1752 
E02000801,2005,Richmond upon Thames 018,Richmond upon Thames,E09000027,4617 ,2247 ,2370 
E02000802,2005,Richmond upon Thames 019,Richmond upon Thames,E09000027,4333 ,2134 ,2199 
E02000803,2005,Richmond upon Thames 020,Richmond upon Thames,E09000027,6070 ,2955 ,3115 
E02000804,2005,Richmond upon Thames 021,Richmond upon Thames,E09000027,4734 ,2354 ,2380 
E02000805,2005,Richmond upon Thames 022,Richmond upon Thames,E09000027,6570 ,3201 ,3369 
E02000806,2005,Richmond upon Thames 023,Richmond upon Thames,E09000027,6238 ,3040 ,3198 
E02000807,2005,Southwark 001,Southwark,E09000028,6196 ,3310 ,2886 
E02000808,2005,Southwark 002,Southwark,E09000028,6261 ,3311 ,2950 
E02000809,2005,Southwark 003,Southwark,E09000028,8056 ,4506 ,3550 
E02000810,2005,Southwark 004,Southwark,E09000028,5380 ,2809 ,2571 
E02000812,2005,Southwark 006,Southwark,E09000028,6814 ,3517 ,3297 
E02000813,2005,Southwark 007,Southwark,E09000028,5560 ,2899 ,2661 
E02000814,2005,Southwark 008,Southwark,E09000028,6348 ,3424 ,2924 
E02000815,2005,Southwark 009,Southwark,E09000028,6426 ,3481 ,2945 
E02000816,2005,Southwark 010,Southwark,E09000028,5337 ,2669 ,2668 
E02000817,2005,Southwark 011,Southwark,E09000028,3971 ,1888 ,2083 
E02000818,2005,Southwark 012,Southwark,E09000028,5420 ,2678 ,2742 
E02000819,2005,Southwark 013,Southwark,E09000028,5001 ,2547 ,2454 
E02000820,2005,Southwark 014,Southwark,E09000028,5341 ,2669 ,2672 
E02000821,2005,Southwark 015,Southwark,E09000028,5370 ,2621 ,2749 
E02000822,2005,Southwark 016,Southwark,E09000028,5463 ,2713 ,2750 
E02000823,2005,Southwark 017,Southwark,E09000028,4997 ,2491 ,2506 
E02000824,2005,Southwark 018,Southwark,E09000028,5766 ,2746 ,3020 
E02000825,2005,Southwark 019,Southwark,E09000028,5254 ,2503 ,2751 
E02000826,2005,Southwark 020,Southwark,E09000028,5440 ,2620 ,2820 
E02000827,2005,Southwark 021,Southwark,E09000028,6627 ,3268 ,3359 
E02000828,2005,Southwark 022,Southwark,E09000028,5455 ,2777 ,2678 
E02000829,2005,Southwark 023,Southwark,E09000028,6179 ,3186 ,2993 
E02000830,2005,Southwark 024,Southwark,E09000028,5846 ,2892 ,2954 
E02000831,2005,Southwark 025,Southwark,E09000028,5699 ,2881 ,2818 
E02000832,2005,Southwark 026,Southwark,E09000028,5827 ,2772 ,3055 
E02000833,2005,Southwark 027,Southwark,E09000028,5292 ,2459 ,2833 
E02000834,2005,Southwark 028,Southwark,E09000028,6437 ,3165 ,3272 
E02000835,2005,Southwark 029,Southwark,E09000028,4667 ,2280 ,2387 
E02000836,2005,Southwark 030,Southwark,E09000028,5817 ,2834 ,2983 
E02000837,2005,Southwark 031,Southwark,E09000028,5151 ,2483 ,2668 
E02000838,2005,Southwark 032,Southwark,E09000028,5932 ,2867 ,3065 
E02000839,2005,Southwark 033,Southwark,E09000028,5247 ,2614 ,2633 
E02006802,2005,Southwark 034,Southwark,E09000028,5685 ,2817 ,2868 
E02000840,2005,Sutton 001,Sutton,E09000029,4957 ,2345 ,2612 
E02000841,2005,Sutton 002,Sutton,E09000029,5130 ,2474 ,2656 
E02000842,2005,Sutton 003,Sutton,E09000029,4878 ,2435 ,2443 
E02000843,2005,Sutton 004,Sutton,E09000029,5368 ,2612 ,2756 
E02000844,2005,Sutton 005,Sutton,E09000029,4945 ,2400 ,2545 
E02000845,2005,Sutton 006,Sutton,E09000029,4956 ,2382 ,2574 
E02000846,2005,Sutton 007,Sutton,E09000029,4329 ,2138 ,2191 
E02000847,2005,Sutton 008,Sutton,E09000029,5551 ,2749 ,2802 
E02000848,2005,Sutton 009,Sutton,E09000029,4938 ,2428 ,2510 
E02000849,2005,Sutton 010,Sutton,E09000029,4918 ,2448 ,2470 
E02000850,2005,Sutton 011,Sutton,E09000029,6635 ,3305 ,3330 
E02000851,2005,Sutton 012,Sutton,E09000029,5195 ,2725 ,2470 
E02000852,2005,Sutton 013,Sutton,E09000029,5063 ,2527 ,2536 
E02000853,2005,Sutton 014,Sutton,E09000029,4950 ,2447 ,2503 
E02000854,2005,Sutton 015,Sutton,E09000029,4570 ,2249 ,2321 
E02000855,2005,Sutton 016,Sutton,E09000029,4727 ,2291 ,2436 
E02000856,2005,Sutton 017,Sutton,E09000029,5363 ,2714 ,2649 
E02000857,2005,Sutton 018,Sutton,E09000029,5194 ,2654 ,2540 
E02000858,2005,Sutton 019,Sutton,E09000029,4469 ,2136 ,2333 
E02000859,2005,Sutton 020,Sutton,E09000029,5254 ,2599 ,2655 
E02000860,2005,Sutton 021,Sutton,E09000029,5000 ,2582 ,2418 
E02000861,2005,Sutton 022,Sutton,E09000029,5037 ,2479 ,2558 
E02000863,2005,Sutton 024,Sutton,E09000029,4101 ,2018 ,2083 
E02006836,2005,Sutton 025,Sutton,E09000029,5157 ,2547 ,2610 
E02000864,2005,Tower Hamlets 001,Tower Hamlets,E09000030,4383 ,2108 ,2275 
E02000865,2005,Tower Hamlets 002,Tower Hamlets,E09000030,4565 ,2250 ,2315 
E02000866,2005,Tower Hamlets 003,Tower Hamlets,E09000030,6170 ,3073 ,3097 
E02000867,2005,Tower Hamlets 004,Tower Hamlets,E09000030,4867 ,2461 ,2406 
E02000868,2005,Tower Hamlets 005,Tower Hamlets,E09000030,4279 ,2135 ,2144 
E02000869,2005,Tower Hamlets 006,Tower Hamlets,E09000030,3660 ,1888 ,1772 
E02000870,2005,Tower Hamlets 007,Tower Hamlets,E09000030,3991 ,2032 ,1959 
E02000871,2005,Tower Hamlets 008,Tower Hamlets,E09000030,4780 ,2438 ,2342 
E02000872,2005,Tower Hamlets 009,Tower Hamlets,E09000030,4676 ,2480 ,2196 
E02000873,2005,Tower Hamlets 010,Tower Hamlets,E09000030,5054 ,2506 ,2548 
E02000874,2005,Tower Hamlets 011,Tower Hamlets,E09000030,4917 ,2493 ,2424 
E02000875,2005,Tower Hamlets 012,Tower Hamlets,E09000030,5343 ,2728 ,2615 
E02000876,2005,Tower Hamlets 013,Tower Hamlets,E09000030,4731 ,2574 ,2157 
E02000877,2005,Tower Hamlets 014,Tower Hamlets,E09000030,6067 ,3095 ,2972 
E02000878,2005,Tower Hamlets 015,Tower Hamlets,E09000030,6856 ,3801 ,3055 
E02000879,2005,Tower Hamlets 016,Tower Hamlets,E09000030,4368 ,2161 ,2207 
E02000880,2005,Tower Hamlets 017,Tower Hamlets,E09000030,3844 ,1940 ,1904 
E02000881,2005,Tower Hamlets 018,Tower Hamlets,E09000030,3868 ,1908 ,1960 
E02000882,2005,Tower Hamlets 019,Tower Hamlets,E09000030,4692 ,2323 ,2369 
E02000883,2005,Tower Hamlets 020,Tower Hamlets,E09000030,4300 ,2096 ,2204 
E02000884,2005,Tower Hamlets 021,Tower Hamlets,E09000030,5534 ,3050 ,2484 
E02000885,2005,Tower Hamlets 022,Tower Hamlets,E09000030,3837 ,2001 ,1836 
E02000886,2005,Tower Hamlets 023,Tower Hamlets,E09000030,4436 ,2421 ,2015 
E02000887,2005,Tower Hamlets 024,Tower Hamlets,E09000030,4723 ,2327 ,2396 
E02000888,2005,Tower Hamlets 025,Tower Hamlets,E09000030,4713 ,2574 ,2139 
E02000889,2005,Tower Hamlets 026,Tower Hamlets,E09000030,4726 ,2572 ,2154 
E02000890,2005,Tower Hamlets 027,Tower Hamlets,E09000030,4472 ,2464 ,2008 
E02000891,2005,Tower Hamlets 028,Tower Hamlets,E09000030,6591 ,3544 ,3047 
E02000893,2005,Tower Hamlets 030,Tower Hamlets,E09000030,4706 ,2469 ,2237 
E02000894,2005,Tower Hamlets 031,Tower Hamlets,E09000030,6813 ,3704 ,3109 
E02006853,2005,Tower Hamlets 032,Tower Hamlets,E09000030,2914 ,1533 ,1381 
E02006854,2005,Tower Hamlets 033,Tower Hamlets,E09000030,2586 ,1474 ,1112 
E02000895,2005,Waltham Forest 001,Waltham Forest,E09000031,4526 ,2161 ,2365 
E02000896,2005,Waltham Forest 002,Waltham Forest,E09000031,5214 ,2593 ,2621 
E02000897,2005,Waltham Forest 003,Waltham Forest,E09000031,4581 ,2147 ,2434 
E02000898,2005,Waltham Forest 004,Waltham Forest,E09000031,4748 ,2292 ,2456 
E02000899,2005,Waltham Forest 005,Waltham Forest,E09000031,4833 ,2358 ,2475 
E02000900,2005,Waltham Forest 006,Waltham Forest,E09000031,4947 ,2386 ,2561 
E02000901,2005,Waltham Forest 007,Waltham Forest,E09000031,5918 ,2878 ,3040 
E02000902,2005,Waltham Forest 008,Waltham Forest,E09000031,5006 ,2408 ,2598 
E02000903,2005,Waltham Forest 009,Waltham Forest,E09000031,5334 ,2582 ,2752 
E02000904,2005,Waltham Forest 010,Waltham Forest,E09000031,4426 ,2176 ,2250 
E02000905,2005,Waltham Forest 011,Waltham Forest,E09000031,5567 ,2759 ,2808 
E02000906,2005,Waltham Forest 012,Waltham Forest,E09000031,5820 ,2919 ,2901 
E02000907,2005,Waltham Forest 013,Waltham Forest,E09000031,5623 ,2756 ,2867 
E02000908,2005,Waltham Forest 014,Waltham Forest,E09000031,6030 ,3172 ,2858 
E02000909,2005,Waltham Forest 015,Waltham Forest,E09000031,5253 ,2674 ,2579 
E02000910,2005,Waltham Forest 016,Waltham Forest,E09000031,6709 ,3427 ,3282 
E02000911,2005,Waltham Forest 017,Waltham Forest,E09000031,6179 ,3069 ,3110 
E02000912,2005,Waltham Forest 018,Waltham Forest,E09000031,5422 ,2705 ,2717 
E02000913,2005,Waltham Forest 019,Waltham Forest,E09000031,5434 ,2736 ,2698 
E02000914,2005,Waltham Forest 020,Waltham Forest,E09000031,6328 ,3267 ,3061 
E02000915,2005,Waltham Forest 021,Waltham Forest,E09000031,5720 ,2946 ,2774 
E02000916,2005,Waltham Forest 022,Waltham Forest,E09000031,5569 ,2786 ,2783 
E02000917,2005,Waltham Forest 023,Waltham Forest,E09000031,5507 ,2843 ,2664 
E02000918,2005,Waltham Forest 024,Waltham Forest,E09000031,5621 ,2938 ,2683 
E02000919,2005,Waltham Forest 025,Waltham Forest,E09000031,5723 ,2992 ,2731 
E02000920,2005,Waltham Forest 026,Waltham Forest,E09000031,5672 ,2870 ,2802 
E02000921,2005,Waltham Forest 027,Waltham Forest,E09000031,6668 ,3331 ,3337 
E02000922,2005,Waltham Forest 028,Waltham Forest,E09000031,6371 ,3296 ,3075 
E02000923,2005,Wandsworth 001,Wandsworth,E09000032,5207 ,2710 ,2497 
E02000924,2005,Wandsworth 002,Wandsworth,E09000032,6664 ,3305 ,3359 
E02000925,2005,Wandsworth 003,Wandsworth,E09000032,4935 ,2411 ,2524 
E02000926,2005,Wandsworth 004,Wandsworth,E09000032,5379 ,2703 ,2676 
E02000927,2005,Wandsworth 005,Wandsworth,E09000032,5268 ,2582 ,2686 
E02000928,2005,Wandsworth 006,Wandsworth,E09000032,6256 ,3058 ,3198 
E02000929,2005,Wandsworth 007,Wandsworth,E09000032,4545 ,2168 ,2377 
E02000930,2005,Wandsworth 008,Wandsworth,E09000032,7142 ,3478 ,3664 
E02000931,2005,Wandsworth 009,Wandsworth,E09000032,6644 ,3391 ,3253 
E02000932,2005,Wandsworth 010,Wandsworth,E09000032,7267 ,3635 ,3632 
E02000933,2005,Wandsworth 011,Wandsworth,E09000032,6047 ,2893 ,3154 
E02000934,2005,Wandsworth 012,Wandsworth,E09000032,6719 ,3357 ,3362 
E02000935,2005,Wandsworth 013,Wandsworth,E09000032,4226 ,1747 ,2479 
E02000936,2005,Wandsworth 014,Wandsworth,E09000032,6186 ,3017 ,3169 
E02000937,2005,Wandsworth 015,Wandsworth,E09000032,5727 ,2837 ,2890 
E02000938,2005,Wandsworth 016,Wandsworth,E09000032,6023 ,2838 ,3185 
E02000939,2005,Wandsworth 017,Wandsworth,E09000032,5430 ,2716 ,2714 
E02000940,2005,Wandsworth 018,Wandsworth,E09000032,5171 ,2487 ,2684 
E02000941,2005,Wandsworth 019,Wandsworth,E09000032,7605 ,3951 ,3654 
E02000942,2005,Wandsworth 020,Wandsworth,E09000032,6666 ,3283 ,3383 
E02000943,2005,Wandsworth 021,Wandsworth,E09000032,6172 ,3107 ,3065 
E02000944,2005,Wandsworth 022,Wandsworth,E09000032,4216 ,1946 ,2270 
E02000945,2005,Wandsworth 023,Wandsworth,E09000032,4625 ,2073 ,2552 
E02000946,2005,Wandsworth 024,Wandsworth,E09000032,5599 ,2840 ,2759 
E02000947,2005,Wandsworth 025,Wandsworth,E09000032,6556 ,3113 ,3443 
E02000948,2005,Wandsworth 026,Wandsworth,E09000032,7935 ,3963 ,3972 
E02000949,2005,Wandsworth 027,Wandsworth,E09000032,7219 ,3545 ,3674 
E02000950,2005,Wandsworth 028,Wandsworth,E09000032,5232 ,2532 ,2700 
E02000951,2005,Wandsworth 029,Wandsworth,E09000032,5065 ,2537 ,2528 
E02000952,2005,Wandsworth 030,Wandsworth,E09000032,4655 ,2371 ,2284 
E02000953,2005,Wandsworth 031,Wandsworth,E09000032,4677 ,2103 ,2574 
E02000954,2005,Wandsworth 032,Wandsworth,E09000032,4503 ,2239 ,2264 
E02000955,2005,Wandsworth 033,Wandsworth,E09000032,4601 ,2216 ,2385 
E02000956,2005,Wandsworth 034,Wandsworth,E09000032,5130 ,2407 ,2723 
E02000957,2005,Wandsworth 035,Wandsworth,E09000032,7292 ,3657 ,3635 
E02000958,2005,Wandsworth 036,Wandsworth,E09000032,5560 ,2646 ,2914 
E02000959,2005,Wandsworth 037,Wandsworth,E09000032,4846 ,2359 ,2487 
E02000960,2005,Westminster 001,Westminster,E09000033,4927 ,2288 ,2639 
E02000961,2005,Westminster 002,Westminster,E09000033,6333 ,3007 ,3326 
E02000962,2005,Westminster 003,Westminster,E09000033,6487 ,3174 ,3313 
E02000963,2005,Westminster 004,Westminster,E09000033,6700 ,3059 ,3641 
E02000964,2005,Westminster 005,Westminster,E09000033,8254 ,3813 ,4441 
E02000965,2005,Westminster 006,Westminster,E09000033,7332 ,3541 ,3791 
E02000966,2005,Westminster 007,Westminster,E09000033,7277 ,3580 ,3697 
E02000967,2005,Westminster 008,Westminster,E09000033,6279 ,3224 ,3055 
E02000968,2005,Westminster 009,Westminster,E09000033,10003 ,4850 ,5153 
E02000969,2005,Westminster 010,Westminster,E09000033,6617 ,3085 ,3532 
E02000970,2005,Westminster 011,Westminster,E09000033,7555 ,3856 ,3699 
E02000971,2005,Westminster 012,Westminster,E09000033,7810 ,4208 ,3602 
E02000972,2005,Westminster 013,Westminster,E09000033,6893 ,3692 ,3201 
E02000973,2005,Westminster 014,Westminster,E09000033,7785 ,3879 ,3906 
E02000974,2005,Westminster 015,Westminster,E09000033,7218 ,3955 ,3263 
E02000975,2005,Westminster 016,Westminster,E09000033,8231 ,4515 ,3716 
E02000976,2005,Westminster 017,Westminster,E09000033,9081 ,4828 ,4253 
E02000977,2005,Westminster 018,Westminster,E09000033,6021 ,3449 ,2572 
E02000978,2005,Westminster 019,Westminster,E09000033,8707 ,4455 ,4252 
E02000979,2005,Westminster 020,Westminster,E09000033,6543 ,3293 ,3250 
E02000980,2005,Westminster 021,Westminster,E09000033,5931 ,2967 ,2964 
E02000981,2005,Westminster 022,Westminster,E09000033,7397 ,3851 ,3546 
E02000982,2005,Westminster 023,Westminster,E09000033,5786 ,3067 ,2719 
E02000983,2005,Westminster 024,Westminster,E09000033,6569 ,3292 ,3277 
E02000001,2006,City of London 001,City of London,E09000001,5754 ,3224 ,2530 
E02000002,2006,Barking and Dagenham 001,Barking and Dagenham,E09000002,3699 ,1772 ,1927 
E02000003,2006,Barking and Dagenham 002,Barking and Dagenham,E09000002,5974 ,2884 ,3090 
E02000004,2006,Barking and Dagenham 003,Barking and Dagenham,E09000002,3735 ,1793 ,1942 
E02000005,2006,Barking and Dagenham 004,Barking and Dagenham,E09000002,5063 ,2421 ,2642 
E02000007,2006,Barking and Dagenham 006,Barking and Dagenham,E09000002,4759 ,2205 ,2554 
E02000008,2006,Barking and Dagenham 007,Barking and Dagenham,E09000002,6705 ,3139 ,3566 
E02000009,2006,Barking and Dagenham 008,Barking and Dagenham,E09000002,5494 ,2755 ,2739 
E02000010,2006,Barking and Dagenham 009,Barking and Dagenham,E09000002,4712 ,2254 ,2458 
E02000011,2006,Barking and Dagenham 010,Barking and Dagenham,E09000002,3668 ,1833 ,1835 
E02000012,2006,Barking and Dagenham 011,Barking and Dagenham,E09000002,5349 ,2684 ,2665 
E02000013,2006,Barking and Dagenham 012,Barking and Dagenham,E09000002,4667 ,2218 ,2449 
E02000014,2006,Barking and Dagenham 013,Barking and Dagenham,E09000002,5401 ,2635 ,2766 
E02000015,2006,Barking and Dagenham 014,Barking and Dagenham,E09000002,4159 ,1955 ,2204 
E02000016,2006,Barking and Dagenham 015,Barking and Dagenham,E09000002,3752 ,2043 ,1709 
E02000017,2006,Barking and Dagenham 016,Barking and Dagenham,E09000002,5295 ,2880 ,2415 
E02000018,2006,Barking and Dagenham 017,Barking and Dagenham,E09000002,4996 ,2355 ,2641 
E02000019,2006,Barking and Dagenham 018,Barking and Dagenham,E09000002,4653 ,2234 ,2419 
E02000020,2006,Barking and Dagenham 019,Barking and Dagenham,E09000002,5163 ,2566 ,2597 
E02000021,2006,Barking and Dagenham 020,Barking and Dagenham,E09000002,4783 ,2303 ,2480 
E02000022,2006,Barking and Dagenham 021,Barking and Dagenham,E09000002,4739 ,2282 ,2457 
E02000023,2006,Barking and Dagenham 022,Barking and Dagenham,E09000002,4076 ,1927 ,2149 
E02006799,2006,Barking and Dagenham 023,Barking and Dagenham,E09000002,5560 ,2671 ,2889 
E02000024,2006,Barnet 001,Barnet,E09000003,6212 ,2954 ,3258 
E02000025,2006,Barnet 002,Barnet,E09000003,5294 ,2597 ,2697 
E02000026,2006,Barnet 003,Barnet,E09000003,3975 ,1893 ,2082 
E02000027,2006,Barnet 004,Barnet,E09000003,6250 ,2896 ,3354 
E02000028,2006,Barnet 005,Barnet,E09000003,3831 ,1870 ,1961 
E02000029,2006,Barnet 006,Barnet,E09000003,5619 ,2721 ,2898 
E02000030,2006,Barnet 007,Barnet,E09000003,5751 ,2730 ,3021 
E02000031,2006,Barnet 008,Barnet,E09000003,4563 ,2212 ,2351 
E02000032,2006,Barnet 009,Barnet,E09000003,4788 ,2246 ,2542 
E02000033,2006,Barnet 010,Barnet,E09000003,4898 ,2309 ,2589 
E02000034,2006,Barnet 011,Barnet,E09000003,5443 ,2606 ,2837 
E02000035,2006,Barnet 012,Barnet,E09000003,5620 ,2817 ,2803 
E02000036,2006,Barnet 013,Barnet,E09000003,6561 ,3132 ,3429 
E02000037,2006,Barnet 014,Barnet,E09000003,5903 ,2805 ,3098 
E02000038,2006,Barnet 015,Barnet,E09000003,6676 ,3251 ,3425 
E02000039,2006,Barnet 016,Barnet,E09000003,4190 ,2043 ,2147 
E02000040,2006,Barnet 017,Barnet,E09000003,4052 ,1927 ,2125 
E02000041,2006,Barnet 018,Barnet,E09000003,5548 ,2759 ,2789 
E02000042,2006,Barnet 019,Barnet,E09000003,7083 ,3599 ,3484 
E02000043,2006,Barnet 020,Barnet,E09000003,5048 ,2478 ,2570 
E02000044,2006,Barnet 021,Barnet,E09000003,5158 ,2408 ,2750 
E02000045,2006,Barnet 022,Barnet,E09000003,6570 ,3142 ,3428 
E02000046,2006,Barnet 023,Barnet,E09000003,4685 ,2381 ,2304 
E02000047,2006,Barnet 024,Barnet,E09000003,6595 ,3092 ,3503 
E02000048,2006,Barnet 025,Barnet,E09000003,5786 ,2833 ,2953 
E02000049,2006,Barnet 026,Barnet,E09000003,5143 ,2231 ,2912 
E02000050,2006,Barnet 027,Barnet,E09000003,6613 ,3195 ,3418 
E02000051,2006,Barnet 028,Barnet,E09000003,5382 ,2700 ,2682 
E02000052,2006,Barnet 029,Barnet,E09000003,6541 ,3096 ,3445 
E02000053,2006,Barnet 030,Barnet,E09000003,4758 ,2393 ,2365 
E02000054,2006,Barnet 031,Barnet,E09000003,4496 ,2228 ,2268 
E02000055,2006,Barnet 032,Barnet,E09000003,6567 ,3339 ,3228 
E02000056,2006,Barnet 033,Barnet,E09000003,5227 ,2368 ,2859 
E02000057,2006,Barnet 034,Barnet,E09000003,4243 ,2072 ,2171 
E02000058,2006,Barnet 035,Barnet,E09000003,5940 ,2811 ,3129 
E02000059,2006,Barnet 036,Barnet,E09000003,6007 ,2859 ,3148 
E02000060,2006,Barnet 037,Barnet,E09000003,6136 ,3064 ,3072 
E02000061,2006,Barnet 038,Barnet,E09000003,5192 ,2604 ,2588 
E02000062,2006,Barnet 039,Barnet,E09000003,3893 ,1884 ,2009 
E02000063,2006,Barnet 040,Barnet,E09000003,4477 ,2202 ,2275 
E02000064,2006,Barnet 041,Barnet,E09000003,3871 ,1825 ,2046 
E02000065,2006,Bexley 001,Bexley,E09000004,4563 ,2216 ,2347 
E02000066,2006,Bexley 002,Bexley,E09000004,6207 ,2917 ,3290 
E02000067,2006,Bexley 003,Bexley,E09000004,5302 ,2529 ,2773 
E02000068,2006,Bexley 004,Bexley,E09000004,4265 ,2081 ,2184 
E02000069,2006,Bexley 005,Bexley,E09000004,3741 ,1839 ,1902 
E02000070,2006,Bexley 006,Bexley,E09000004,4980 ,2423 ,2557 
E02000071,2006,Bexley 007,Bexley,E09000004,4779 ,2291 ,2488 
E02000072,2006,Bexley 008,Bexley,E09000004,7204 ,3388 ,3816 
E02000073,2006,Bexley 009,Bexley,E09000004,6628 ,3273 ,3355 
E02000074,2006,Bexley 010,Bexley,E09000004,4716 ,2249 ,2467 
E02000075,2006,Bexley 011,Bexley,E09000004,4937 ,2446 ,2491 
E02000077,2006,Bexley 013,Bexley,E09000004,4784 ,2312 ,2472 
E02000078,2006,Bexley 014,Bexley,E09000004,5127 ,2516 ,2611 
E02000079,2006,Bexley 015,Bexley,E09000004,4953 ,2451 ,2502 
E02000080,2006,Bexley 016,Bexley,E09000004,5809 ,2874 ,2935 
E02000081,2006,Bexley 017,Bexley,E09000004,4641 ,2275 ,2366 
E02000082,2006,Bexley 018,Bexley,E09000004,5672 ,2853 ,2819 
E02000083,2006,Bexley 019,Bexley,E09000004,6015 ,2944 ,3071 
E02000084,2006,Bexley 020,Bexley,E09000004,6662 ,3298 ,3364 
E02000085,2006,Bexley 021,Bexley,E09000004,4926 ,2426 ,2500 
E02000086,2006,Bexley 022,Bexley,E09000004,4808 ,2334 ,2474 
E02000087,2006,Bexley 023,Bexley,E09000004,4408 ,2243 ,2165 
E02000088,2006,Bexley 024,Bexley,E09000004,4844 ,2372 ,2472 
E02000089,2006,Bexley 025,Bexley,E09000004,4789 ,2291 ,2498 
E02000090,2006,Bexley 026,Bexley,E09000004,5309 ,2554 ,2755 
E02000091,2006,Bexley 027,Bexley,E09000004,5732 ,2780 ,2952 
E02000092,2006,Bexley 028,Bexley,E09000004,3691 ,1748 ,1943 
E02006785,2006,Bexley 029,Bexley,E09000004,3880 ,1901 ,1979 
E02000093,2006,Brent 001,Brent,E09000005,6426 ,3171 ,3255 
E02000094,2006,Brent 002,Brent,E09000005,4876 ,2426 ,2450 
E02000095,2006,Brent 003,Brent,E09000005,5863 ,2910 ,2953 
E02000096,2006,Brent 004,Brent,E09000005,4539 ,2273 ,2266 
E02000097,2006,Brent 005,Brent,E09000005,5281 ,2671 ,2610 
E02000098,2006,Brent 006,Brent,E09000005,4588 ,2273 ,2315 
E02000099,2006,Brent 007,Brent,E09000005,4769 ,2374 ,2395 
E02000100,2006,Brent 008,Brent,E09000005,5263 ,2508 ,2755 
E02000101,2006,Brent 009,Brent,E09000005,5281 ,2496 ,2785 
E02000102,2006,Brent 010,Brent,E09000005,4761 ,2411 ,2350 
E02000103,2006,Brent 011,Brent,E09000005,5206 ,2671 ,2535 
E02000104,2006,Brent 012,Brent,E09000005,3980 ,2049 ,1931 
E02000105,2006,Brent 013,Brent,E09000005,5126 ,2631 ,2495 
E02000106,2006,Brent 014,Brent,E09000005,6486 ,3300 ,3186 
E02000107,2006,Brent 015,Brent,E09000005,7945 ,4223 ,3722 
E02000108,2006,Brent 016,Brent,E09000005,3968 ,2056 ,1912 
E02000109,2006,Brent 017,Brent,E09000005,5473 ,2874 ,2599 
E02000110,2006,Brent 018,Brent,E09000005,5608 ,2793 ,2815 
E02000111,2006,Brent 019,Brent,E09000005,5616 ,2912 ,2704 
E02000112,2006,Brent 020,Brent,E09000005,5613 ,2941 ,2672 
E02000113,2006,Brent 021,Brent,E09000005,5624 ,2605 ,3019 
E02000114,2006,Brent 022,Brent,E09000005,6010 ,3035 ,2975 
E02000115,2006,Brent 023,Brent,E09000005,5875 ,3028 ,2847 
E02000116,2006,Brent 024,Brent,E09000005,4606 ,2339 ,2267 
E02000117,2006,Brent 025,Brent,E09000005,7251 ,3516 ,3735 
E02000118,2006,Brent 026,Brent,E09000005,5774 ,2977 ,2797 
E02000119,2006,Brent 027,Brent,E09000005,4273 ,2134 ,2139 
E02000120,2006,Brent 028,Brent,E09000005,6566 ,3225 ,3341 
E02000121,2006,Brent 029,Brent,E09000005,5518 ,2862 ,2656 
E02000122,2006,Brent 030,Brent,E09000005,5355 ,2640 ,2715 
E02000123,2006,Brent 031,Brent,E09000005,9025 ,4656 ,4369 
E02000124,2006,Brent 032,Brent,E09000005,6988 ,3527 ,3461 
E02000125,2006,Brent 033,Brent,E09000005,7092 ,3513 ,3579 
E02000126,2006,Brent 034,Brent,E09000005,4673 ,2261 ,2412 
E02000127,2006,Bromley 001,Bromley,E09000006,5387 ,2479 ,2908 
E02000128,2006,Bromley 002,Bromley,E09000006,4857 ,2335 ,2522 
E02000130,2006,Bromley 004,Bromley,E09000006,5313 ,2557 ,2756 
E02000131,2006,Bromley 005,Bromley,E09000006,6316 ,3110 ,3206 
E02000132,2006,Bromley 006,Bromley,E09000006,5615 ,2786 ,2829 
E02000133,2006,Bromley 007,Bromley,E09000006,5689 ,2810 ,2879 
E02000134,2006,Bromley 008,Bromley,E09000006,7148 ,3509 ,3639 
E02000135,2006,Bromley 009,Bromley,E09000006,6386 ,2997 ,3389 
E02000136,2006,Bromley 010,Bromley,E09000006,3365 ,1673 ,1692 
E02000137,2006,Bromley 011,Bromley,E09000006,5017 ,2443 ,2574 
E02000138,2006,Bromley 012,Bromley,E09000006,5010 ,2531 ,2479 
E02000139,2006,Bromley 013,Bromley,E09000006,5058 ,2452 ,2606 
E02000140,2006,Bromley 014,Bromley,E09000006,4580 ,2166 ,2414 
E02000141,2006,Bromley 015,Bromley,E09000006,5006 ,2438 ,2568 
E02000142,2006,Bromley 016,Bromley,E09000006,5194 ,2580 ,2614 
E02000144,2006,Bromley 018,Bromley,E09000006,5432 ,2713 ,2719 
E02000145,2006,Bromley 019,Bromley,E09000006,4698 ,2213 ,2485 
E02000146,2006,Bromley 020,Bromley,E09000006,5124 ,2519 ,2605 
E02000147,2006,Bromley 021,Bromley,E09000006,4748 ,2342 ,2406 
E02000148,2006,Bromley 022,Bromley,E09000006,3856 ,1894 ,1962 
E02000149,2006,Bromley 023,Bromley,E09000006,4773 ,2273 ,2500 
E02000150,2006,Bromley 024,Bromley,E09000006,5098 ,2458 ,2640 
E02000151,2006,Bromley 025,Bromley,E09000006,4667 ,2284 ,2383 
E02000152,2006,Bromley 026,Bromley,E09000006,4043 ,1910 ,2133 
E02000153,2006,Bromley 027,Bromley,E09000006,4791 ,2286 ,2505 
E02000154,2006,Bromley 028,Bromley,E09000006,4965 ,2498 ,2467 
E02000155,2006,Bromley 029,Bromley,E09000006,4294 ,2115 ,2179 
E02000156,2006,Bromley 030,Bromley,E09000006,7367 ,3655 ,3712 
E02000157,2006,Bromley 031,Bromley,E09000006,4670 ,2281 ,2389 
E02000158,2006,Bromley 032,Bromley,E09000006,4377 ,2092 ,2285 
E02000159,2006,Bromley 033,Bromley,E09000006,3961 ,1936 ,2025 
E02000160,2006,Bromley 034,Bromley,E09000006,4810 ,2408 ,2402 
E02000161,2006,Bromley 035,Bromley,E09000006,5256 ,2559 ,2697 
E02000162,2006,Bromley 036,Bromley,E09000006,3945 ,1886 ,2059 
E02000163,2006,Bromley 037,Bromley,E09000006,4855 ,2400 ,2455 
E02000165,2006,Bromley 039,Bromley,E09000006,4839 ,2403 ,2436 
E02006782,2006,Bromley 040,Bromley,E09000006,4734 ,2251 ,2483 
E02006787,2006,Bromley 041,Bromley,E09000006,4923 ,2339 ,2584 
E02006789,2006,Bromley 042,Bromley,E09000006,3769 ,1858 ,1911 
E02000166,2006,Camden 001,Camden,E09000007,5701 ,2574 ,3127 
E02000167,2006,Camden 002,Camden,E09000007,5456 ,2653 ,2803 
E02000168,2006,Camden 003,Camden,E09000007,5777 ,2769 ,3008 
E02000169,2006,Camden 004,Camden,E09000007,4537 ,2074 ,2463 
E02000170,2006,Camden 005,Camden,E09000007,5934 ,2818 ,3116 
E02000171,2006,Camden 006,Camden,E09000007,5260 ,2524 ,2736 
E02000172,2006,Camden 007,Camden,E09000007,6617 ,3207 ,3410 
E02000173,2006,Camden 008,Camden,E09000007,5258 ,2558 ,2700 
E02000174,2006,Camden 009,Camden,E09000007,6488 ,3128 ,3360 
E02000175,2006,Camden 010,Camden,E09000007,6911 ,3273 ,3638 
E02000176,2006,Camden 011,Camden,E09000007,4700 ,2345 ,2355 
E02000177,2006,Camden 012,Camden,E09000007,5757 ,2726 ,3031 
E02000178,2006,Camden 013,Camden,E09000007,6744 ,3227 ,3517 
E02000179,2006,Camden 014,Camden,E09000007,4195 ,2066 ,2129 
E02000180,2006,Camden 015,Camden,E09000007,5968 ,3014 ,2954 
E02000181,2006,Camden 016,Camden,E09000007,6340 ,3096 ,3244 
E02000182,2006,Camden 017,Camden,E09000007,4098 ,1891 ,2207 
E02000183,2006,Camden 018,Camden,E09000007,5656 ,2842 ,2814 
E02000184,2006,Camden 019,Camden,E09000007,6054 ,2997 ,3057 
E02000185,2006,Camden 020,Camden,E09000007,5706 ,2778 ,2928 
E02000186,2006,Camden 021,Camden,E09000007,5280 ,2863 ,2417 
E02000187,2006,Camden 022,Camden,E09000007,5280 ,2565 ,2715 
E02000188,2006,Camden 023,Camden,E09000007,5428 ,2757 ,2671 
E02000189,2006,Camden 024,Camden,E09000007,4124 ,2026 ,2098 
E02000190,2006,Camden 025,Camden,E09000007,6046 ,3095 ,2951 
E02000191,2006,Camden 026,Camden,E09000007,5944 ,3081 ,2863 
E02000192,2006,Camden 027,Camden,E09000007,4985 ,2700 ,2285 
E02000193,2006,Camden 028,Camden,E09000007,6211 ,3173 ,3038 
E02000194,2006,Croydon 001,Croydon,E09000008,5497 ,2734 ,2763 
E02000195,2006,Croydon 002,Croydon,E09000008,5575 ,2797 ,2778 
E02000196,2006,Croydon 003,Croydon,E09000008,4365 ,2104 ,2261 
E02000197,2006,Croydon 004,Croydon,E09000008,5540 ,2647 ,2893 
E02000198,2006,Croydon 005,Croydon,E09000008,5218 ,2434 ,2784 
E02000199,2006,Croydon 006,Croydon,E09000008,5246 ,2474 ,2772 
E02000200,2006,Croydon 007,Croydon,E09000008,5560 ,2693 ,2867 
E02000201,2006,Croydon 008,Croydon,E09000008,5297 ,2575 ,2722 
E02000202,2006,Croydon 009,Croydon,E09000008,5877 ,2904 ,2973 
E02000203,2006,Croydon 010,Croydon,E09000008,5090 ,2502 ,2588 
E02000204,2006,Croydon 011,Croydon,E09000008,6300 ,3066 ,3234 
E02000206,2006,Croydon 013,Croydon,E09000008,6073 ,2875 ,3198 
E02000207,2006,Croydon 014,Croydon,E09000008,5409 ,2547 ,2862 
E02000208,2006,Croydon 015,Croydon,E09000008,5277 ,2633 ,2644 
E02000209,2006,Croydon 016,Croydon,E09000008,5385 ,2600 ,2785 
E02000210,2006,Croydon 017,Croydon,E09000008,5519 ,2687 ,2832 
E02000211,2006,Croydon 018,Croydon,E09000008,5064 ,2500 ,2564 
E02000212,2006,Croydon 019,Croydon,E09000008,5008 ,2457 ,2551 
E02000213,2006,Croydon 020,Croydon,E09000008,6013 ,3101 ,2912 
E02000214,2006,Croydon 021,Croydon,E09000008,4005 ,2057 ,1948 
E02000215,2006,Croydon 022,Croydon,E09000008,7147 ,3713 ,3434 
E02000216,2006,Croydon 023,Croydon,E09000008,4223 ,2242 ,1981 
E02000217,2006,Croydon 024,Croydon,E09000008,5689 ,2869 ,2820 
E02000218,2006,Croydon 025,Croydon,E09000008,3905 ,1804 ,2101 
E02000219,2006,Croydon 026,Croydon,E09000008,4596 ,2242 ,2354 
E02000220,2006,Croydon 027,Croydon,E09000008,6439 ,3411 ,3028 
E02000221,2006,Croydon 028,Croydon,E09000008,5602 ,2632 ,2970 
E02000222,2006,Croydon 029,Croydon,E09000008,5344 ,2680 ,2664 
E02000223,2006,Croydon 030,Croydon,E09000008,4661 ,2045 ,2616 
E02000224,2006,Croydon 031,Croydon,E09000008,5267 ,2692 ,2575 
E02000225,2006,Croydon 032,Croydon,E09000008,4590 ,2151 ,2439 
E02000226,2006,Croydon 033,Croydon,E09000008,4909 ,2466 ,2443 
E02000227,2006,Croydon 034,Croydon,E09000008,7641 ,3633 ,4008 
E02000228,2006,Croydon 035,Croydon,E09000008,4593 ,2222 ,2371 
E02000229,2006,Croydon 036,Croydon,E09000008,3484 ,1623 ,1861 
E02000230,2006,Croydon 037,Croydon,E09000008,6081 ,3097 ,2984 
E02000231,2006,Croydon 038,Croydon,E09000008,4852 ,2443 ,2409 
E02000232,2006,Croydon 039,Croydon,E09000008,3746 ,1786 ,1960 
E02000233,2006,Croydon 040,Croydon,E09000008,3773 ,1847 ,1926 
E02000234,2006,Croydon 041,Croydon,E09000008,5038 ,2459 ,2579 
E02000235,2006,Croydon 042,Croydon,E09000008,4450 ,2139 ,2311 
E02000236,2006,Croydon 043,Croydon,E09000008,4905 ,2428 ,2477 
E02000237,2006,Croydon 044,Croydon,E09000008,4540 ,2197 ,2343 
E02006788,2006,Croydon 045,Croydon,E09000008,4824 ,2160 ,2664 
E02000238,2006,Ealing 001,Ealing,E09000009,6015 ,3040 ,2975 
E02000239,2006,Ealing 002,Ealing,E09000009,5985 ,3104 ,2881 
E02000240,2006,Ealing 003,Ealing,E09000009,5977 ,2833 ,3144 
E02000241,2006,Ealing 004,Ealing,E09000009,4256 ,2159 ,2097 
E02000242,2006,Ealing 005,Ealing,E09000009,4346 ,2294 ,2052 
E02000243,2006,Ealing 006,Ealing,E09000009,5782 ,2932 ,2850 
E02000244,2006,Ealing 007,Ealing,E09000009,4538 ,2363 ,2175 
E02000245,2006,Ealing 008,Ealing,E09000009,5054 ,2410 ,2644 
E02000246,2006,Ealing 009,Ealing,E09000009,5283 ,2528 ,2755 
E02000247,2006,Ealing 010,Ealing,E09000009,5405 ,2577 ,2828 
E02000248,2006,Ealing 011,Ealing,E09000009,5039 ,2688 ,2351 
E02000249,2006,Ealing 012,Ealing,E09000009,4680 ,2386 ,2294 
E02000250,2006,Ealing 013,Ealing,E09000009,4431 ,2221 ,2210 
E02000251,2006,Ealing 014,Ealing,E09000009,5141 ,2569 ,2572 
E02000252,2006,Ealing 015,Ealing,E09000009,6216 ,3293 ,2923 
E02000253,2006,Ealing 016,Ealing,E09000009,5921 ,2764 ,3157 
E02000254,2006,Ealing 017,Ealing,E09000009,5837 ,3003 ,2834 
E02000255,2006,Ealing 018,Ealing,E09000009,6502 ,3167 ,3335 
E02000256,2006,Ealing 019,Ealing,E09000009,6075 ,3116 ,2959 
E02000257,2006,Ealing 020,Ealing,E09000009,9946 ,5269 ,4677 
E02000258,2006,Ealing 021,Ealing,E09000009,4505 ,2202 ,2303 
E02000259,2006,Ealing 022,Ealing,E09000009,4314 ,2068 ,2246 
E02000260,2006,Ealing 023,Ealing,E09000009,5520 ,2894 ,2626 
E02000261,2006,Ealing 024,Ealing,E09000009,6671 ,3360 ,3311 
E02000262,2006,Ealing 025,Ealing,E09000009,5874 ,3021 ,2853 
E02000263,2006,Ealing 026,Ealing,E09000009,7428 ,4042 ,3386 
E02000264,2006,Ealing 027,Ealing,E09000009,5630 ,2729 ,2901 
E02000265,2006,Ealing 028,Ealing,E09000009,7546 ,3825 ,3721 
E02000266,2006,Ealing 029,Ealing,E09000009,7973 ,3999 ,3974 
E02000267,2006,Ealing 030,Ealing,E09000009,4750 ,2354 ,2396 
E02000268,2006,Ealing 031,Ealing,E09000009,6703 ,3382 ,3321 
E02000269,2006,Ealing 032,Ealing,E09000009,5821 ,2952 ,2869 
E02000270,2006,Ealing 033,Ealing,E09000009,5059 ,2313 ,2746 
E02000271,2006,Ealing 034,Ealing,E09000009,4868 ,2411 ,2457 
E02000272,2006,Ealing 035,Ealing,E09000009,4549 ,2276 ,2273 
E02000274,2006,Ealing 037,Ealing,E09000009,7538 ,3980 ,3558 
E02000275,2006,Ealing 038,Ealing,E09000009,4238 ,2192 ,2046 
E02000276,2006,Ealing 039,Ealing,E09000009,4404 ,2144 ,2260 
E02006791,2006,Ealing 040,Ealing,E09000009,5380 ,2763 ,2617 
E02000277,2006,Enfield 001,Enfield,E09000010,4281 ,2055 ,2226 
E02000278,2006,Enfield 002,Enfield,E09000010,4996 ,2360 ,2636 
E02000279,2006,Enfield 003,Enfield,E09000010,6521 ,3037 ,3484 
E02000280,2006,Enfield 004,Enfield,E09000010,5233 ,2504 ,2729 
E02000281,2006,Enfield 005,Enfield,E09000010,5163 ,2444 ,2719 
E02000282,2006,Enfield 006,Enfield,E09000010,5378 ,2568 ,2810 
E02000283,2006,Enfield 007,Enfield,E09000010,5056 ,2501 ,2555 
E02000284,2006,Enfield 008,Enfield,E09000010,5117 ,2475 ,2642 
E02000285,2006,Enfield 009,Enfield,E09000010,4149 ,2007 ,2142 
E02000286,2006,Enfield 010,Enfield,E09000010,5185 ,2663 ,2522 
E02000287,2006,Enfield 011,Enfield,E09000010,4232 ,2161 ,2071 
E02000288,2006,Enfield 012,Enfield,E09000010,5899 ,2890 ,3009 
E02000289,2006,Enfield 013,Enfield,E09000010,4028 ,1968 ,2060 
E02000290,2006,Enfield 014,Enfield,E09000010,4426 ,2125 ,2301 
E02000291,2006,Enfield 015,Enfield,E09000010,5383 ,2727 ,2656 
E02000292,2006,Enfield 016,Enfield,E09000010,6006 ,2975 ,3031 
E02000293,2006,Enfield 017,Enfield,E09000010,3893 ,1934 ,1959 
E02000294,2006,Enfield 018,Enfield,E09000010,5397 ,2614 ,2783 
E02000295,2006,Enfield 019,Enfield,E09000010,5423 ,2652 ,2771 
E02000296,2006,Enfield 020,Enfield,E09000010,5623 ,2730 ,2893 
E02000297,2006,Enfield 021,Enfield,E09000010,6013 ,3035 ,2978 
E02000298,2006,Enfield 022,Enfield,E09000010,5247 ,2617 ,2630 
E02000299,2006,Enfield 023,Enfield,E09000010,5449 ,2668 ,2781 
E02000300,2006,Enfield 024,Enfield,E09000010,5104 ,2465 ,2639 
E02000301,2006,Enfield 025,Enfield,E09000010,5939 ,2835 ,3104 
E02000302,2006,Enfield 026,Enfield,E09000010,5254 ,2616 ,2638 
E02000303,2006,Enfield 027,Enfield,E09000010,4926 ,2358 ,2568 
E02000304,2006,Enfield 028,Enfield,E09000010,5065 ,2504 ,2561 
E02000305,2006,Enfield 029,Enfield,E09000010,5537 ,2817 ,2720 
E02000306,2006,Enfield 030,Enfield,E09000010,4591 ,2113 ,2478 
E02000307,2006,Enfield 031,Enfield,E09000010,5938 ,2889 ,3049 
E02000308,2006,Enfield 032,Enfield,E09000010,4991 ,2577 ,2414 
E02000309,2006,Enfield 033,Enfield,E09000010,6142 ,2965 ,3177 
E02000311,2006,Enfield 035,Enfield,E09000010,6159 ,3008 ,3151 
E02000312,2006,Enfield 036,Enfield,E09000010,6711 ,3476 ,3235 
E02006793,2006,Enfield 037,Enfield,E09000010,5354 ,2524 ,2830 
E02000313,2006,Greenwich 001,Greenwich,E09000011,3973 ,1971 ,2002 
E02000314,2006,Greenwich 002,Greenwich,E09000011,7138 ,3747 ,3391 
E02000315,2006,Greenwich 003,Greenwich,E09000011,5093 ,2395 ,2698 
E02000316,2006,Greenwich 004,Greenwich,E09000011,5442 ,2781 ,2661 
E02000317,2006,Greenwich 005,Greenwich,E09000011,5509 ,2691 ,2818 
E02000318,2006,Greenwich 006,Greenwich,E09000011,5752 ,2937 ,2815 
E02000319,2006,Greenwich 007,Greenwich,E09000011,6436 ,3277 ,3159 
E02000320,2006,Greenwich 008,Greenwich,E09000011,4135 ,1966 ,2169 
E02000321,2006,Greenwich 009,Greenwich,E09000011,4429 ,2235 ,2194 
E02000323,2006,Greenwich 011,Greenwich,E09000011,6500 ,3212 ,3288 
E02000324,2006,Greenwich 012,Greenwich,E09000011,4465 ,2175 ,2290 
E02000326,2006,Greenwich 014,Greenwich,E09000011,4591 ,2208 ,2383 
E02000327,2006,Greenwich 015,Greenwich,E09000011,4144 ,2153 ,1991 
E02000328,2006,Greenwich 016,Greenwich,E09000011,4316 ,2176 ,2140 
E02000329,2006,Greenwich 017,Greenwich,E09000011,4067 ,2009 ,2058 
E02000331,2006,Greenwich 019,Greenwich,E09000011,4837 ,2392 ,2445 
E02000332,2006,Greenwich 020,Greenwich,E09000011,4721 ,2362 ,2359 
E02000333,2006,Greenwich 021,Greenwich,E09000011,4255 ,2251 ,2004 
E02000334,2006,Greenwich 022,Greenwich,E09000011,4046 ,2036 ,2010 
E02000335,2006,Greenwich 023,Greenwich,E09000011,4151 ,2061 ,2090 
E02000337,2006,Greenwich 025,Greenwich,E09000011,5115 ,2445 ,2670 
E02000339,2006,Greenwich 027,Greenwich,E09000011,3827 ,1898 ,1929 
E02000340,2006,Greenwich 028,Greenwich,E09000011,3761 ,1902 ,1859 
E02000341,2006,Greenwich 029,Greenwich,E09000011,4807 ,2259 ,2548 
E02000342,2006,Greenwich 030,Greenwich,E09000011,4063 ,1888 ,2175 
E02000343,2006,Greenwich 031,Greenwich,E09000011,4093 ,2028 ,2065 
E02000344,2006,Greenwich 032,Greenwich,E09000011,4061 ,1999 ,2062 
E02006786,2006,Greenwich 033,Greenwich,E09000011,4381 ,2150 ,2231 
E02006927,2006,Greenwich 034,Greenwich,E09000011,7191 ,3479 ,3712 
E02006928,2006,Greenwich 035,Greenwich,E09000011,4578 ,2349 ,2229 
E02006929,2006,Greenwich 036,Greenwich,E09000011,4508 ,2258 ,2250 
E02006930,2006,Greenwich 037,Greenwich,E09000011,4783 ,2425 ,2358 
E02006931,2006,Greenwich 038,Greenwich,E09000011,6195 ,3118 ,3077 
E02000345,2006,Hackney 001,Hackney,E09000012,4774 ,2485 ,2289 
E02000346,2006,Hackney 002,Hackney,E09000012,4669 ,2359 ,2310 
E02000347,2006,Hackney 003,Hackney,E09000012,4711 ,2399 ,2312 
E02000348,2006,Hackney 004,Hackney,E09000012,4917 ,2436 ,2481 
E02000350,2006,Hackney 006,Hackney,E09000012,6453 ,3200 ,3253 
E02000351,2006,Hackney 007,Hackney,E09000012,6070 ,3068 ,3002 
E02000352,2006,Hackney 008,Hackney,E09000012,4222 ,1995 ,2227 
E02000353,2006,Hackney 009,Hackney,E09000012,5349 ,2588 ,2761 
E02000354,2006,Hackney 010,Hackney,E09000012,5844 ,2896 ,2948 
E02000355,2006,Hackney 011,Hackney,E09000012,5617 ,2787 ,2830 
E02000356,2006,Hackney 012,Hackney,E09000012,5232 ,2564 ,2668 
E02000357,2006,Hackney 013,Hackney,E09000012,3998 ,1861 ,2137 
E02000358,2006,Hackney 014,Hackney,E09000012,7462 ,3689 ,3773 
E02000359,2006,Hackney 015,Hackney,E09000012,4354 ,2043 ,2311 
E02000360,2006,Hackney 016,Hackney,E09000012,7120 ,3523 ,3597 
E02000361,2006,Hackney 017,Hackney,E09000012,4906 ,2506 ,2400 
E02000362,2006,Hackney 018,Hackney,E09000012,3745 ,1766 ,1979 
E02000363,2006,Hackney 019,Hackney,E09000012,6544 ,3134 ,3410 
E02000364,2006,Hackney 020,Hackney,E09000012,5726 ,2855 ,2871 
E02000365,2006,Hackney 021,Hackney,E09000012,7953 ,4018 ,3935 
E02000366,2006,Hackney 022,Hackney,E09000012,5373 ,2568 ,2805 
E02000367,2006,Hackney 023,Hackney,E09000012,5951 ,2811 ,3140 
E02000368,2006,Hackney 024,Hackney,E09000012,6378 ,3118 ,3260 
E02000369,2006,Hackney 025,Hackney,E09000012,6990 ,3486 ,3504 
E02000370,2006,Hackney 026,Hackney,E09000012,4776 ,2410 ,2366 
E02000371,2006,Hackney 027,Hackney,E09000012,7199 ,3855 ,3344 
E02006918,2006,Hackney 028,Hackney,E09000012,3703 ,1856 ,1847 
E02006921,2006,Hackney 029,Hackney,E09000012,4738 ,2284 ,2454 
E02000372,2006,Hammersmith and Fulham 001,Hammersmith and Fulham,E09000013,5732 ,2693 ,3039 
E02000373,2006,Hammersmith and Fulham 002,Hammersmith and Fulham,E09000013,4230 ,1897 ,2333 
E02000374,2006,Hammersmith and Fulham 003,Hammersmith and Fulham,E09000013,4426 ,2125 ,2301 
E02000375,2006,Hammersmith and Fulham 004,Hammersmith and Fulham,E09000013,4996 ,2519 ,2477 
E02000376,2006,Hammersmith and Fulham 005,Hammersmith and Fulham,E09000013,5190 ,2560 ,2630 
E02000377,2006,Hammersmith and Fulham 006,Hammersmith and Fulham,E09000013,5694 ,2746 ,2948 
E02000378,2006,Hammersmith and Fulham 007,Hammersmith and Fulham,E09000013,4884 ,2308 ,2576 
E02000379,2006,Hammersmith and Fulham 008,Hammersmith and Fulham,E09000013,4788 ,2451 ,2337 
E02000380,2006,Hammersmith and Fulham 009,Hammersmith and Fulham,E09000013,4511 ,2209 ,2302 
E02000381,2006,Hammersmith and Fulham 010,Hammersmith and Fulham,E09000013,5824 ,2823 ,3001 
E02000382,2006,Hammersmith and Fulham 011,Hammersmith and Fulham,E09000013,4426 ,2243 ,2183 
E02000383,2006,Hammersmith and Fulham 012,Hammersmith and Fulham,E09000013,7306 ,3744 ,3562 
E02000384,2006,Hammersmith and Fulham 013,Hammersmith and Fulham,E09000013,5779 ,2934 ,2845 
E02000385,2006,Hammersmith and Fulham 014,Hammersmith and Fulham,E09000013,5363 ,2782 ,2581 
E02000386,2006,Hammersmith and Fulham 015,Hammersmith and Fulham,E09000013,6084 ,3041 ,3043 
E02000387,2006,Hammersmith and Fulham 016,Hammersmith and Fulham,E09000013,4618 ,2233 ,2385 
E02000388,2006,Hammersmith and Fulham 017,Hammersmith and Fulham,E09000013,6143 ,3049 ,3094 
E02000389,2006,Hammersmith and Fulham 018,Hammersmith and Fulham,E09000013,5884 ,2781 ,3103 
E02000390,2006,Hammersmith and Fulham 019,Hammersmith and Fulham,E09000013,4929 ,2478 ,2451 
E02000391,2006,Hammersmith and Fulham 020,Hammersmith and Fulham,E09000013,5463 ,2617 ,2846 
E02000392,2006,Hammersmith and Fulham 021,Hammersmith and Fulham,E09000013,7173 ,3545 ,3628 
E02000393,2006,Hammersmith and Fulham 022,Hammersmith and Fulham,E09000013,4528 ,2174 ,2354 
E02000394,2006,Hammersmith and Fulham 023,Hammersmith and Fulham,E09000013,4331 ,1997 ,2334 
E02000395,2006,Hammersmith and Fulham 024,Hammersmith and Fulham,E09000013,4516 ,2231 ,2285 
E02000396,2006,Hammersmith and Fulham 025,Hammersmith and Fulham,E09000013,4289 ,1961 ,2328 
E02000397,2006,Haringey 001,Haringey,E09000014,4969 ,2485 ,2484 
E02000398,2006,Haringey 002,Haringey,E09000014,4522 ,2191 ,2331 
E02000400,2006,Haringey 004,Haringey,E09000014,4522 ,2138 ,2384 
E02000401,2006,Haringey 005,Haringey,E09000014,4110 ,1933 ,2177 
E02000402,2006,Haringey 006,Haringey,E09000014,4145 ,1931 ,2214 
E02000403,2006,Haringey 007,Haringey,E09000014,4938 ,2518 ,2420 
E02000404,2006,Haringey 008,Haringey,E09000014,4463 ,2170 ,2293 
E02000405,2006,Haringey 009,Haringey,E09000014,4264 ,2057 ,2207 
E02000406,2006,Haringey 010,Haringey,E09000014,4528 ,2166 ,2362 
E02000407,2006,Haringey 011,Haringey,E09000014,4457 ,2261 ,2196 
E02000408,2006,Haringey 012,Haringey,E09000014,4494 ,2198 ,2296 
E02000409,2006,Haringey 013,Haringey,E09000014,4283 ,2130 ,2153 
E02000410,2006,Haringey 014,Haringey,E09000014,4606 ,2220 ,2386 
E02000411,2006,Haringey 015,Haringey,E09000014,4726 ,2395 ,2331 
E02000412,2006,Haringey 016,Haringey,E09000014,4523 ,2350 ,2173 
E02000413,2006,Haringey 017,Haringey,E09000014,4516 ,2147 ,2369 
E02000414,2006,Haringey 018,Haringey,E09000014,4617 ,2309 ,2308 
E02000415,2006,Haringey 019,Haringey,E09000014,4458 ,2317 ,2141 
E02000416,2006,Haringey 020,Haringey,E09000014,4497 ,2195 ,2302 
E02000417,2006,Haringey 021,Haringey,E09000014,4583 ,2280 ,2303 
E02000418,2006,Haringey 022,Haringey,E09000014,3565 ,1638 ,1927 
E02000419,2006,Haringey 023,Haringey,E09000014,5800 ,3128 ,2672 
E02000420,2006,Haringey 024,Haringey,E09000014,4656 ,2285 ,2371 
E02000421,2006,Haringey 025,Haringey,E09000014,4604 ,2246 ,2358 
E02000422,2006,Haringey 026,Haringey,E09000014,4906 ,2495 ,2411 
E02000423,2006,Haringey 027,Haringey,E09000014,4986 ,2763 ,2223 
E02000424,2006,Haringey 028,Haringey,E09000014,5050 ,2502 ,2548 
E02000425,2006,Haringey 029,Haringey,E09000014,3713 ,1854 ,1859 
E02000426,2006,Haringey 030,Haringey,E09000014,4296 ,2028 ,2268 
E02000427,2006,Haringey 031,Haringey,E09000014,5215 ,2778 ,2437 
E02000428,2006,Haringey 032,Haringey,E09000014,4482 ,2273 ,2209 
E02000429,2006,Haringey 033,Haringey,E09000014,4693 ,2267 ,2426 
E02000430,2006,Haringey 034,Haringey,E09000014,5235 ,2624 ,2611 
E02000431,2006,Haringey 035,Haringey,E09000014,4772 ,2288 ,2484 
E02000432,2006,Haringey 036,Haringey,E09000014,4648 ,2283 ,2365 
E02006794,2006,Haringey 037,Haringey,E09000014,4375 ,2226 ,2149 
E02000433,2006,Harrow 001,Harrow,E09000015,4067 ,1906 ,2161 
E02000434,2006,Harrow 002,Harrow,E09000015,5005 ,2414 ,2591 
E02000435,2006,Harrow 003,Harrow,E09000015,4592 ,2171 ,2421 
E02000436,2006,Harrow 004,Harrow,E09000015,3661 ,1734 ,1927 
E02000437,2006,Harrow 005,Harrow,E09000015,5196 ,2505 ,2691 
E02000438,2006,Harrow 006,Harrow,E09000015,4653 ,2200 ,2453 
E02000439,2006,Harrow 007,Harrow,E09000015,5214 ,2618 ,2596 
E02000440,2006,Harrow 008,Harrow,E09000015,5831 ,2831 ,3000 
E02000441,2006,Harrow 009,Harrow,E09000015,4361 ,2080 ,2281 
E02000442,2006,Harrow 010,Harrow,E09000015,5533 ,2843 ,2690 
E02000443,2006,Harrow 011,Harrow,E09000015,5960 ,3030 ,2930 
E02000444,2006,Harrow 012,Harrow,E09000015,5127 ,2494 ,2633 
E02000445,2006,Harrow 013,Harrow,E09000015,6147 ,3104 ,3043 
E02000447,2006,Harrow 015,Harrow,E09000015,4549 ,2236 ,2313 
E02000448,2006,Harrow 016,Harrow,E09000015,4095 ,2020 ,2075 
E02000449,2006,Harrow 017,Harrow,E09000015,5274 ,2633 ,2641 
E02000451,2006,Harrow 019,Harrow,E09000015,4182 ,2090 ,2092 
E02000452,2006,Harrow 020,Harrow,E09000015,5239 ,2696 ,2543 
E02000453,2006,Harrow 021,Harrow,E09000015,4720 ,2361 ,2359 
E02000454,2006,Harrow 022,Harrow,E09000015,4416 ,2172 ,2244 
E02000455,2006,Harrow 023,Harrow,E09000015,5240 ,2648 ,2592 
E02000456,2006,Harrow 024,Harrow,E09000015,4650 ,2295 ,2355 
E02000457,2006,Harrow 025,Harrow,E09000015,4014 ,2045 ,1969 
E02000459,2006,Harrow 027,Harrow,E09000015,4910 ,2510 ,2400 
E02000460,2006,Harrow 028,Harrow,E09000015,4332 ,2181 ,2151 
E02000461,2006,Harrow 029,Harrow,E09000015,4601 ,2558 ,2043 
E02000462,2006,Harrow 030,Harrow,E09000015,4236 ,2169 ,2067 
E02000463,2006,Harrow 031,Harrow,E09000015,5586 ,2736 ,2850 
E02006795,2006,Harrow 032,Harrow,E09000015,5182 ,2590 ,2592 
E02006882,2006,Harrow 033,Harrow,E09000015,9306 ,4621 ,4685 
E02000464,2006,Havering 001,Havering,E09000016,3740 ,1834 ,1906 
E02000465,2006,Havering 002,Havering,E09000016,4878 ,2366 ,2512 
E02000466,2006,Havering 003,Havering,E09000016,4880 ,2316 ,2564 
E02000467,2006,Havering 004,Havering,E09000016,5725 ,2731 ,2994 
E02000468,2006,Havering 005,Havering,E09000016,4773 ,2289 ,2484 
E02000469,2006,Havering 006,Havering,E09000016,3859 ,1848 ,2011 
E02000470,2006,Havering 007,Havering,E09000016,5155 ,2543 ,2612 
E02000471,2006,Havering 008,Havering,E09000016,4686 ,2288 ,2398 
E02000472,2006,Havering 009,Havering,E09000016,5667 ,2811 ,2856 
E02000473,2006,Havering 010,Havering,E09000016,5858 ,2845 ,3013 
E02000474,2006,Havering 011,Havering,E09000016,4952 ,2442 ,2510 
E02000475,2006,Havering 012,Havering,E09000016,5724 ,2814 ,2910 
E02000476,2006,Havering 013,Havering,E09000016,4441 ,2224 ,2217 
E02000477,2006,Havering 014,Havering,E09000016,6000 ,2955 ,3045 
E02000478,2006,Havering 015,Havering,E09000016,3542 ,1763 ,1779 
E02000479,2006,Havering 016,Havering,E09000016,5406 ,2669 ,2737 
E02000480,2006,Havering 017,Havering,E09000016,5974 ,2995 ,2979 
E02000481,2006,Havering 018,Havering,E09000016,4504 ,2204 ,2300 
E02000482,2006,Havering 019,Havering,E09000016,3815 ,1905 ,1910 
E02000483,2006,Havering 020,Havering,E09000016,4630 ,2276 ,2354 
E02000484,2006,Havering 021,Havering,E09000016,5444 ,2714 ,2730 
E02000485,2006,Havering 022,Havering,E09000016,4818 ,2385 ,2433 
E02000486,2006,Havering 023,Havering,E09000016,4812 ,2392 ,2420 
E02000487,2006,Havering 024,Havering,E09000016,4909 ,2447 ,2462 
E02000488,2006,Havering 025,Havering,E09000016,4950 ,2473 ,2477 
E02000489,2006,Havering 026,Havering,E09000016,4851 ,2359 ,2492 
E02000490,2006,Havering 027,Havering,E09000016,4628 ,2229 ,2399 
E02000491,2006,Havering 028,Havering,E09000016,5512 ,2758 ,2754 
E02000492,2006,Havering 029,Havering,E09000016,3924 ,1932 ,1992 
E02000493,2006,Havering 030,Havering,E09000016,4041 ,1945 ,2096 
E02000494,2006,Hillingdon 001,Hillingdon,E09000017,4880 ,2332 ,2548 
E02000495,2006,Hillingdon 002,Hillingdon,E09000017,6056 ,2887 ,3169 
E02000496,2006,Hillingdon 003,Hillingdon,E09000017,4678 ,2289 ,2389 
E02000497,2006,Hillingdon 004,Hillingdon,E09000017,4995 ,2378 ,2617 
E02000498,2006,Hillingdon 005,Hillingdon,E09000017,3785 ,1804 ,1981 
E02000499,2006,Hillingdon 006,Hillingdon,E09000017,4715 ,2300 ,2415 
E02000500,2006,Hillingdon 007,Hillingdon,E09000017,4654 ,2352 ,2302 
E02000501,2006,Hillingdon 008,Hillingdon,E09000017,5204 ,2517 ,2687 
E02000502,2006,Hillingdon 009,Hillingdon,E09000017,4678 ,2322 ,2356 
E02000503,2006,Hillingdon 010,Hillingdon,E09000017,5652 ,2822 ,2830 
E02000504,2006,Hillingdon 011,Hillingdon,E09000017,4379 ,2180 ,2199 
E02000506,2006,Hillingdon 013,Hillingdon,E09000017,4694 ,2308 ,2386 
E02000507,2006,Hillingdon 014,Hillingdon,E09000017,5072 ,2556 ,2516 
E02000508,2006,Hillingdon 015,Hillingdon,E09000017,5648 ,2966 ,2682 
E02000509,2006,Hillingdon 016,Hillingdon,E09000017,6922 ,3598 ,3324 
E02000510,2006,Hillingdon 017,Hillingdon,E09000017,5464 ,2687 ,2777 
E02000511,2006,Hillingdon 018,Hillingdon,E09000017,5855 ,2860 ,2995 
E02000512,2006,Hillingdon 019,Hillingdon,E09000017,5026 ,2452 ,2574 
E02000513,2006,Hillingdon 020,Hillingdon,E09000017,5374 ,2552 ,2822 
E02000514,2006,Hillingdon 021,Hillingdon,E09000017,6252 ,3087 ,3165 
E02000515,2006,Hillingdon 022,Hillingdon,E09000017,6250 ,3135 ,3115 
E02000516,2006,Hillingdon 023,Hillingdon,E09000017,5320 ,2632 ,2688 
E02000517,2006,Hillingdon 024,Hillingdon,E09000017,4922 ,2384 ,2538 
E02000518,2006,Hillingdon 025,Hillingdon,E09000017,5338 ,2659 ,2679 
E02000519,2006,Hillingdon 026,Hillingdon,E09000017,5244 ,2608 ,2636 
E02000520,2006,Hillingdon 027,Hillingdon,E09000017,6712 ,3443 ,3269 
E02000521,2006,Hillingdon 028,Hillingdon,E09000017,5320 ,2643 ,2677 
E02000522,2006,Hillingdon 029,Hillingdon,E09000017,5096 ,2534 ,2562 
E02000523,2006,Hillingdon 030,Hillingdon,E09000017,5849 ,3045 ,2804 
E02000524,2006,Hillingdon 031,Hillingdon,E09000017,4458 ,2438 ,2020 
E02000525,2006,Hillingdon 032,Hillingdon,E09000017,5441 ,2756 ,2685 
E02006796,2006,Hillingdon 033,Hillingdon,E09000017,5417 ,2680 ,2737 
E02000526,2006,Hounslow 001,Hounslow,E09000018,6108 ,3005 ,3103 
E02000528,2006,Hounslow 003,Hounslow,E09000018,6462 ,3130 ,3332 
E02000529,2006,Hounslow 004,Hounslow,E09000018,5442 ,2737 ,2705 
E02000530,2006,Hounslow 005,Hounslow,E09000018,4114 ,1997 ,2117 
E02000531,2006,Hounslow 006,Hounslow,E09000018,6223 ,3023 ,3200 
E02000532,2006,Hounslow 007,Hounslow,E09000018,6517 ,3267 ,3250 
E02000533,2006,Hounslow 008,Hounslow,E09000018,6045 ,3134 ,2911 
E02000534,2006,Hounslow 009,Hounslow,E09000018,4648 ,2401 ,2247 
E02000535,2006,Hounslow 010,Hounslow,E09000018,6014 ,3063 ,2951 
E02000536,2006,Hounslow 011,Hounslow,E09000018,6055 ,3042 ,3013 
E02000537,2006,Hounslow 012,Hounslow,E09000018,5924 ,3066 ,2858 
E02000538,2006,Hounslow 013,Hounslow,E09000018,5414 ,2851 ,2563 
E02000539,2006,Hounslow 014,Hounslow,E09000018,6394 ,3087 ,3307 
E02000540,2006,Hounslow 015,Hounslow,E09000018,6059 ,3153 ,2906 
E02000541,2006,Hounslow 016,Hounslow,E09000018,5524 ,2819 ,2705 
E02000542,2006,Hounslow 017,Hounslow,E09000018,5722 ,2981 ,2741 
E02000543,2006,Hounslow 018,Hounslow,E09000018,6566 ,3366 ,3200 
E02000544,2006,Hounslow 019,Hounslow,E09000018,5406 ,2695 ,2711 
E02000545,2006,Hounslow 020,Hounslow,E09000018,5563 ,2697 ,2866 
E02000546,2006,Hounslow 021,Hounslow,E09000018,6055 ,3142 ,2913 
E02000547,2006,Hounslow 022,Hounslow,E09000018,5545 ,2730 ,2815 
E02000548,2006,Hounslow 023,Hounslow,E09000018,5093 ,2544 ,2549 
E02000549,2006,Hounslow 024,Hounslow,E09000018,6496 ,3302 ,3194 
E02000550,2006,Hounslow 025,Hounslow,E09000018,5276 ,2538 ,2738 
E02000551,2006,Hounslow 026,Hounslow,E09000018,5144 ,2472 ,2672 
E02000552,2006,Hounslow 027,Hounslow,E09000018,5059 ,2639 ,2420 
E02000553,2006,Hounslow 028,Hounslow,E09000018,4216 ,2042 ,2174 
E02006792,2006,Hounslow 029,Hounslow,E09000018,6238 ,3207 ,3031 
E02000554,2006,Islington 001,Islington,E09000019,6630 ,3122 ,3508 
E02000555,2006,Islington 002,Islington,E09000019,6048 ,2707 ,3341 
E02000556,2006,Islington 003,Islington,E09000019,7270 ,3521 ,3749 
E02000557,2006,Islington 004,Islington,E09000019,5561 ,2550 ,3011 
E02000558,2006,Islington 005,Islington,E09000019,5710 ,2761 ,2949 
E02000559,2006,Islington 006,Islington,E09000019,5704 ,2851 ,2853 
E02000560,2006,Islington 007,Islington,E09000019,5421 ,2678 ,2743 
E02000561,2006,Islington 008,Islington,E09000019,4965 ,2408 ,2557 
E02000562,2006,Islington 009,Islington,E09000019,5315 ,2476 ,2839 
E02000563,2006,Islington 010,Islington,E09000019,6009 ,2759 ,3250 
E02000564,2006,Islington 011,Islington,E09000019,5968 ,2981 ,2987 
E02000565,2006,Islington 012,Islington,E09000019,5436 ,2590 ,2846 
E02000566,2006,Islington 013,Islington,E09000019,5610 ,2733 ,2877 
E02000567,2006,Islington 014,Islington,E09000019,7350 ,3587 ,3763 
E02000568,2006,Islington 015,Islington,E09000019,5749 ,3050 ,2699 
E02000569,2006,Islington 016,Islington,E09000019,6966 ,3366 ,3600 
E02000570,2006,Islington 017,Islington,E09000019,5998 ,2933 ,3065 
E02000571,2006,Islington 018,Islington,E09000019,5351 ,2564 ,2787 
E02000572,2006,Islington 019,Islington,E09000019,4822 ,2263 ,2559 
E02000573,2006,Islington 020,Islington,E09000019,6284 ,3207 ,3077 
E02000574,2006,Islington 021,Islington,E09000019,6136 ,3022 ,3114 
E02000575,2006,Islington 022,Islington,E09000019,7997 ,4151 ,3846 
E02000576,2006,Islington 023,Islington,E09000019,5546 ,2751 ,2795 
E02000577,2006,Kensington and Chelsea 001,Kensington and Chelsea,E09000020,5195 ,2534 ,2661 
E02000578,2006,Kensington and Chelsea 002,Kensington and Chelsea,E09000020,4041 ,1883 ,2158 
E02000579,2006,Kensington and Chelsea 003,Kensington and Chelsea,E09000020,5713 ,2627 ,3086 
E02000580,2006,Kensington and Chelsea 004,Kensington and Chelsea,E09000020,6563 ,3247 ,3316 
E02000581,2006,Kensington and Chelsea 005,Kensington and Chelsea,E09000020,5076 ,2431 ,2645 
E02000582,2006,Kensington and Chelsea 006,Kensington and Chelsea,E09000020,6581 ,3298 ,3283 
E02000583,2006,Kensington and Chelsea 007,Kensington and Chelsea,E09000020,5513 ,2664 ,2849 
E02000584,2006,Kensington and Chelsea 008,Kensington and Chelsea,E09000020,6408 ,3061 ,3347 
E02000585,2006,Kensington and Chelsea 009,Kensington and Chelsea,E09000020,6648 ,3291 ,3357 
E02000586,2006,Kensington and Chelsea 010,Kensington and Chelsea,E09000020,6608 ,3281 ,3327 
E02000587,2006,Kensington and Chelsea 011,Kensington and Chelsea,E09000020,5615 ,2792 ,2823 
E02000588,2006,Kensington and Chelsea 012,Kensington and Chelsea,E09000020,6315 ,3102 ,3213 
E02000589,2006,Kensington and Chelsea 013,Kensington and Chelsea,E09000020,7269 ,3950 ,3319 
E02000590,2006,Kensington and Chelsea 014,Kensington and Chelsea,E09000020,5636 ,2575 ,3061 
E02000591,2006,Kensington and Chelsea 015,Kensington and Chelsea,E09000020,5442 ,2886 ,2556 
E02000592,2006,Kensington and Chelsea 016,Kensington and Chelsea,E09000020,5703 ,2887 ,2816 
E02000593,2006,Kensington and Chelsea 017,Kensington and Chelsea,E09000020,5869 ,3041 ,2828 
E02000594,2006,Kensington and Chelsea 018,Kensington and Chelsea,E09000020,5129 ,2413 ,2716 
E02000595,2006,Kensington and Chelsea 019,Kensington and Chelsea,E09000020,5383 ,2549 ,2834 
E02000596,2006,Kensington and Chelsea 020,Kensington and Chelsea,E09000020,5962 ,2997 ,2965 
E02000597,2006,Kensington and Chelsea 021,Kensington and Chelsea,E09000020,5503 ,2620 ,2883 
E02000598,2006,Kingston upon Thames 001,Kingston upon Thames,E09000021,4725 ,2282 ,2443 
E02000599,2006,Kingston upon Thames 002,Kingston upon Thames,E09000021,4992 ,2411 ,2581 
E02000600,2006,Kingston upon Thames 003,Kingston upon Thames,E09000021,5919 ,2995 ,2924 
E02000601,2006,Kingston upon Thames 004,Kingston upon Thames,E09000021,6420 ,3125 ,3295 
E02000602,2006,Kingston upon Thames 005,Kingston upon Thames,E09000021,6119 ,3121 ,2998 
E02000603,2006,Kingston upon Thames 006,Kingston upon Thames,E09000021,5301 ,2611 ,2690 
E02000604,2006,Kingston upon Thames 007,Kingston upon Thames,E09000021,5888 ,2980 ,2908 
E02000605,2006,Kingston upon Thames 008,Kingston upon Thames,E09000021,5259 ,2625 ,2634 
E02000606,2006,Kingston upon Thames 009,Kingston upon Thames,E09000021,7091 ,3787 ,3304 
E02000607,2006,Kingston upon Thames 010,Kingston upon Thames,E09000021,4860 ,2480 ,2380 
E02000608,2006,Kingston upon Thames 011,Kingston upon Thames,E09000021,5378 ,2792 ,2586 
E02000609,2006,Kingston upon Thames 012,Kingston upon Thames,E09000021,4651 ,2360 ,2291 
E02000610,2006,Kingston upon Thames 013,Kingston upon Thames,E09000021,5615 ,2891 ,2724 
E02000611,2006,Kingston upon Thames 014,Kingston upon Thames,E09000021,4865 ,2445 ,2420 
E02000612,2006,Kingston upon Thames 015,Kingston upon Thames,E09000021,5200 ,2544 ,2656 
E02000613,2006,Kingston upon Thames 016,Kingston upon Thames,E09000021,5199 ,2516 ,2683 
E02000614,2006,Kingston upon Thames 017,Kingston upon Thames,E09000021,5699 ,2829 ,2870 
E02000615,2006,Kingston upon Thames 018,Kingston upon Thames,E09000021,4910 ,2470 ,2440 
E02000616,2006,Kingston upon Thames 019,Kingston upon Thames,E09000021,4053 ,1988 ,2065 
E02000617,2006,Kingston upon Thames 020,Kingston upon Thames,E09000021,5459 ,2613 ,2846 
E02000619,2006,Lambeth 002,Lambeth,E09000022,5293 ,2666 ,2627 
E02000620,2006,Lambeth 003,Lambeth,E09000022,5937 ,3085 ,2852 
E02000621,2006,Lambeth 004,Lambeth,E09000022,6827 ,3714 ,3113 
E02000622,2006,Lambeth 005,Lambeth,E09000022,5760 ,3086 ,2674 
E02000623,2006,Lambeth 006,Lambeth,E09000022,5523 ,2803 ,2720 
E02000624,2006,Lambeth 007,Lambeth,E09000022,5518 ,2806 ,2712 
E02000625,2006,Lambeth 008,Lambeth,E09000022,5959 ,3013 ,2946 
E02000626,2006,Lambeth 009,Lambeth,E09000022,5799 ,2909 ,2890 
E02000627,2006,Lambeth 010,Lambeth,E09000022,6781 ,3503 ,3278 
E02000628,2006,Lambeth 011,Lambeth,E09000022,6721 ,3419 ,3302 
E02000629,2006,Lambeth 012,Lambeth,E09000022,6570 ,3424 ,3146 
E02000630,2006,Lambeth 013,Lambeth,E09000022,5214 ,2667 ,2547 
E02000631,2006,Lambeth 014,Lambeth,E09000022,6317 ,3165 ,3152 
E02000632,2006,Lambeth 015,Lambeth,E09000022,7465 ,3907 ,3558 
E02000633,2006,Lambeth 016,Lambeth,E09000022,6011 ,3090 ,2921 
E02000634,2006,Lambeth 017,Lambeth,E09000022,4936 ,2519 ,2417 
E02000635,2006,Lambeth 018,Lambeth,E09000022,6345 ,3310 ,3035 
E02000636,2006,Lambeth 019,Lambeth,E09000022,5404 ,2800 ,2604 
E02000637,2006,Lambeth 020,Lambeth,E09000022,6257 ,3308 ,2949 
E02000638,2006,Lambeth 021,Lambeth,E09000022,6441 ,3281 ,3160 
E02000639,2006,Lambeth 022,Lambeth,E09000022,5854 ,2832 ,3022 
E02000640,2006,Lambeth 023,Lambeth,E09000022,6536 ,3304 ,3232 
E02000641,2006,Lambeth 024,Lambeth,E09000022,5722 ,2731 ,2991 
E02000642,2006,Lambeth 025,Lambeth,E09000022,6423 ,3146 ,3277 
E02000643,2006,Lambeth 026,Lambeth,E09000022,5635 ,2900 ,2735 
E02000644,2006,Lambeth 027,Lambeth,E09000022,5621 ,2867 ,2754 
E02000645,2006,Lambeth 028,Lambeth,E09000022,5754 ,2867 ,2887 
E02000646,2006,Lambeth 029,Lambeth,E09000022,5912 ,3045 ,2867 
E02000647,2006,Lambeth 030,Lambeth,E09000022,5285 ,2630 ,2655 
E02000648,2006,Lambeth 031,Lambeth,E09000022,4513 ,2140 ,2373 
E02000649,2006,Lambeth 032,Lambeth,E09000022,7153 ,3672 ,3481 
E02000650,2006,Lambeth 033,Lambeth,E09000022,5214 ,2503 ,2711 
E02000651,2006,Lambeth 034,Lambeth,E09000022,5568 ,2864 ,2704 
E02000652,2006,Lambeth 035,Lambeth,E09000022,4325 ,2107 ,2218 
E02006801,2006,Lambeth 036,Lambeth,E09000022,5956 ,3090 ,2866 
E02000653,2006,Lewisham 001,Lewisham,E09000023,5019 ,2532 ,2487 
E02000654,2006,Lewisham 002,Lewisham,E09000023,4940 ,2404 ,2536 
E02000655,2006,Lewisham 003,Lewisham,E09000023,5579 ,2806 ,2773 
E02000657,2006,Lewisham 005,Lewisham,E09000023,6473 ,3217 ,3256 
E02000658,2006,Lewisham 006,Lewisham,E09000023,5743 ,2921 ,2822 
E02000659,2006,Lewisham 007,Lewisham,E09000023,5344 ,2636 ,2708 
E02000660,2006,Lewisham 008,Lewisham,E09000023,5611 ,2894 ,2717 
E02000661,2006,Lewisham 009,Lewisham,E09000023,4296 ,2205 ,2091 
E02000662,2006,Lewisham 010,Lewisham,E09000023,5583 ,2792 ,2791 
E02000663,2006,Lewisham 011,Lewisham,E09000023,5174 ,2732 ,2442 
E02000664,2006,Lewisham 012,Lewisham,E09000023,6210 ,3233 ,2977 
E02000665,2006,Lewisham 013,Lewisham,E09000023,5067 ,2532 ,2535 
E02000666,2006,Lewisham 014,Lewisham,E09000023,5175 ,2592 ,2583 
E02000667,2006,Lewisham 015,Lewisham,E09000023,4529 ,2236 ,2293 
E02000668,2006,Lewisham 016,Lewisham,E09000023,4268 ,2139 ,2129 
E02000669,2006,Lewisham 017,Lewisham,E09000023,5017 ,2559 ,2458 
E02000670,2006,Lewisham 018,Lewisham,E09000023,4075 ,1992 ,2083 
E02000671,2006,Lewisham 019,Lewisham,E09000023,5720 ,2830 ,2890 
E02000672,2006,Lewisham 020,Lewisham,E09000023,5079 ,2584 ,2495 
E02000673,2006,Lewisham 021,Lewisham,E09000023,5228 ,2644 ,2584 
E02000674,2006,Lewisham 022,Lewisham,E09000023,5295 ,2544 ,2751 
E02000675,2006,Lewisham 023,Lewisham,E09000023,5377 ,2641 ,2736 
E02000676,2006,Lewisham 024,Lewisham,E09000023,5126 ,2522 ,2604 
E02000677,2006,Lewisham 025,Lewisham,E09000023,4661 ,2347 ,2314 
E02000678,2006,Lewisham 026,Lewisham,E09000023,3668 ,1733 ,1935 
E02000679,2006,Lewisham 027,Lewisham,E09000023,5242 ,2576 ,2666 
E02000680,2006,Lewisham 028,Lewisham,E09000023,4342 ,2174 ,2168 
E02000681,2006,Lewisham 029,Lewisham,E09000023,4998 ,2338 ,2660 
E02000682,2006,Lewisham 030,Lewisham,E09000023,4916 ,2362 ,2554 
E02000683,2006,Lewisham 031,Lewisham,E09000023,4030 ,1917 ,2113 
E02000685,2006,Lewisham 033,Lewisham,E09000023,4990 ,2389 ,2601 
E02000686,2006,Lewisham 034,Lewisham,E09000023,4436 ,1989 ,2447 
E02000687,2006,Lewisham 035,Lewisham,E09000023,5412 ,2664 ,2748 
E02006783,2006,Lewisham 037,Lewisham,E09000023,4334 ,1981 ,2353 
E02006784,2006,Lewisham 038,Lewisham,E09000023,4498 ,2213 ,2285 
E02006798,2006,Lewisham 039,Lewisham,E09000023,5331 ,2679 ,2652 
E02000689,2006,Merton 001,Merton,E09000024,5270 ,2641 ,2629 
E02000690,2006,Merton 002,Merton,E09000024,3653 ,1858 ,1795 
E02000691,2006,Merton 003,Merton,E09000024,5498 ,2742 ,2756 
E02000692,2006,Merton 004,Merton,E09000024,5696 ,3008 ,2688 
E02000693,2006,Merton 005,Merton,E09000024,6646 ,3422 ,3224 
E02000694,2006,Merton 006,Merton,E09000024,6564 ,3269 ,3295 
E02000695,2006,Merton 007,Merton,E09000024,5820 ,3069 ,2751 
E02000696,2006,Merton 008,Merton,E09000024,5823 ,2938 ,2885 
E02000697,2006,Merton 009,Merton,E09000024,6502 ,3280 ,3222 
E02000698,2006,Merton 010,Merton,E09000024,5156 ,2564 ,2592 
E02000699,2006,Merton 011,Merton,E09000024,5731 ,2831 ,2900 
E02000700,2006,Merton 012,Merton,E09000024,5805 ,2811 ,2994 
E02000701,2006,Merton 013,Merton,E09000024,5196 ,2629 ,2567 
E02000702,2006,Merton 014,Merton,E09000024,4909 ,2373 ,2536 
E02000703,2006,Merton 015,Merton,E09000024,5276 ,2628 ,2648 
E02000704,2006,Merton 016,Merton,E09000024,5523 ,2765 ,2758 
E02000705,2006,Merton 017,Merton,E09000024,5093 ,2467 ,2626 
E02000706,2006,Merton 018,Merton,E09000024,5067 ,2399 ,2668 
E02000707,2006,Merton 019,Merton,E09000024,4644 ,2206 ,2438 
E02000708,2006,Merton 020,Merton,E09000024,5468 ,2713 ,2755 
E02000709,2006,Merton 021,Merton,E09000024,4909 ,2425 ,2484 
E02000710,2006,Merton 022,Merton,E09000024,4974 ,2418 ,2556 
E02000711,2006,Merton 023,Merton,E09000024,5280 ,2679 ,2601 
E02000712,2006,Merton 024,Merton,E09000024,4915 ,2384 ,2531 
E02000713,2006,Merton 025,Merton,E09000024,4649 ,2313 ,2336 
E02000714,2006,Newham 001,Newham,E09000025,4562 ,2289 ,2273 
E02000715,2006,Newham 002,Newham,E09000025,3991 ,2033 ,1958 
E02000716,2006,Newham 003,Newham,E09000025,4167 ,2192 ,1975 
E02000717,2006,Newham 004,Newham,E09000025,4526 ,2373 ,2153 
E02000718,2006,Newham 005,Newham,E09000025,3648 ,1763 ,1885 
E02000719,2006,Newham 006,Newham,E09000025,4778 ,2421 ,2357 
E02000720,2006,Newham 007,Newham,E09000025,4495 ,2435 ,2060 
E02000721,2006,Newham 008,Newham,E09000025,5578 ,3007 ,2571 
E02000722,2006,Newham 009,Newham,E09000025,4792 ,2446 ,2346 
E02000723,2006,Newham 010,Newham,E09000025,6062 ,3343 ,2719 
E02000724,2006,Newham 011,Newham,E09000025,5539 ,3080 ,2459 
E02000725,2006,Newham 012,Newham,E09000025,4955 ,2580 ,2375 
E02000726,2006,Newham 013,Newham,E09000025,5183 ,2728 ,2455 
E02000727,2006,Newham 014,Newham,E09000025,4854 ,2740 ,2114 
E02000728,2006,Newham 015,Newham,E09000025,5440 ,3079 ,2361 
E02000729,2006,Newham 016,Newham,E09000025,4135 ,2176 ,1959 
E02000730,2006,Newham 017,Newham,E09000025,5216 ,2843 ,2373 
E02000731,2006,Newham 018,Newham,E09000025,5670 ,3248 ,2422 
E02000732,2006,Newham 019,Newham,E09000025,4120 ,2185 ,1935 
E02000733,2006,Newham 020,Newham,E09000025,5612 ,2764 ,2848 
E02000734,2006,Newham 021,Newham,E09000025,3891 ,1965 ,1926 
E02000735,2006,Newham 022,Newham,E09000025,4217 ,2249 ,1968 
E02000736,2006,Newham 023,Newham,E09000025,4822 ,2454 ,2368 
E02000737,2006,Newham 024,Newham,E09000025,5043 ,2575 ,2468 
E02000738,2006,Newham 025,Newham,E09000025,4685 ,2403 ,2282 
E02000739,2006,Newham 026,Newham,E09000025,4036 ,2041 ,1995 
E02000740,2006,Newham 027,Newham,E09000025,4060 ,1961 ,2099 
E02000741,2006,Newham 028,Newham,E09000025,4611 ,2286 ,2325 
E02000742,2006,Newham 029,Newham,E09000025,4234 ,2129 ,2105 
E02000743,2006,Newham 030,Newham,E09000025,4309 ,2143 ,2166 
E02000744,2006,Newham 031,Newham,E09000025,4357 ,2179 ,2178 
E02000745,2006,Newham 032,Newham,E09000025,5169 ,2564 ,2605 
E02000746,2006,Newham 033,Newham,E09000025,4107 ,1898 ,2209 
E02000747,2006,Newham 034,Newham,E09000025,5786 ,2901 ,2885 
E02000748,2006,Newham 035,Newham,E09000025,4001 ,1972 ,2029 
E02000749,2006,Newham 036,Newham,E09000025,4647 ,2216 ,2431 
E02000750,2006,Newham 037,Newham,E09000025,5940 ,3064 ,2876 
E02000751,2006,Redbridge 001,Redbridge,E09000026,6471 ,3164 ,3307 
E02000752,2006,Redbridge 002,Redbridge,E09000026,3822 ,1856 ,1966 
E02000753,2006,Redbridge 003,Redbridge,E09000026,3634 ,1729 ,1905 
E02000754,2006,Redbridge 004,Redbridge,E09000026,4070 ,1954 ,2116 
E02000755,2006,Redbridge 005,Redbridge,E09000026,3444 ,1663 ,1781 
E02000756,2006,Redbridge 006,Redbridge,E09000026,7864 ,3818 ,4046 
E02000757,2006,Redbridge 007,Redbridge,E09000026,7032 ,3517 ,3515 
E02000758,2006,Redbridge 008,Redbridge,E09000026,3655 ,1788 ,1867 
E02000759,2006,Redbridge 009,Redbridge,E09000026,7772 ,3799 ,3973 
E02000760,2006,Redbridge 010,Redbridge,E09000026,3900 ,1865 ,2035 
E02000762,2006,Redbridge 012,Redbridge,E09000026,3909 ,1962 ,1947 
E02000763,2006,Redbridge 013,Redbridge,E09000026,4234 ,2064 ,2170 
E02000764,2006,Redbridge 014,Redbridge,E09000026,7569 ,3713 ,3856 
E02000765,2006,Redbridge 015,Redbridge,E09000026,3764 ,1865 ,1899 
E02000767,2006,Redbridge 017,Redbridge,E09000026,4450 ,2147 ,2303 
E02000768,2006,Redbridge 018,Redbridge,E09000026,3828 ,1868 ,1960 
E02000769,2006,Redbridge 019,Redbridge,E09000026,8302 ,3940 ,4362 
E02000770,2006,Redbridge 020,Redbridge,E09000026,4575 ,2328 ,2247 
E02000772,2006,Redbridge 022,Redbridge,E09000026,4529 ,2312 ,2217 
E02000773,2006,Redbridge 023,Redbridge,E09000026,5208 ,2584 ,2624 
E02000774,2006,Redbridge 024,Redbridge,E09000026,4503 ,2361 ,2142 
E02000776,2006,Redbridge 026,Redbridge,E09000026,3935 ,1991 ,1944 
E02000777,2006,Redbridge 027,Redbridge,E09000026,3971 ,2010 ,1961 
E02000779,2006,Redbridge 029,Redbridge,E09000026,4810 ,2550 ,2260 
E02000780,2006,Redbridge 030,Redbridge,E09000026,7868 ,4068 ,3800 
E02000781,2006,Redbridge 031,Redbridge,E09000026,7909 ,4021 ,3888 
E02000782,2006,Redbridge 032,Redbridge,E09000026,5390 ,2809 ,2581 
E02000783,2006,Redbridge 033,Redbridge,E09000026,4163 ,2086 ,2077 
E02006800,2006,Redbridge 034,Redbridge,E09000026,8248 ,4200 ,4048 
E02006924,2006,Redbridge 035,Redbridge,E09000026,8083 ,4129 ,3954 
E02006925,2006,Redbridge 036,Redbridge,E09000026,7887 ,3859 ,4028 
E02000784,2006,Richmond upon Thames 001,Richmond upon Thames,E09000027,7209 ,3538 ,3671 
E02000785,2006,Richmond upon Thames 002,Richmond upon Thames,E09000027,6960 ,3470 ,3490 
E02000786,2006,Richmond upon Thames 003,Richmond upon Thames,E09000027,7825 ,3908 ,3917 
E02000787,2006,Richmond upon Thames 004,Richmond upon Thames,E09000027,7149 ,3552 ,3597 
E02000788,2006,Richmond upon Thames 005,Richmond upon Thames,E09000027,5794 ,2842 ,2952 
E02000789,2006,Richmond upon Thames 006,Richmond upon Thames,E09000027,4386 ,2231 ,2155 
E02000790,2006,Richmond upon Thames 007,Richmond upon Thames,E09000027,4159 ,2133 ,2026 
E02000791,2006,Richmond upon Thames 008,Richmond upon Thames,E09000027,4679 ,2447 ,2232 
E02000792,2006,Richmond upon Thames 009,Richmond upon Thames,E09000027,4924 ,2480 ,2444 
E02000793,2006,Richmond upon Thames 010,Richmond upon Thames,E09000027,5210 ,2591 ,2619 
E02000794,2006,Richmond upon Thames 011,Richmond upon Thames,E09000027,4372 ,2153 ,2219 
E02000795,2006,Richmond upon Thames 012,Richmond upon Thames,E09000027,4170 ,2116 ,2054 
E02000796,2006,Richmond upon Thames 013,Richmond upon Thames,E09000027,6519 ,3268 ,3251 
E02000797,2006,Richmond upon Thames 014,Richmond upon Thames,E09000027,5136 ,2655 ,2481 
E02000798,2006,Richmond upon Thames 015,Richmond upon Thames,E09000027,7298 ,3585 ,3713 
E02000799,2006,Richmond upon Thames 016,Richmond upon Thames,E09000027,4434 ,2193 ,2241 
E02000800,2006,Richmond upon Thames 017,Richmond upon Thames,E09000027,3393 ,1628 ,1765 
E02000801,2006,Richmond upon Thames 018,Richmond upon Thames,E09000027,4622 ,2278 ,2344 
E02000802,2006,Richmond upon Thames 019,Richmond upon Thames,E09000027,4319 ,2107 ,2212 
E02000803,2006,Richmond upon Thames 020,Richmond upon Thames,E09000027,6122 ,2986 ,3136 
E02000804,2006,Richmond upon Thames 021,Richmond upon Thames,E09000027,4642 ,2312 ,2330 
E02000805,2006,Richmond upon Thames 022,Richmond upon Thames,E09000027,6594 ,3237 ,3357 
E02000806,2006,Richmond upon Thames 023,Richmond upon Thames,E09000027,6333 ,3053 ,3280 
E02000807,2006,Southwark 001,Southwark,E09000028,6356 ,3380 ,2976 
E02000808,2006,Southwark 002,Southwark,E09000028,6414 ,3446 ,2968 
E02000809,2006,Southwark 003,Southwark,E09000028,8572 ,4804 ,3768 
E02000810,2006,Southwark 004,Southwark,E09000028,5540 ,2854 ,2686 
E02000812,2006,Southwark 006,Southwark,E09000028,6964 ,3568 ,3396 
E02000813,2006,Southwark 007,Southwark,E09000028,5731 ,2952 ,2779 
E02000814,2006,Southwark 008,Southwark,E09000028,6696 ,3602 ,3094 
E02000815,2006,Southwark 009,Southwark,E09000028,6435 ,3432 ,3003 
E02000816,2006,Southwark 010,Southwark,E09000028,5374 ,2663 ,2711 
E02000817,2006,Southwark 011,Southwark,E09000028,4035 ,1951 ,2084 
E02000818,2006,Southwark 012,Southwark,E09000028,5541 ,2755 ,2786 
E02000819,2006,Southwark 013,Southwark,E09000028,5098 ,2548 ,2550 
E02000820,2006,Southwark 014,Southwark,E09000028,5511 ,2757 ,2754 
E02000821,2006,Southwark 015,Southwark,E09000028,5499 ,2711 ,2788 
E02000822,2006,Southwark 016,Southwark,E09000028,5613 ,2771 ,2842 
E02000823,2006,Southwark 017,Southwark,E09000028,5177 ,2579 ,2598 
E02000824,2006,Southwark 018,Southwark,E09000028,5906 ,2827 ,3079 
E02000825,2006,Southwark 019,Southwark,E09000028,5509 ,2621 ,2888 
E02000826,2006,Southwark 020,Southwark,E09000028,5588 ,2712 ,2876 
E02000827,2006,Southwark 021,Southwark,E09000028,6909 ,3411 ,3498 
E02000828,2006,Southwark 022,Southwark,E09000028,5598 ,2811 ,2787 
E02000829,2006,Southwark 023,Southwark,E09000028,6418 ,3336 ,3082 
E02000830,2006,Southwark 024,Southwark,E09000028,6162 ,3043 ,3119 
E02000831,2006,Southwark 025,Southwark,E09000028,5955 ,3030 ,2925 
E02000832,2006,Southwark 026,Southwark,E09000028,6079 ,2914 ,3165 
E02000833,2006,Southwark 027,Southwark,E09000028,5451 ,2539 ,2912 
E02000834,2006,Southwark 028,Southwark,E09000028,6693 ,3254 ,3439 
E02000835,2006,Southwark 029,Southwark,E09000028,4754 ,2322 ,2432 
E02000836,2006,Southwark 030,Southwark,E09000028,5899 ,2845 ,3054 
E02000837,2006,Southwark 031,Southwark,E09000028,5234 ,2525 ,2709 
E02000838,2006,Southwark 032,Southwark,E09000028,6167 ,2981 ,3186 
E02000839,2006,Southwark 033,Southwark,E09000028,5151 ,2535 ,2616 
E02006802,2006,Southwark 034,Southwark,E09000028,5944 ,3008 ,2936 
E02000840,2006,Sutton 001,Sutton,E09000029,5055 ,2376 ,2679 
E02000841,2006,Sutton 002,Sutton,E09000029,5282 ,2518 ,2764 
E02000842,2006,Sutton 003,Sutton,E09000029,4933 ,2440 ,2493 
E02000843,2006,Sutton 004,Sutton,E09000029,5360 ,2622 ,2738 
E02000844,2006,Sutton 005,Sutton,E09000029,4947 ,2384 ,2563 
E02000845,2006,Sutton 006,Sutton,E09000029,5115 ,2458 ,2657 
E02000846,2006,Sutton 007,Sutton,E09000029,4349 ,2169 ,2180 
E02000847,2006,Sutton 008,Sutton,E09000029,5570 ,2771 ,2799 
E02000848,2006,Sutton 009,Sutton,E09000029,4973 ,2448 ,2525 
E02000849,2006,Sutton 010,Sutton,E09000029,4942 ,2460 ,2482 
E02000850,2006,Sutton 011,Sutton,E09000029,6613 ,3311 ,3302 
E02000851,2006,Sutton 012,Sutton,E09000029,5266 ,2725 ,2541 
E02000852,2006,Sutton 013,Sutton,E09000029,5041 ,2524 ,2517 
E02000853,2006,Sutton 014,Sutton,E09000029,5042 ,2467 ,2575 
E02000854,2006,Sutton 015,Sutton,E09000029,4570 ,2234 ,2336 
E02000855,2006,Sutton 016,Sutton,E09000029,4770 ,2331 ,2439 
E02000856,2006,Sutton 017,Sutton,E09000029,5370 ,2693 ,2677 
E02000857,2006,Sutton 018,Sutton,E09000029,5270 ,2692 ,2578 
E02000858,2006,Sutton 019,Sutton,E09000029,4439 ,2119 ,2320 
E02000859,2006,Sutton 020,Sutton,E09000029,5267 ,2587 ,2680 
E02000860,2006,Sutton 021,Sutton,E09000029,5019 ,2583 ,2436 
E02000861,2006,Sutton 022,Sutton,E09000029,5033 ,2477 ,2556 
E02000863,2006,Sutton 024,Sutton,E09000029,4114 ,2018 ,2096 
E02006836,2006,Sutton 025,Sutton,E09000029,5181 ,2548 ,2633 
E02000864,2006,Tower Hamlets 001,Tower Hamlets,E09000030,4544 ,2157 ,2387 
E02000865,2006,Tower Hamlets 002,Tower Hamlets,E09000030,4577 ,2267 ,2310 
E02000866,2006,Tower Hamlets 003,Tower Hamlets,E09000030,6337 ,3145 ,3192 
E02000867,2006,Tower Hamlets 004,Tower Hamlets,E09000030,5260 ,2660 ,2600 
E02000868,2006,Tower Hamlets 005,Tower Hamlets,E09000030,4406 ,2206 ,2200 
E02000869,2006,Tower Hamlets 006,Tower Hamlets,E09000030,3773 ,1937 ,1836 
E02000870,2006,Tower Hamlets 007,Tower Hamlets,E09000030,3985 ,2006 ,1979 
E02000871,2006,Tower Hamlets 008,Tower Hamlets,E09000030,4827 ,2474 ,2353 
E02000872,2006,Tower Hamlets 009,Tower Hamlets,E09000030,4789 ,2534 ,2255 
E02000873,2006,Tower Hamlets 010,Tower Hamlets,E09000030,5114 ,2546 ,2568 
E02000874,2006,Tower Hamlets 011,Tower Hamlets,E09000030,4818 ,2458 ,2360 
E02000875,2006,Tower Hamlets 012,Tower Hamlets,E09000030,5531 ,2821 ,2710 
E02000876,2006,Tower Hamlets 013,Tower Hamlets,E09000030,5050 ,2676 ,2374 
E02000877,2006,Tower Hamlets 014,Tower Hamlets,E09000030,6095 ,3122 ,2973 
E02000878,2006,Tower Hamlets 015,Tower Hamlets,E09000030,6907 ,3836 ,3071 
E02000879,2006,Tower Hamlets 016,Tower Hamlets,E09000030,4484 ,2229 ,2255 
E02000880,2006,Tower Hamlets 017,Tower Hamlets,E09000030,3808 ,1953 ,1855 
E02000881,2006,Tower Hamlets 018,Tower Hamlets,E09000030,4068 ,2017 ,2051 
E02000882,2006,Tower Hamlets 019,Tower Hamlets,E09000030,4827 ,2422 ,2405 
E02000883,2006,Tower Hamlets 020,Tower Hamlets,E09000030,4528 ,2202 ,2326 
E02000884,2006,Tower Hamlets 021,Tower Hamlets,E09000030,5749 ,3187 ,2562 
E02000885,2006,Tower Hamlets 022,Tower Hamlets,E09000030,3991 ,2056 ,1935 
E02000886,2006,Tower Hamlets 023,Tower Hamlets,E09000030,4772 ,2609 ,2163 
E02000887,2006,Tower Hamlets 024,Tower Hamlets,E09000030,4957 ,2441 ,2516 
E02000888,2006,Tower Hamlets 025,Tower Hamlets,E09000030,4866 ,2635 ,2231 
E02000889,2006,Tower Hamlets 026,Tower Hamlets,E09000030,4804 ,2604 ,2200 
E02000890,2006,Tower Hamlets 027,Tower Hamlets,E09000030,4590 ,2509 ,2081 
E02000891,2006,Tower Hamlets 028,Tower Hamlets,E09000030,7017 ,3765 ,3252 
E02000893,2006,Tower Hamlets 030,Tower Hamlets,E09000030,4717 ,2499 ,2218 
E02000894,2006,Tower Hamlets 031,Tower Hamlets,E09000030,6984 ,3816 ,3168 
E02006853,2006,Tower Hamlets 032,Tower Hamlets,E09000030,3272 ,1741 ,1531 
E02006854,2006,Tower Hamlets 033,Tower Hamlets,E09000030,2883 ,1663 ,1220 
E02000895,2006,Waltham Forest 001,Waltham Forest,E09000031,4546 ,2168 ,2378 
E02000896,2006,Waltham Forest 002,Waltham Forest,E09000031,5275 ,2605 ,2670 
E02000897,2006,Waltham Forest 003,Waltham Forest,E09000031,4711 ,2226 ,2485 
E02000898,2006,Waltham Forest 004,Waltham Forest,E09000031,4771 ,2303 ,2468 
E02000899,2006,Waltham Forest 005,Waltham Forest,E09000031,4914 ,2403 ,2511 
E02000900,2006,Waltham Forest 006,Waltham Forest,E09000031,5003 ,2389 ,2614 
E02000901,2006,Waltham Forest 007,Waltham Forest,E09000031,5889 ,2872 ,3017 
E02000902,2006,Waltham Forest 008,Waltham Forest,E09000031,5031 ,2420 ,2611 
E02000903,2006,Waltham Forest 009,Waltham Forest,E09000031,5514 ,2649 ,2865 
E02000904,2006,Waltham Forest 010,Waltham Forest,E09000031,4586 ,2275 ,2311 
E02000905,2006,Waltham Forest 011,Waltham Forest,E09000031,5614 ,2790 ,2824 
E02000906,2006,Waltham Forest 012,Waltham Forest,E09000031,5840 ,2931 ,2909 
E02000907,2006,Waltham Forest 013,Waltham Forest,E09000031,5711 ,2765 ,2946 
E02000908,2006,Waltham Forest 014,Waltham Forest,E09000031,6263 ,3319 ,2944 
E02000909,2006,Waltham Forest 015,Waltham Forest,E09000031,5355 ,2684 ,2671 
E02000910,2006,Waltham Forest 016,Waltham Forest,E09000031,6837 ,3495 ,3342 
E02000911,2006,Waltham Forest 017,Waltham Forest,E09000031,6479 ,3190 ,3289 
E02000912,2006,Waltham Forest 018,Waltham Forest,E09000031,5452 ,2678 ,2774 
E02000913,2006,Waltham Forest 019,Waltham Forest,E09000031,5495 ,2751 ,2744 
E02000914,2006,Waltham Forest 020,Waltham Forest,E09000031,6362 ,3287 ,3075 
E02000915,2006,Waltham Forest 021,Waltham Forest,E09000031,5786 ,3001 ,2785 
E02000916,2006,Waltham Forest 022,Waltham Forest,E09000031,5708 ,2847 ,2861 
E02000917,2006,Waltham Forest 023,Waltham Forest,E09000031,5729 ,2938 ,2791 
E02000918,2006,Waltham Forest 024,Waltham Forest,E09000031,5899 ,3084 ,2815 
E02000919,2006,Waltham Forest 025,Waltham Forest,E09000031,5870 ,3081 ,2789 
E02000920,2006,Waltham Forest 026,Waltham Forest,E09000031,5824 ,2955 ,2869 
E02000921,2006,Waltham Forest 027,Waltham Forest,E09000031,6825 ,3399 ,3426 
E02000922,2006,Waltham Forest 028,Waltham Forest,E09000031,6583 ,3452 ,3131 
E02000923,2006,Wandsworth 001,Wandsworth,E09000032,5279 ,2755 ,2524 
E02000924,2006,Wandsworth 002,Wandsworth,E09000032,6838 ,3392 ,3446 
E02000925,2006,Wandsworth 003,Wandsworth,E09000032,5034 ,2457 ,2577 
E02000926,2006,Wandsworth 004,Wandsworth,E09000032,5721 ,2868 ,2853 
E02000927,2006,Wandsworth 005,Wandsworth,E09000032,5281 ,2637 ,2644 
E02000928,2006,Wandsworth 006,Wandsworth,E09000032,6254 ,3041 ,3213 
E02000929,2006,Wandsworth 007,Wandsworth,E09000032,4678 ,2212 ,2466 
E02000930,2006,Wandsworth 008,Wandsworth,E09000032,7343 ,3609 ,3734 
E02000931,2006,Wandsworth 009,Wandsworth,E09000032,6632 ,3405 ,3227 
E02000932,2006,Wandsworth 010,Wandsworth,E09000032,7607 ,3805 ,3802 
E02000933,2006,Wandsworth 011,Wandsworth,E09000032,6098 ,2933 ,3165 
E02000934,2006,Wandsworth 012,Wandsworth,E09000032,6844 ,3421 ,3423 
E02000935,2006,Wandsworth 013,Wandsworth,E09000032,4544 ,1861 ,2683 
E02000936,2006,Wandsworth 014,Wandsworth,E09000032,6175 ,3023 ,3152 
E02000937,2006,Wandsworth 015,Wandsworth,E09000032,5829 ,2912 ,2917 
E02000938,2006,Wandsworth 016,Wandsworth,E09000032,6230 ,2956 ,3274 
E02000939,2006,Wandsworth 017,Wandsworth,E09000032,5485 ,2780 ,2705 
E02000940,2006,Wandsworth 018,Wandsworth,E09000032,5268 ,2571 ,2697 
E02000941,2006,Wandsworth 019,Wandsworth,E09000032,7694 ,3978 ,3716 
E02000942,2006,Wandsworth 020,Wandsworth,E09000032,6826 ,3345 ,3481 
E02000943,2006,Wandsworth 021,Wandsworth,E09000032,6308 ,3195 ,3113 
E02000944,2006,Wandsworth 022,Wandsworth,E09000032,4404 ,2015 ,2389 
E02000945,2006,Wandsworth 023,Wandsworth,E09000032,4937 ,2227 ,2710 
E02000946,2006,Wandsworth 024,Wandsworth,E09000032,5726 ,2964 ,2762 
E02000947,2006,Wandsworth 025,Wandsworth,E09000032,6651 ,3160 ,3491 
E02000948,2006,Wandsworth 026,Wandsworth,E09000032,7981 ,3955 ,4026 
E02000949,2006,Wandsworth 027,Wandsworth,E09000032,7215 ,3520 ,3695 
E02000950,2006,Wandsworth 028,Wandsworth,E09000032,5471 ,2588 ,2883 
E02000951,2006,Wandsworth 029,Wandsworth,E09000032,5199 ,2582 ,2617 
E02000952,2006,Wandsworth 030,Wandsworth,E09000032,4572 ,2299 ,2273 
E02000953,2006,Wandsworth 031,Wandsworth,E09000032,4719 ,2129 ,2590 
E02000954,2006,Wandsworth 032,Wandsworth,E09000032,4479 ,2201 ,2278 
E02000955,2006,Wandsworth 033,Wandsworth,E09000032,4632 ,2200 ,2432 
E02000956,2006,Wandsworth 034,Wandsworth,E09000032,5246 ,2448 ,2798 
E02000957,2006,Wandsworth 035,Wandsworth,E09000032,7297 ,3610 ,3687 
E02000958,2006,Wandsworth 036,Wandsworth,E09000032,5517 ,2662 ,2855 
E02000959,2006,Wandsworth 037,Wandsworth,E09000032,4922 ,2429 ,2493 
E02000960,2006,Westminster 001,Westminster,E09000033,4888 ,2294 ,2594 
E02000961,2006,Westminster 002,Westminster,E09000033,6299 ,2986 ,3313 
E02000962,2006,Westminster 003,Westminster,E09000033,6470 ,3191 ,3279 
E02000963,2006,Westminster 004,Westminster,E09000033,6801 ,3079 ,3722 
E02000964,2006,Westminster 005,Westminster,E09000033,8437 ,3883 ,4554 
E02000965,2006,Westminster 006,Westminster,E09000033,7408 ,3612 ,3796 
E02000966,2006,Westminster 007,Westminster,E09000033,7382 ,3613 ,3769 
E02000967,2006,Westminster 008,Westminster,E09000033,6238 ,3205 ,3033 
E02000968,2006,Westminster 009,Westminster,E09000033,9897 ,4789 ,5108 
E02000969,2006,Westminster 010,Westminster,E09000033,6692 ,3130 ,3562 
E02000970,2006,Westminster 011,Westminster,E09000033,7551 ,3893 ,3658 
E02000971,2006,Westminster 012,Westminster,E09000033,7615 ,4098 ,3517 
E02000972,2006,Westminster 013,Westminster,E09000033,6888 ,3812 ,3076 
E02000973,2006,Westminster 014,Westminster,E09000033,7763 ,3893 ,3870 
E02000974,2006,Westminster 015,Westminster,E09000033,7022 ,3819 ,3203 
E02000975,2006,Westminster 016,Westminster,E09000033,7933 ,4298 ,3635 
E02000976,2006,Westminster 017,Westminster,E09000033,8905 ,4728 ,4177 
E02000977,2006,Westminster 018,Westminster,E09000033,6175 ,3585 ,2590 
E02000978,2006,Westminster 019,Westminster,E09000033,8255 ,4159 ,4096 
E02000979,2006,Westminster 020,Westminster,E09000033,6665 ,3358 ,3307 
E02000980,2006,Westminster 021,Westminster,E09000033,6127 ,3073 ,3054 
E02000981,2006,Westminster 022,Westminster,E09000033,7409 ,3888 ,3521 
E02000982,2006,Westminster 023,Westminster,E09000033,5764 ,3043 ,2721 
E02000983,2006,Westminster 024,Westminster,E09000033,6450 ,3260 ,3190 
E02000001,2007,City of London 001,City of London,E09000001,6093 ,3447 ,2646 
E02000002,2007,Barking and Dagenham 001,Barking and Dagenham,E09000002,3689 ,1742 ,1947 
E02000003,2007,Barking and Dagenham 002,Barking and Dagenham,E09000002,6062 ,2942 ,3120 
E02000004,2007,Barking and Dagenham 003,Barking and Dagenham,E09000002,3745 ,1807 ,1938 
E02000005,2007,Barking and Dagenham 004,Barking and Dagenham,E09000002,5066 ,2422 ,2644 
E02000007,2007,Barking and Dagenham 006,Barking and Dagenham,E09000002,4847 ,2228 ,2619 
E02000008,2007,Barking and Dagenham 007,Barking and Dagenham,E09000002,6735 ,3142 ,3593 
E02000009,2007,Barking and Dagenham 008,Barking and Dagenham,E09000002,5480 ,2754 ,2726 
E02000010,2007,Barking and Dagenham 009,Barking and Dagenham,E09000002,4944 ,2351 ,2593 
E02000011,2007,Barking and Dagenham 010,Barking and Dagenham,E09000002,3633 ,1799 ,1834 
E02000012,2007,Barking and Dagenham 011,Barking and Dagenham,E09000002,5502 ,2747 ,2755 
E02000013,2007,Barking and Dagenham 012,Barking and Dagenham,E09000002,4706 ,2220 ,2486 
E02000014,2007,Barking and Dagenham 013,Barking and Dagenham,E09000002,5504 ,2665 ,2839 
E02000015,2007,Barking and Dagenham 014,Barking and Dagenham,E09000002,4286 ,2027 ,2259 
E02000016,2007,Barking and Dagenham 015,Barking and Dagenham,E09000002,3778 ,2053 ,1725 
E02000017,2007,Barking and Dagenham 016,Barking and Dagenham,E09000002,5428 ,2952 ,2476 
E02000018,2007,Barking and Dagenham 017,Barking and Dagenham,E09000002,5050 ,2362 ,2688 
E02000019,2007,Barking and Dagenham 018,Barking and Dagenham,E09000002,4685 ,2228 ,2457 
E02000020,2007,Barking and Dagenham 019,Barking and Dagenham,E09000002,5219 ,2623 ,2596 
E02000021,2007,Barking and Dagenham 020,Barking and Dagenham,E09000002,4788 ,2293 ,2495 
E02000022,2007,Barking and Dagenham 021,Barking and Dagenham,E09000002,4845 ,2347 ,2498 
E02000023,2007,Barking and Dagenham 022,Barking and Dagenham,E09000002,4014 ,1903 ,2111 
E02006799,2007,Barking and Dagenham 023,Barking and Dagenham,E09000002,5589 ,2697 ,2892 
E02000024,2007,Barnet 001,Barnet,E09000003,6355 ,3069 ,3286 
E02000025,2007,Barnet 002,Barnet,E09000003,5476 ,2671 ,2805 
E02000026,2007,Barnet 003,Barnet,E09000003,4061 ,1929 ,2132 
E02000027,2007,Barnet 004,Barnet,E09000003,6292 ,2944 ,3348 
E02000028,2007,Barnet 005,Barnet,E09000003,3933 ,1936 ,1997 
E02000029,2007,Barnet 006,Barnet,E09000003,5840 ,2869 ,2971 
E02000030,2007,Barnet 007,Barnet,E09000003,5921 ,2832 ,3089 
E02000031,2007,Barnet 008,Barnet,E09000003,4651 ,2290 ,2361 
E02000032,2007,Barnet 009,Barnet,E09000003,4879 ,2301 ,2578 
E02000033,2007,Barnet 010,Barnet,E09000003,5071 ,2406 ,2665 
E02000034,2007,Barnet 011,Barnet,E09000003,5547 ,2680 ,2867 
E02000035,2007,Barnet 012,Barnet,E09000003,5730 ,2856 ,2874 
E02000036,2007,Barnet 013,Barnet,E09000003,6667 ,3168 ,3499 
E02000037,2007,Barnet 014,Barnet,E09000003,5994 ,2834 ,3160 
E02000038,2007,Barnet 015,Barnet,E09000003,7040 ,3539 ,3501 
E02000039,2007,Barnet 016,Barnet,E09000003,4275 ,2092 ,2183 
E02000040,2007,Barnet 017,Barnet,E09000003,4255 ,2069 ,2186 
E02000041,2007,Barnet 018,Barnet,E09000003,5495 ,2689 ,2806 
E02000042,2007,Barnet 019,Barnet,E09000003,7220 ,3690 ,3530 
E02000043,2007,Barnet 020,Barnet,E09000003,5153 ,2542 ,2611 
E02000044,2007,Barnet 021,Barnet,E09000003,5000 ,2262 ,2738 
E02000045,2007,Barnet 022,Barnet,E09000003,6854 ,3307 ,3547 
E02000046,2007,Barnet 023,Barnet,E09000003,4763 ,2402 ,2361 
E02000047,2007,Barnet 024,Barnet,E09000003,6269 ,2839 ,3430 
E02000048,2007,Barnet 025,Barnet,E09000003,5961 ,2925 ,3036 
E02000049,2007,Barnet 026,Barnet,E09000003,4843 ,2066 ,2777 
E02000050,2007,Barnet 027,Barnet,E09000003,6623 ,3179 ,3444 
E02000051,2007,Barnet 028,Barnet,E09000003,5527 ,2776 ,2751 
E02000052,2007,Barnet 029,Barnet,E09000003,6755 ,3205 ,3550 
E02000053,2007,Barnet 030,Barnet,E09000003,4847 ,2439 ,2408 
E02000054,2007,Barnet 031,Barnet,E09000003,4740 ,2350 ,2390 
E02000055,2007,Barnet 032,Barnet,E09000003,6866 ,3490 ,3376 
E02000056,2007,Barnet 033,Barnet,E09000003,5326 ,2420 ,2906 
E02000057,2007,Barnet 034,Barnet,E09000003,4341 ,2142 ,2199 
E02000058,2007,Barnet 035,Barnet,E09000003,5885 ,2717 ,3168 
E02000059,2007,Barnet 036,Barnet,E09000003,6286 ,3034 ,3252 
E02000060,2007,Barnet 037,Barnet,E09000003,5864 ,2899 ,2965 
E02000061,2007,Barnet 038,Barnet,E09000003,5144 ,2587 ,2557 
E02000062,2007,Barnet 039,Barnet,E09000003,3817 ,1777 ,2040 
E02000063,2007,Barnet 040,Barnet,E09000003,4336 ,2110 ,2226 
E02000064,2007,Barnet 041,Barnet,E09000003,3814 ,1775 ,2039 
E02000065,2007,Bexley 001,Bexley,E09000004,4609 ,2219 ,2390 
E02000066,2007,Bexley 002,Bexley,E09000004,6256 ,2965 ,3291 
E02000067,2007,Bexley 003,Bexley,E09000004,5335 ,2528 ,2807 
E02000068,2007,Bexley 004,Bexley,E09000004,4349 ,2121 ,2228 
E02000069,2007,Bexley 005,Bexley,E09000004,3732 ,1817 ,1915 
E02000070,2007,Bexley 006,Bexley,E09000004,5037 ,2456 ,2581 
E02000071,2007,Bexley 007,Bexley,E09000004,4800 ,2313 ,2487 
E02000072,2007,Bexley 008,Bexley,E09000004,7309 ,3422 ,3887 
E02000073,2007,Bexley 009,Bexley,E09000004,6670 ,3294 ,3376 
E02000074,2007,Bexley 010,Bexley,E09000004,4760 ,2270 ,2490 
E02000075,2007,Bexley 011,Bexley,E09000004,5029 ,2479 ,2550 
E02000077,2007,Bexley 013,Bexley,E09000004,4870 ,2371 ,2499 
E02000078,2007,Bexley 014,Bexley,E09000004,5121 ,2506 ,2615 
E02000079,2007,Bexley 015,Bexley,E09000004,5027 ,2484 ,2543 
E02000080,2007,Bexley 016,Bexley,E09000004,5875 ,2878 ,2997 
E02000081,2007,Bexley 017,Bexley,E09000004,4726 ,2326 ,2400 
E02000082,2007,Bexley 018,Bexley,E09000004,5684 ,2873 ,2811 
E02000083,2007,Bexley 019,Bexley,E09000004,6076 ,2985 ,3091 
E02000084,2007,Bexley 020,Bexley,E09000004,6717 ,3315 ,3402 
E02000085,2007,Bexley 021,Bexley,E09000004,4963 ,2444 ,2519 
E02000086,2007,Bexley 022,Bexley,E09000004,4795 ,2318 ,2477 
E02000087,2007,Bexley 023,Bexley,E09000004,4505 ,2269 ,2236 
E02000088,2007,Bexley 024,Bexley,E09000004,4845 ,2394 ,2451 
E02000089,2007,Bexley 025,Bexley,E09000004,4833 ,2317 ,2516 
E02000090,2007,Bexley 026,Bexley,E09000004,5297 ,2547 ,2750 
E02000091,2007,Bexley 027,Bexley,E09000004,5826 ,2826 ,3000 
E02000092,2007,Bexley 028,Bexley,E09000004,3762 ,1759 ,2003 
E02006785,2007,Bexley 029,Bexley,E09000004,3919 ,1932 ,1987 
E02000093,2007,Brent 001,Brent,E09000005,6644 ,3299 ,3345 
E02000094,2007,Brent 002,Brent,E09000005,5152 ,2558 ,2594 
E02000095,2007,Brent 003,Brent,E09000005,5958 ,2967 ,2991 
E02000096,2007,Brent 004,Brent,E09000005,4669 ,2347 ,2322 
E02000097,2007,Brent 005,Brent,E09000005,5359 ,2699 ,2660 
E02000098,2007,Brent 006,Brent,E09000005,4727 ,2352 ,2375 
E02000099,2007,Brent 007,Brent,E09000005,4951 ,2483 ,2468 
E02000100,2007,Brent 008,Brent,E09000005,5445 ,2601 ,2844 
E02000101,2007,Brent 009,Brent,E09000005,5504 ,2637 ,2867 
E02000102,2007,Brent 010,Brent,E09000005,4811 ,2398 ,2413 
E02000103,2007,Brent 011,Brent,E09000005,5299 ,2677 ,2622 
E02000104,2007,Brent 012,Brent,E09000005,4134 ,2148 ,1986 
E02000105,2007,Brent 013,Brent,E09000005,5408 ,2790 ,2618 
E02000106,2007,Brent 014,Brent,E09000005,6724 ,3461 ,3263 
E02000107,2007,Brent 015,Brent,E09000005,7877 ,4176 ,3701 
E02000108,2007,Brent 016,Brent,E09000005,4121 ,2138 ,1983 
E02000109,2007,Brent 017,Brent,E09000005,5761 ,3050 ,2711 
E02000110,2007,Brent 018,Brent,E09000005,5790 ,2915 ,2875 
E02000111,2007,Brent 019,Brent,E09000005,5857 ,3064 ,2793 
E02000112,2007,Brent 020,Brent,E09000005,5688 ,2965 ,2723 
E02000113,2007,Brent 021,Brent,E09000005,5768 ,2675 ,3093 
E02000114,2007,Brent 022,Brent,E09000005,6357 ,3232 ,3125 
E02000115,2007,Brent 023,Brent,E09000005,5933 ,3055 ,2878 
E02000116,2007,Brent 024,Brent,E09000005,4928 ,2507 ,2421 
E02000117,2007,Brent 025,Brent,E09000005,7444 ,3627 ,3817 
E02000118,2007,Brent 026,Brent,E09000005,5980 ,3137 ,2843 
E02000119,2007,Brent 027,Brent,E09000005,4268 ,2105 ,2163 
E02000120,2007,Brent 028,Brent,E09000005,6650 ,3275 ,3375 
E02000121,2007,Brent 029,Brent,E09000005,5717 ,2958 ,2759 
E02000122,2007,Brent 030,Brent,E09000005,5330 ,2607 ,2723 
E02000123,2007,Brent 031,Brent,E09000005,9260 ,4784 ,4476 
E02000124,2007,Brent 032,Brent,E09000005,7093 ,3540 ,3553 
E02000125,2007,Brent 033,Brent,E09000005,7232 ,3563 ,3669 
E02000126,2007,Brent 034,Brent,E09000005,4797 ,2327 ,2470 
E02000127,2007,Bromley 001,Bromley,E09000006,5425 ,2486 ,2939 
E02000128,2007,Bromley 002,Bromley,E09000006,4786 ,2282 ,2504 
E02000130,2007,Bromley 004,Bromley,E09000006,5322 ,2548 ,2774 
E02000131,2007,Bromley 005,Bromley,E09000006,6375 ,3170 ,3205 
E02000132,2007,Bromley 006,Bromley,E09000006,5738 ,2847 ,2891 
E02000133,2007,Bromley 007,Bromley,E09000006,5806 ,2867 ,2939 
E02000134,2007,Bromley 008,Bromley,E09000006,7196 ,3580 ,3616 
E02000135,2007,Bromley 009,Bromley,E09000006,6473 ,3046 ,3427 
E02000136,2007,Bromley 010,Bromley,E09000006,3434 ,1671 ,1763 
E02000137,2007,Bromley 011,Bromley,E09000006,5019 ,2430 ,2589 
E02000138,2007,Bromley 012,Bromley,E09000006,5016 ,2521 ,2495 
E02000139,2007,Bromley 013,Bromley,E09000006,4958 ,2398 ,2560 
E02000140,2007,Bromley 014,Bromley,E09000006,4601 ,2149 ,2452 
E02000141,2007,Bromley 015,Bromley,E09000006,4978 ,2433 ,2545 
E02000142,2007,Bromley 016,Bromley,E09000006,5304 ,2601 ,2703 
E02000144,2007,Bromley 018,Bromley,E09000006,5636 ,2837 ,2799 
E02000145,2007,Bromley 019,Bromley,E09000006,4770 ,2228 ,2542 
E02000146,2007,Bromley 020,Bromley,E09000006,5076 ,2476 ,2600 
E02000147,2007,Bromley 021,Bromley,E09000006,4751 ,2331 ,2420 
E02000148,2007,Bromley 022,Bromley,E09000006,3956 ,1916 ,2040 
E02000149,2007,Bromley 023,Bromley,E09000006,4855 ,2309 ,2546 
E02000150,2007,Bromley 024,Bromley,E09000006,5129 ,2471 ,2658 
E02000151,2007,Bromley 025,Bromley,E09000006,4696 ,2265 ,2431 
E02000152,2007,Bromley 026,Bromley,E09000006,4055 ,1909 ,2146 
E02000153,2007,Bromley 027,Bromley,E09000006,4886 ,2343 ,2543 
E02000154,2007,Bromley 028,Bromley,E09000006,5065 ,2528 ,2537 
E02000155,2007,Bromley 029,Bromley,E09000006,4281 ,2097 ,2184 
E02000156,2007,Bromley 030,Bromley,E09000006,7395 ,3660 ,3735 
E02000157,2007,Bromley 031,Bromley,E09000006,4651 ,2278 ,2373 
E02000158,2007,Bromley 032,Bromley,E09000006,4481 ,2122 ,2359 
E02000159,2007,Bromley 033,Bromley,E09000006,4028 ,1963 ,2065 
E02000160,2007,Bromley 034,Bromley,E09000006,4859 ,2424 ,2435 
E02000161,2007,Bromley 035,Bromley,E09000006,5296 ,2588 ,2708 
E02000162,2007,Bromley 036,Bromley,E09000006,3963 ,1878 ,2085 
E02000163,2007,Bromley 037,Bromley,E09000006,4912 ,2424 ,2488 
E02000165,2007,Bromley 039,Bromley,E09000006,4919 ,2448 ,2471 
E02006782,2007,Bromley 040,Bromley,E09000006,4798 ,2299 ,2499 
E02006787,2007,Bromley 041,Bromley,E09000006,4826 ,2302 ,2524 
E02006789,2007,Bromley 042,Bromley,E09000006,3863 ,1886 ,1977 
E02000166,2007,Camden 001,Camden,E09000007,5660 ,2611 ,3049 
E02000167,2007,Camden 002,Camden,E09000007,5366 ,2601 ,2765 
E02000168,2007,Camden 003,Camden,E09000007,5865 ,2818 ,3047 
E02000169,2007,Camden 004,Camden,E09000007,4740 ,2193 ,2547 
E02000170,2007,Camden 005,Camden,E09000007,6002 ,2834 ,3168 
E02000171,2007,Camden 006,Camden,E09000007,5257 ,2447 ,2810 
E02000172,2007,Camden 007,Camden,E09000007,6690 ,3255 ,3435 
E02000173,2007,Camden 008,Camden,E09000007,5210 ,2468 ,2742 
E02000174,2007,Camden 009,Camden,E09000007,6566 ,3179 ,3387 
E02000175,2007,Camden 010,Camden,E09000007,6757 ,3148 ,3609 
E02000176,2007,Camden 011,Camden,E09000007,4576 ,2189 ,2387 
E02000177,2007,Camden 012,Camden,E09000007,5964 ,2812 ,3152 
E02000178,2007,Camden 013,Camden,E09000007,6696 ,3249 ,3447 
E02000179,2007,Camden 014,Camden,E09000007,4209 ,2032 ,2177 
E02000180,2007,Camden 015,Camden,E09000007,5593 ,2633 ,2960 
E02000181,2007,Camden 016,Camden,E09000007,6051 ,2921 ,3130 
E02000182,2007,Camden 017,Camden,E09000007,4185 ,1911 ,2274 
E02000183,2007,Camden 018,Camden,E09000007,5599 ,2789 ,2810 
E02000184,2007,Camden 019,Camden,E09000007,6114 ,2998 ,3116 
E02000185,2007,Camden 020,Camden,E09000007,5753 ,2783 ,2970 
E02000186,2007,Camden 021,Camden,E09000007,5279 ,2926 ,2353 
E02000187,2007,Camden 022,Camden,E09000007,5334 ,2607 ,2727 
E02000188,2007,Camden 023,Camden,E09000007,5607 ,2872 ,2735 
E02000189,2007,Camden 024,Camden,E09000007,4239 ,2126 ,2113 
E02000190,2007,Camden 025,Camden,E09000007,5954 ,3096 ,2858 
E02000191,2007,Camden 026,Camden,E09000007,5966 ,3202 ,2764 
E02000192,2007,Camden 027,Camden,E09000007,5168 ,2836 ,2332 
E02000193,2007,Camden 028,Camden,E09000007,6320 ,3321 ,2999 
E02000194,2007,Croydon 001,Croydon,E09000008,5584 ,2780 ,2804 
E02000195,2007,Croydon 002,Croydon,E09000008,5709 ,2866 ,2843 
E02000196,2007,Croydon 003,Croydon,E09000008,4534 ,2200 ,2334 
E02000197,2007,Croydon 004,Croydon,E09000008,5627 ,2693 ,2934 
E02000198,2007,Croydon 005,Croydon,E09000008,5214 ,2463 ,2751 
E02000199,2007,Croydon 006,Croydon,E09000008,5366 ,2553 ,2813 
E02000200,2007,Croydon 007,Croydon,E09000008,5675 ,2749 ,2926 
E02000201,2007,Croydon 008,Croydon,E09000008,5417 ,2625 ,2792 
E02000202,2007,Croydon 009,Croydon,E09000008,5908 ,2927 ,2981 
E02000203,2007,Croydon 010,Croydon,E09000008,5191 ,2507 ,2684 
E02000204,2007,Croydon 011,Croydon,E09000008,6368 ,3096 ,3272 
E02000206,2007,Croydon 013,Croydon,E09000008,6184 ,2951 ,3233 
E02000207,2007,Croydon 014,Croydon,E09000008,5450 ,2574 ,2876 
E02000208,2007,Croydon 015,Croydon,E09000008,5425 ,2709 ,2716 
E02000209,2007,Croydon 016,Croydon,E09000008,5459 ,2631 ,2828 
E02000210,2007,Croydon 017,Croydon,E09000008,5559 ,2704 ,2855 
E02000211,2007,Croydon 018,Croydon,E09000008,5114 ,2517 ,2597 
E02000212,2007,Croydon 019,Croydon,E09000008,5070 ,2467 ,2603 
E02000213,2007,Croydon 020,Croydon,E09000008,6176 ,3166 ,3010 
E02000214,2007,Croydon 021,Croydon,E09000008,4014 ,2046 ,1968 
E02000215,2007,Croydon 022,Croydon,E09000008,7086 ,3690 ,3396 
E02000216,2007,Croydon 023,Croydon,E09000008,4260 ,2257 ,2003 
E02000217,2007,Croydon 024,Croydon,E09000008,5858 ,2911 ,2947 
E02000218,2007,Croydon 025,Croydon,E09000008,3978 ,1843 ,2135 
E02000219,2007,Croydon 026,Croydon,E09000008,4678 ,2295 ,2383 
E02000220,2007,Croydon 027,Croydon,E09000008,6550 ,3439 ,3111 
E02000221,2007,Croydon 028,Croydon,E09000008,5703 ,2668 ,3035 
E02000222,2007,Croydon 029,Croydon,E09000008,5404 ,2710 ,2694 
E02000223,2007,Croydon 030,Croydon,E09000008,4751 ,2054 ,2697 
E02000224,2007,Croydon 031,Croydon,E09000008,5295 ,2684 ,2611 
E02000225,2007,Croydon 032,Croydon,E09000008,4667 ,2163 ,2504 
E02000226,2007,Croydon 033,Croydon,E09000008,4896 ,2443 ,2453 
E02000227,2007,Croydon 034,Croydon,E09000008,7598 ,3600 ,3998 
E02000228,2007,Croydon 035,Croydon,E09000008,4628 ,2266 ,2362 
E02000229,2007,Croydon 036,Croydon,E09000008,3503 ,1621 ,1882 
E02000230,2007,Croydon 037,Croydon,E09000008,6206 ,3150 ,3056 
E02000231,2007,Croydon 038,Croydon,E09000008,4906 ,2464 ,2442 
E02000232,2007,Croydon 039,Croydon,E09000008,3771 ,1814 ,1957 
E02000233,2007,Croydon 040,Croydon,E09000008,3804 ,1852 ,1952 
E02000234,2007,Croydon 041,Croydon,E09000008,5072 ,2450 ,2622 
E02000235,2007,Croydon 042,Croydon,E09000008,4455 ,2139 ,2316 
E02000236,2007,Croydon 043,Croydon,E09000008,4899 ,2421 ,2478 
E02000237,2007,Croydon 044,Croydon,E09000008,4574 ,2197 ,2377 
E02006788,2007,Croydon 045,Croydon,E09000008,4885 ,2185 ,2700 
E02000238,2007,Ealing 001,Ealing,E09000009,6375 ,3275 ,3100 
E02000239,2007,Ealing 002,Ealing,E09000009,6231 ,3260 ,2971 
E02000240,2007,Ealing 003,Ealing,E09000009,6476 ,3145 ,3331 
E02000241,2007,Ealing 004,Ealing,E09000009,4506 ,2275 ,2231 
E02000242,2007,Ealing 005,Ealing,E09000009,4592 ,2447 ,2145 
E02000243,2007,Ealing 006,Ealing,E09000009,6060 ,3095 ,2965 
E02000244,2007,Ealing 007,Ealing,E09000009,4907 ,2603 ,2304 
E02000245,2007,Ealing 008,Ealing,E09000009,5315 ,2548 ,2767 
E02000246,2007,Ealing 009,Ealing,E09000009,5494 ,2659 ,2835 
E02000247,2007,Ealing 010,Ealing,E09000009,5960 ,2869 ,3091 
E02000248,2007,Ealing 011,Ealing,E09000009,5299 ,2794 ,2505 
E02000249,2007,Ealing 012,Ealing,E09000009,4934 ,2532 ,2402 
E02000250,2007,Ealing 013,Ealing,E09000009,4631 ,2376 ,2255 
E02000251,2007,Ealing 014,Ealing,E09000009,5345 ,2721 ,2624 
E02000252,2007,Ealing 015,Ealing,E09000009,6326 ,3397 ,2929 
E02000253,2007,Ealing 016,Ealing,E09000009,6062 ,2822 ,3240 
E02000254,2007,Ealing 017,Ealing,E09000009,5881 ,2982 ,2899 
E02000255,2007,Ealing 018,Ealing,E09000009,6843 ,3389 ,3454 
E02000256,2007,Ealing 019,Ealing,E09000009,6368 ,3316 ,3052 
E02000257,2007,Ealing 020,Ealing,E09000009,10133 ,5396 ,4737 
E02000258,2007,Ealing 021,Ealing,E09000009,4102 ,2019 ,2083 
E02000259,2007,Ealing 022,Ealing,E09000009,4175 ,2016 ,2159 
E02000260,2007,Ealing 023,Ealing,E09000009,5405 ,2771 ,2634 
E02000261,2007,Ealing 024,Ealing,E09000009,6951 ,3503 ,3448 
E02000262,2007,Ealing 025,Ealing,E09000009,5149 ,2489 ,2660 
E02000263,2007,Ealing 026,Ealing,E09000009,6873 ,3498 ,3375 
E02000264,2007,Ealing 027,Ealing,E09000009,5123 ,2510 ,2613 
E02000265,2007,Ealing 028,Ealing,E09000009,7999 ,4111 ,3888 
E02000266,2007,Ealing 029,Ealing,E09000009,8305 ,4201 ,4104 
E02000267,2007,Ealing 030,Ealing,E09000009,4987 ,2501 ,2486 
E02000268,2007,Ealing 031,Ealing,E09000009,6576 ,3266 ,3310 
E02000269,2007,Ealing 032,Ealing,E09000009,5920 ,2987 ,2933 
E02000270,2007,Ealing 033,Ealing,E09000009,4805 ,2251 ,2554 
E02000271,2007,Ealing 034,Ealing,E09000009,4072 ,1868 ,2204 
E02000272,2007,Ealing 035,Ealing,E09000009,4315 ,2076 ,2239 
E02000274,2007,Ealing 037,Ealing,E09000009,7812 ,4106 ,3706 
E02000275,2007,Ealing 038,Ealing,E09000009,4510 ,2327 ,2183 
E02000276,2007,Ealing 039,Ealing,E09000009,4372 ,2170 ,2202 
E02006791,2007,Ealing 040,Ealing,E09000009,4342 ,2038 ,2304 
E02000277,2007,Enfield 001,Enfield,E09000010,4359 ,2064 ,2295 
E02000278,2007,Enfield 002,Enfield,E09000010,4996 ,2357 ,2639 
E02000279,2007,Enfield 003,Enfield,E09000010,6471 ,2989 ,3482 
E02000280,2007,Enfield 004,Enfield,E09000010,5242 ,2481 ,2761 
E02000281,2007,Enfield 005,Enfield,E09000010,5282 ,2491 ,2791 
E02000282,2007,Enfield 006,Enfield,E09000010,5463 ,2587 ,2876 
E02000283,2007,Enfield 007,Enfield,E09000010,5040 ,2477 ,2563 
E02000284,2007,Enfield 008,Enfield,E09000010,5148 ,2482 ,2666 
E02000285,2007,Enfield 009,Enfield,E09000010,4186 ,2006 ,2180 
E02000286,2007,Enfield 010,Enfield,E09000010,5252 ,2657 ,2595 
E02000287,2007,Enfield 011,Enfield,E09000010,4309 ,2169 ,2140 
E02000288,2007,Enfield 012,Enfield,E09000010,6019 ,2949 ,3070 
E02000289,2007,Enfield 013,Enfield,E09000010,4063 ,1972 ,2091 
E02000290,2007,Enfield 014,Enfield,E09000010,4505 ,2155 ,2350 
E02000291,2007,Enfield 015,Enfield,E09000010,5477 ,2737 ,2740 
E02000292,2007,Enfield 016,Enfield,E09000010,6032 ,2971 ,3061 
E02000293,2007,Enfield 017,Enfield,E09000010,3901 ,1928 ,1973 
E02000294,2007,Enfield 018,Enfield,E09000010,5368 ,2601 ,2767 
E02000295,2007,Enfield 019,Enfield,E09000010,5393 ,2638 ,2755 
E02000296,2007,Enfield 020,Enfield,E09000010,5775 ,2800 ,2975 
E02000297,2007,Enfield 021,Enfield,E09000010,6096 ,3043 ,3053 
E02000298,2007,Enfield 022,Enfield,E09000010,5232 ,2600 ,2632 
E02000299,2007,Enfield 023,Enfield,E09000010,5486 ,2668 ,2818 
E02000300,2007,Enfield 024,Enfield,E09000010,5192 ,2501 ,2691 
E02000301,2007,Enfield 025,Enfield,E09000010,5946 ,2811 ,3135 
E02000302,2007,Enfield 026,Enfield,E09000010,5330 ,2640 ,2690 
E02000303,2007,Enfield 027,Enfield,E09000010,5053 ,2386 ,2667 
E02000304,2007,Enfield 028,Enfield,E09000010,5161 ,2543 ,2618 
E02000305,2007,Enfield 029,Enfield,E09000010,5714 ,2919 ,2795 
E02000306,2007,Enfield 030,Enfield,E09000010,4913 ,2270 ,2643 
E02000307,2007,Enfield 031,Enfield,E09000010,6117 ,2979 ,3138 
E02000308,2007,Enfield 032,Enfield,E09000010,5067 ,2629 ,2438 
E02000309,2007,Enfield 033,Enfield,E09000010,6323 ,3081 ,3242 
E02000311,2007,Enfield 035,Enfield,E09000010,6332 ,3089 ,3243 
E02000312,2007,Enfield 036,Enfield,E09000010,6900 ,3619 ,3281 
E02006793,2007,Enfield 037,Enfield,E09000010,5507 ,2602 ,2905 
E02000313,2007,Greenwich 001,Greenwich,E09000011,3938 ,1950 ,1988 
E02000314,2007,Greenwich 002,Greenwich,E09000011,7339 ,3846 ,3493 
E02000315,2007,Greenwich 003,Greenwich,E09000011,5164 ,2428 ,2736 
E02000316,2007,Greenwich 004,Greenwich,E09000011,5898 ,3019 ,2879 
E02000317,2007,Greenwich 005,Greenwich,E09000011,5424 ,2668 ,2756 
E02000318,2007,Greenwich 006,Greenwich,E09000011,5959 ,3056 ,2903 
E02000319,2007,Greenwich 007,Greenwich,E09000011,6694 ,3420 ,3274 
E02000320,2007,Greenwich 008,Greenwich,E09000011,4132 ,1958 ,2174 
E02000321,2007,Greenwich 009,Greenwich,E09000011,4536 ,2257 ,2279 
E02000323,2007,Greenwich 011,Greenwich,E09000011,6567 ,3284 ,3283 
E02000324,2007,Greenwich 012,Greenwich,E09000011,4408 ,2149 ,2259 
E02000326,2007,Greenwich 014,Greenwich,E09000011,4533 ,2220 ,2313 
E02000327,2007,Greenwich 015,Greenwich,E09000011,4183 ,2210 ,1973 
E02000328,2007,Greenwich 016,Greenwich,E09000011,4291 ,2159 ,2132 
E02000329,2007,Greenwich 017,Greenwich,E09000011,4070 ,2012 ,2058 
E02000331,2007,Greenwich 019,Greenwich,E09000011,5010 ,2455 ,2555 
E02000332,2007,Greenwich 020,Greenwich,E09000011,4754 ,2368 ,2386 
E02000333,2007,Greenwich 021,Greenwich,E09000011,4300 ,2250 ,2050 
E02000334,2007,Greenwich 022,Greenwich,E09000011,4095 ,2056 ,2039 
E02000335,2007,Greenwich 023,Greenwich,E09000011,4174 ,2063 ,2111 
E02000337,2007,Greenwich 025,Greenwich,E09000011,5109 ,2433 ,2676 
E02000339,2007,Greenwich 027,Greenwich,E09000011,3875 ,1916 ,1959 
E02000340,2007,Greenwich 028,Greenwich,E09000011,3770 ,1897 ,1873 
E02000341,2007,Greenwich 029,Greenwich,E09000011,4805 ,2251 ,2554 
E02000342,2007,Greenwich 030,Greenwich,E09000011,4094 ,1918 ,2176 
E02000343,2007,Greenwich 031,Greenwich,E09000011,4186 ,2080 ,2106 
E02000344,2007,Greenwich 032,Greenwich,E09000011,4059 ,2012 ,2047 
E02006786,2007,Greenwich 033,Greenwich,E09000011,4429 ,2178 ,2251 
E02006927,2007,Greenwich 034,Greenwich,E09000011,6924 ,3388 ,3536 
E02006928,2007,Greenwich 035,Greenwich,E09000011,4776 ,2479 ,2297 
E02006929,2007,Greenwich 036,Greenwich,E09000011,4753 ,2370 ,2383 
E02006930,2007,Greenwich 037,Greenwich,E09000011,4814 ,2422 ,2392 
E02006931,2007,Greenwich 038,Greenwich,E09000011,6206 ,3170 ,3036 
E02000345,2007,Hackney 001,Hackney,E09000012,4866 ,2528 ,2338 
E02000346,2007,Hackney 002,Hackney,E09000012,4650 ,2373 ,2277 
E02000347,2007,Hackney 003,Hackney,E09000012,4790 ,2413 ,2377 
E02000348,2007,Hackney 004,Hackney,E09000012,4988 ,2484 ,2504 
E02000350,2007,Hackney 006,Hackney,E09000012,6558 ,3289 ,3269 
E02000351,2007,Hackney 007,Hackney,E09000012,6271 ,3166 ,3105 
E02000352,2007,Hackney 008,Hackney,E09000012,4320 ,2054 ,2266 
E02000353,2007,Hackney 009,Hackney,E09000012,5545 ,2702 ,2843 
E02000354,2007,Hackney 010,Hackney,E09000012,5947 ,2979 ,2968 
E02000355,2007,Hackney 011,Hackney,E09000012,5721 ,2870 ,2851 
E02000356,2007,Hackney 012,Hackney,E09000012,5221 ,2580 ,2641 
E02000357,2007,Hackney 013,Hackney,E09000012,3952 ,1858 ,2094 
E02000358,2007,Hackney 014,Hackney,E09000012,7765 ,3801 ,3964 
E02000359,2007,Hackney 015,Hackney,E09000012,4336 ,2047 ,2289 
E02000360,2007,Hackney 016,Hackney,E09000012,7346 ,3634 ,3712 
E02000361,2007,Hackney 017,Hackney,E09000012,5087 ,2577 ,2510 
E02000362,2007,Hackney 018,Hackney,E09000012,3955 ,1879 ,2076 
E02000363,2007,Hackney 019,Hackney,E09000012,6670 ,3216 ,3454 
E02000364,2007,Hackney 020,Hackney,E09000012,5893 ,2960 ,2933 
E02000365,2007,Hackney 021,Hackney,E09000012,8201 ,4143 ,4058 
E02000366,2007,Hackney 022,Hackney,E09000012,5529 ,2642 ,2887 
E02000367,2007,Hackney 023,Hackney,E09000012,6198 ,2948 ,3250 
E02000368,2007,Hackney 024,Hackney,E09000012,6484 ,3191 ,3293 
E02000369,2007,Hackney 025,Hackney,E09000012,7308 ,3655 ,3653 
E02000370,2007,Hackney 026,Hackney,E09000012,5024 ,2531 ,2493 
E02000371,2007,Hackney 027,Hackney,E09000012,7700 ,4168 ,3532 
E02006918,2007,Hackney 028,Hackney,E09000012,3838 ,1902 ,1936 
E02006921,2007,Hackney 029,Hackney,E09000012,4807 ,2338 ,2469 
E02000372,2007,Hammersmith and Fulham 001,Hammersmith and Fulham,E09000013,5901 ,2815 ,3086 
E02000373,2007,Hammersmith and Fulham 002,Hammersmith and Fulham,E09000013,4259 ,1887 ,2372 
E02000374,2007,Hammersmith and Fulham 003,Hammersmith and Fulham,E09000013,4442 ,2136 ,2306 
E02000375,2007,Hammersmith and Fulham 004,Hammersmith and Fulham,E09000013,5029 ,2509 ,2520 
E02000376,2007,Hammersmith and Fulham 005,Hammersmith and Fulham,E09000013,5217 ,2549 ,2668 
E02000377,2007,Hammersmith and Fulham 006,Hammersmith and Fulham,E09000013,5605 ,2656 ,2949 
E02000378,2007,Hammersmith and Fulham 007,Hammersmith and Fulham,E09000013,5010 ,2348 ,2662 
E02000379,2007,Hammersmith and Fulham 008,Hammersmith and Fulham,E09000013,4897 ,2516 ,2381 
E02000380,2007,Hammersmith and Fulham 009,Hammersmith and Fulham,E09000013,4478 ,2181 ,2297 
E02000381,2007,Hammersmith and Fulham 010,Hammersmith and Fulham,E09000013,5935 ,2888 ,3047 
E02000382,2007,Hammersmith and Fulham 011,Hammersmith and Fulham,E09000013,4496 ,2263 ,2233 
E02000383,2007,Hammersmith and Fulham 012,Hammersmith and Fulham,E09000013,7395 ,3782 ,3613 
E02000384,2007,Hammersmith and Fulham 013,Hammersmith and Fulham,E09000013,5626 ,2790 ,2836 
E02000385,2007,Hammersmith and Fulham 014,Hammersmith and Fulham,E09000013,5481 ,2837 ,2644 
E02000386,2007,Hammersmith and Fulham 015,Hammersmith and Fulham,E09000013,6144 ,3059 ,3085 
E02000387,2007,Hammersmith and Fulham 016,Hammersmith and Fulham,E09000013,4694 ,2270 ,2424 
E02000388,2007,Hammersmith and Fulham 017,Hammersmith and Fulham,E09000013,6338 ,3154 ,3184 
E02000389,2007,Hammersmith and Fulham 018,Hammersmith and Fulham,E09000013,6045 ,2890 ,3155 
E02000390,2007,Hammersmith and Fulham 019,Hammersmith and Fulham,E09000013,4948 ,2479 ,2469 
E02000391,2007,Hammersmith and Fulham 020,Hammersmith and Fulham,E09000013,5548 ,2644 ,2904 
E02000392,2007,Hammersmith and Fulham 021,Hammersmith and Fulham,E09000013,7350 ,3619 ,3731 
E02000393,2007,Hammersmith and Fulham 022,Hammersmith and Fulham,E09000013,4567 ,2227 ,2340 
E02000394,2007,Hammersmith and Fulham 023,Hammersmith and Fulham,E09000013,4558 ,2092 ,2466 
E02000395,2007,Hammersmith and Fulham 024,Hammersmith and Fulham,E09000013,4567 ,2256 ,2311 
E02000396,2007,Hammersmith and Fulham 025,Hammersmith and Fulham,E09000013,4371 ,1974 ,2397 
E02000397,2007,Haringey 001,Haringey,E09000014,5235 ,2652 ,2583 
E02000398,2007,Haringey 002,Haringey,E09000014,4644 ,2265 ,2379 
E02000400,2007,Haringey 004,Haringey,E09000014,4754 ,2324 ,2430 
E02000401,2007,Haringey 005,Haringey,E09000014,4184 ,1929 ,2255 
E02000402,2007,Haringey 006,Haringey,E09000014,4195 ,1967 ,2228 
E02000403,2007,Haringey 007,Haringey,E09000014,5072 ,2594 ,2478 
E02000404,2007,Haringey 008,Haringey,E09000014,4554 ,2182 ,2372 
E02000405,2007,Haringey 009,Haringey,E09000014,4397 ,2131 ,2266 
E02000406,2007,Haringey 010,Haringey,E09000014,4527 ,2130 ,2397 
E02000407,2007,Haringey 011,Haringey,E09000014,4539 ,2222 ,2317 
E02000408,2007,Haringey 012,Haringey,E09000014,4518 ,2230 ,2288 
E02000409,2007,Haringey 013,Haringey,E09000014,4200 ,2055 ,2145 
E02000410,2007,Haringey 014,Haringey,E09000014,4688 ,2281 ,2407 
E02000411,2007,Haringey 015,Haringey,E09000014,4788 ,2397 ,2391 
E02000412,2007,Haringey 016,Haringey,E09000014,4630 ,2365 ,2265 
E02000413,2007,Haringey 017,Haringey,E09000014,4576 ,2211 ,2365 
E02000414,2007,Haringey 018,Haringey,E09000014,4538 ,2232 ,2306 
E02000415,2007,Haringey 019,Haringey,E09000014,4491 ,2311 ,2180 
E02000416,2007,Haringey 020,Haringey,E09000014,4978 ,2453 ,2525 
E02000417,2007,Haringey 021,Haringey,E09000014,4690 ,2362 ,2328 
E02000418,2007,Haringey 022,Haringey,E09000014,3696 ,1706 ,1990 
E02000419,2007,Haringey 023,Haringey,E09000014,5626 ,2937 ,2689 
E02000420,2007,Haringey 024,Haringey,E09000014,4733 ,2329 ,2404 
E02000421,2007,Haringey 025,Haringey,E09000014,4681 ,2291 ,2390 
E02000422,2007,Haringey 026,Haringey,E09000014,5061 ,2607 ,2454 
E02000423,2007,Haringey 027,Haringey,E09000014,4897 ,2660 ,2237 
E02000424,2007,Haringey 028,Haringey,E09000014,5093 ,2527 ,2566 
E02000425,2007,Haringey 029,Haringey,E09000014,3650 ,1826 ,1824 
E02000426,2007,Haringey 030,Haringey,E09000014,4365 ,2101 ,2264 
E02000427,2007,Haringey 031,Haringey,E09000014,5052 ,2663 ,2389 
E02000428,2007,Haringey 032,Haringey,E09000014,4523 ,2316 ,2207 
E02000429,2007,Haringey 033,Haringey,E09000014,4914 ,2441 ,2473 
E02000430,2007,Haringey 034,Haringey,E09000014,5469 ,2757 ,2712 
E02000431,2007,Haringey 035,Haringey,E09000014,4872 ,2398 ,2474 
E02000432,2007,Haringey 036,Haringey,E09000014,4716 ,2317 ,2399 
E02006794,2007,Haringey 037,Haringey,E09000014,4404 ,2258 ,2146 
E02000433,2007,Harrow 001,Harrow,E09000015,4263 ,2004 ,2259 
E02000434,2007,Harrow 002,Harrow,E09000015,5029 ,2447 ,2582 
E02000435,2007,Harrow 003,Harrow,E09000015,4649 ,2225 ,2424 
E02000436,2007,Harrow 004,Harrow,E09000015,3657 ,1726 ,1931 
E02000437,2007,Harrow 005,Harrow,E09000015,5240 ,2544 ,2696 
E02000438,2007,Harrow 006,Harrow,E09000015,4677 ,2212 ,2465 
E02000439,2007,Harrow 007,Harrow,E09000015,5317 ,2682 ,2635 
E02000440,2007,Harrow 008,Harrow,E09000015,5951 ,2892 ,3059 
E02000441,2007,Harrow 009,Harrow,E09000015,4471 ,2136 ,2335 
E02000442,2007,Harrow 010,Harrow,E09000015,5637 ,2910 ,2727 
E02000443,2007,Harrow 011,Harrow,E09000015,6033 ,3058 ,2975 
E02000444,2007,Harrow 012,Harrow,E09000015,5258 ,2556 ,2702 
E02000445,2007,Harrow 013,Harrow,E09000015,6383 ,3183 ,3200 
E02000447,2007,Harrow 015,Harrow,E09000015,4574 ,2261 ,2313 
E02000448,2007,Harrow 016,Harrow,E09000015,4150 ,2061 ,2089 
E02000449,2007,Harrow 017,Harrow,E09000015,5302 ,2655 ,2647 
E02000451,2007,Harrow 019,Harrow,E09000015,4268 ,2172 ,2096 
E02000452,2007,Harrow 020,Harrow,E09000015,5367 ,2742 ,2625 
E02000453,2007,Harrow 021,Harrow,E09000015,4815 ,2412 ,2403 
E02000454,2007,Harrow 022,Harrow,E09000015,4453 ,2195 ,2258 
E02000455,2007,Harrow 023,Harrow,E09000015,5317 ,2660 ,2657 
E02000456,2007,Harrow 024,Harrow,E09000015,4601 ,2265 ,2336 
E02000457,2007,Harrow 025,Harrow,E09000015,4066 ,2063 ,2003 
E02000459,2007,Harrow 027,Harrow,E09000015,4929 ,2528 ,2401 
E02000460,2007,Harrow 028,Harrow,E09000015,4393 ,2184 ,2209 
E02000461,2007,Harrow 029,Harrow,E09000015,4559 ,2522 ,2037 
E02000462,2007,Harrow 030,Harrow,E09000015,4212 ,2145 ,2067 
E02000463,2007,Harrow 031,Harrow,E09000015,5628 ,2767 ,2861 
E02006795,2007,Harrow 032,Harrow,E09000015,5243 ,2630 ,2613 
E02006882,2007,Harrow 033,Harrow,E09000015,9384 ,4635 ,4749 
E02000464,2007,Havering 001,Havering,E09000016,3749 ,1861 ,1888 
E02000465,2007,Havering 002,Havering,E09000016,4957 ,2410 ,2547 
E02000466,2007,Havering 003,Havering,E09000016,4999 ,2372 ,2627 
E02000467,2007,Havering 004,Havering,E09000016,5879 ,2819 ,3060 
E02000468,2007,Havering 005,Havering,E09000016,4787 ,2279 ,2508 
E02000469,2007,Havering 006,Havering,E09000016,3896 ,1852 ,2044 
E02000470,2007,Havering 007,Havering,E09000016,5118 ,2532 ,2586 
E02000471,2007,Havering 008,Havering,E09000016,4723 ,2310 ,2413 
E02000472,2007,Havering 009,Havering,E09000016,5685 ,2829 ,2856 
E02000473,2007,Havering 010,Havering,E09000016,5965 ,2893 ,3072 
E02000474,2007,Havering 011,Havering,E09000016,4983 ,2462 ,2521 
E02000475,2007,Havering 012,Havering,E09000016,5785 ,2824 ,2961 
E02000476,2007,Havering 013,Havering,E09000016,4718 ,2368 ,2350 
E02000477,2007,Havering 014,Havering,E09000016,6030 ,2955 ,3075 
E02000478,2007,Havering 015,Havering,E09000016,3638 ,1824 ,1814 
E02000479,2007,Havering 016,Havering,E09000016,5478 ,2707 ,2771 
E02000480,2007,Havering 017,Havering,E09000016,6011 ,3030 ,2981 
E02000481,2007,Havering 018,Havering,E09000016,4523 ,2217 ,2306 
E02000482,2007,Havering 019,Havering,E09000016,3833 ,1911 ,1922 
E02000483,2007,Havering 020,Havering,E09000016,4692 ,2292 ,2400 
E02000484,2007,Havering 021,Havering,E09000016,5484 ,2731 ,2753 
E02000485,2007,Havering 022,Havering,E09000016,4882 ,2417 ,2465 
E02000486,2007,Havering 023,Havering,E09000016,4851 ,2412 ,2439 
E02000487,2007,Havering 024,Havering,E09000016,4912 ,2449 ,2463 
E02000488,2007,Havering 025,Havering,E09000016,4973 ,2473 ,2500 
E02000489,2007,Havering 026,Havering,E09000016,4899 ,2380 ,2519 
E02000490,2007,Havering 027,Havering,E09000016,4685 ,2276 ,2409 
E02000491,2007,Havering 028,Havering,E09000016,5543 ,2757 ,2786 
E02000492,2007,Havering 029,Havering,E09000016,3914 ,1944 ,1970 
E02000493,2007,Havering 030,Havering,E09000016,4071 ,1975 ,2096 
E02000494,2007,Hillingdon 001,Hillingdon,E09000017,4894 ,2367 ,2527 
E02000495,2007,Hillingdon 002,Hillingdon,E09000017,6058 ,2886 ,3172 
E02000496,2007,Hillingdon 003,Hillingdon,E09000017,4729 ,2329 ,2400 
E02000497,2007,Hillingdon 004,Hillingdon,E09000017,5138 ,2470 ,2668 
E02000498,2007,Hillingdon 005,Hillingdon,E09000017,3807 ,1821 ,1986 
E02000499,2007,Hillingdon 006,Hillingdon,E09000017,4742 ,2343 ,2399 
E02000500,2007,Hillingdon 007,Hillingdon,E09000017,4744 ,2384 ,2360 
E02000501,2007,Hillingdon 008,Hillingdon,E09000017,5228 ,2531 ,2697 
E02000502,2007,Hillingdon 009,Hillingdon,E09000017,4782 ,2381 ,2401 
E02000503,2007,Hillingdon 010,Hillingdon,E09000017,5782 ,2917 ,2865 
E02000504,2007,Hillingdon 011,Hillingdon,E09000017,4502 ,2251 ,2251 
E02000506,2007,Hillingdon 013,Hillingdon,E09000017,4808 ,2379 ,2429 
E02000507,2007,Hillingdon 014,Hillingdon,E09000017,5104 ,2561 ,2543 
E02000508,2007,Hillingdon 015,Hillingdon,E09000017,6053 ,3218 ,2835 
E02000509,2007,Hillingdon 016,Hillingdon,E09000017,7272 ,3783 ,3489 
E02000510,2007,Hillingdon 017,Hillingdon,E09000017,5596 ,2800 ,2796 
E02000511,2007,Hillingdon 018,Hillingdon,E09000017,5882 ,2860 ,3022 
E02000512,2007,Hillingdon 019,Hillingdon,E09000017,5126 ,2512 ,2614 
E02000513,2007,Hillingdon 020,Hillingdon,E09000017,5379 ,2519 ,2860 
E02000514,2007,Hillingdon 021,Hillingdon,E09000017,6161 ,3053 ,3108 
E02000515,2007,Hillingdon 022,Hillingdon,E09000017,6567 ,3337 ,3230 
E02000516,2007,Hillingdon 023,Hillingdon,E09000017,5340 ,2605 ,2735 
E02000517,2007,Hillingdon 024,Hillingdon,E09000017,4936 ,2393 ,2543 
E02000518,2007,Hillingdon 025,Hillingdon,E09000017,5401 ,2715 ,2686 
E02000519,2007,Hillingdon 026,Hillingdon,E09000017,5235 ,2582 ,2653 
E02000520,2007,Hillingdon 027,Hillingdon,E09000017,6720 ,3392 ,3328 
E02000521,2007,Hillingdon 028,Hillingdon,E09000017,5426 ,2690 ,2736 
E02000522,2007,Hillingdon 029,Hillingdon,E09000017,5154 ,2552 ,2602 
E02000523,2007,Hillingdon 030,Hillingdon,E09000017,5593 ,2847 ,2746 
E02000524,2007,Hillingdon 031,Hillingdon,E09000017,4506 ,2455 ,2051 
E02000525,2007,Hillingdon 032,Hillingdon,E09000017,5484 ,2775 ,2709 
E02006796,2007,Hillingdon 033,Hillingdon,E09000017,5460 ,2730 ,2730 
E02000526,2007,Hounslow 001,Hounslow,E09000018,6146 ,3051 ,3095 
E02000528,2007,Hounslow 003,Hounslow,E09000018,6632 ,3256 ,3376 
E02000529,2007,Hounslow 004,Hounslow,E09000018,5495 ,2764 ,2731 
E02000530,2007,Hounslow 005,Hounslow,E09000018,4176 ,2028 ,2148 
E02000531,2007,Hounslow 006,Hounslow,E09000018,6729 ,3288 ,3441 
E02000532,2007,Hounslow 007,Hounslow,E09000018,6584 ,3324 ,3260 
E02000533,2007,Hounslow 008,Hounslow,E09000018,6017 ,3150 ,2867 
E02000534,2007,Hounslow 009,Hounslow,E09000018,4783 ,2510 ,2273 
E02000535,2007,Hounslow 010,Hounslow,E09000018,6060 ,3103 ,2957 
E02000536,2007,Hounslow 011,Hounslow,E09000018,6027 ,3011 ,3016 
E02000537,2007,Hounslow 012,Hounslow,E09000018,6004 ,3122 ,2882 
E02000538,2007,Hounslow 013,Hounslow,E09000018,5528 ,2896 ,2632 
E02000539,2007,Hounslow 014,Hounslow,E09000018,6643 ,3218 ,3425 
E02000540,2007,Hounslow 015,Hounslow,E09000018,6235 ,3313 ,2922 
E02000541,2007,Hounslow 016,Hounslow,E09000018,5455 ,2747 ,2708 
E02000542,2007,Hounslow 017,Hounslow,E09000018,5799 ,2953 ,2846 
E02000543,2007,Hounslow 018,Hounslow,E09000018,6694 ,3405 ,3289 
E02000544,2007,Hounslow 019,Hounslow,E09000018,5459 ,2708 ,2751 
E02000545,2007,Hounslow 020,Hounslow,E09000018,5662 ,2728 ,2934 
E02000546,2007,Hounslow 021,Hounslow,E09000018,6269 ,3231 ,3038 
E02000547,2007,Hounslow 022,Hounslow,E09000018,5747 ,2843 ,2904 
E02000548,2007,Hounslow 023,Hounslow,E09000018,5341 ,2680 ,2661 
E02000549,2007,Hounslow 024,Hounslow,E09000018,6651 ,3361 ,3290 
E02000550,2007,Hounslow 025,Hounslow,E09000018,5918 ,2858 ,3060 
E02000551,2007,Hounslow 026,Hounslow,E09000018,5289 ,2538 ,2751 
E02000552,2007,Hounslow 027,Hounslow,E09000018,5294 ,2777 ,2517 
E02000553,2007,Hounslow 028,Hounslow,E09000018,4394 ,2145 ,2249 
E02006792,2007,Hounslow 029,Hounslow,E09000018,6317 ,3263 ,3054 
E02000554,2007,Islington 001,Islington,E09000019,6610 ,3095 ,3515 
E02000555,2007,Islington 002,Islington,E09000019,6432 ,2973 ,3459 
E02000556,2007,Islington 003,Islington,E09000019,7516 ,3679 ,3837 
E02000557,2007,Islington 004,Islington,E09000019,5801 ,2743 ,3058 
E02000558,2007,Islington 005,Islington,E09000019,5511 ,2623 ,2888 
E02000559,2007,Islington 006,Islington,E09000019,5792 ,2915 ,2877 
E02000560,2007,Islington 007,Islington,E09000019,5449 ,2725 ,2724 
E02000561,2007,Islington 008,Islington,E09000019,5174 ,2530 ,2644 
E02000562,2007,Islington 009,Islington,E09000019,5488 ,2583 ,2905 
E02000563,2007,Islington 010,Islington,E09000019,6007 ,2684 ,3323 
E02000564,2007,Islington 011,Islington,E09000019,6294 ,3097 ,3197 
E02000565,2007,Islington 012,Islington,E09000019,5469 ,2559 ,2910 
E02000566,2007,Islington 013,Islington,E09000019,5363 ,2530 ,2833 
E02000567,2007,Islington 014,Islington,E09000019,7331 ,3535 ,3796 
E02000568,2007,Islington 015,Islington,E09000019,6013 ,3200 ,2813 
E02000569,2007,Islington 016,Islington,E09000019,6859 ,3212 ,3647 
E02000570,2007,Islington 017,Islington,E09000019,5885 ,2813 ,3072 
E02000571,2007,Islington 018,Islington,E09000019,5495 ,2696 ,2799 
E02000572,2007,Islington 019,Islington,E09000019,5219 ,2510 ,2709 
E02000573,2007,Islington 020,Islington,E09000019,6454 ,3262 ,3192 
E02000574,2007,Islington 021,Islington,E09000019,6416 ,3190 ,3226 
E02000575,2007,Islington 022,Islington,E09000019,8531 ,4561 ,3970 
E02000576,2007,Islington 023,Islington,E09000019,5929 ,3091 ,2838 
E02000577,2007,Kensington and Chelsea 001,Kensington and Chelsea,E09000020,5128 ,2514 ,2614 
E02000578,2007,Kensington and Chelsea 002,Kensington and Chelsea,E09000020,4035 ,1889 ,2146 
E02000579,2007,Kensington and Chelsea 003,Kensington and Chelsea,E09000020,5672 ,2619 ,3053 
E02000580,2007,Kensington and Chelsea 004,Kensington and Chelsea,E09000020,6492 ,3196 ,3296 
E02000581,2007,Kensington and Chelsea 005,Kensington and Chelsea,E09000020,5000 ,2380 ,2620 
E02000582,2007,Kensington and Chelsea 006,Kensington and Chelsea,E09000020,6442 ,3293 ,3149 
E02000583,2007,Kensington and Chelsea 007,Kensington and Chelsea,E09000020,5396 ,2572 ,2824 
E02000584,2007,Kensington and Chelsea 008,Kensington and Chelsea,E09000020,6337 ,3116 ,3221 
E02000585,2007,Kensington and Chelsea 009,Kensington and Chelsea,E09000020,6567 ,3236 ,3331 
E02000586,2007,Kensington and Chelsea 010,Kensington and Chelsea,E09000020,6528 ,3228 ,3300 
E02000587,2007,Kensington and Chelsea 011,Kensington and Chelsea,E09000020,5501 ,2758 ,2743 
E02000588,2007,Kensington and Chelsea 012,Kensington and Chelsea,E09000020,6251 ,3090 ,3161 
E02000589,2007,Kensington and Chelsea 013,Kensington and Chelsea,E09000020,7204 ,3906 ,3298 
E02000590,2007,Kensington and Chelsea 014,Kensington and Chelsea,E09000020,5457 ,2496 ,2961 
E02000591,2007,Kensington and Chelsea 015,Kensington and Chelsea,E09000020,5376 ,2853 ,2523 
E02000592,2007,Kensington and Chelsea 016,Kensington and Chelsea,E09000020,5493 ,2776 ,2717 
E02000593,2007,Kensington and Chelsea 017,Kensington and Chelsea,E09000020,5814 ,3031 ,2783 
E02000594,2007,Kensington and Chelsea 018,Kensington and Chelsea,E09000020,5065 ,2415 ,2650 
E02000595,2007,Kensington and Chelsea 019,Kensington and Chelsea,E09000020,5258 ,2510 ,2748 
E02000596,2007,Kensington and Chelsea 020,Kensington and Chelsea,E09000020,5986 ,2945 ,3041 
E02000597,2007,Kensington and Chelsea 021,Kensington and Chelsea,E09000020,5225 ,2438 ,2787 
E02000598,2007,Kingston upon Thames 001,Kingston upon Thames,E09000021,4745 ,2269 ,2476 
E02000599,2007,Kingston upon Thames 002,Kingston upon Thames,E09000021,5034 ,2421 ,2613 
E02000600,2007,Kingston upon Thames 003,Kingston upon Thames,E09000021,6050 ,3030 ,3020 
E02000601,2007,Kingston upon Thames 004,Kingston upon Thames,E09000021,6601 ,3243 ,3358 
E02000602,2007,Kingston upon Thames 005,Kingston upon Thames,E09000021,6392 ,3222 ,3170 
E02000603,2007,Kingston upon Thames 006,Kingston upon Thames,E09000021,5248 ,2591 ,2657 
E02000604,2007,Kingston upon Thames 007,Kingston upon Thames,E09000021,5735 ,2862 ,2873 
E02000605,2007,Kingston upon Thames 008,Kingston upon Thames,E09000021,5264 ,2619 ,2645 
E02000606,2007,Kingston upon Thames 009,Kingston upon Thames,E09000021,7429 ,3875 ,3554 
E02000607,2007,Kingston upon Thames 010,Kingston upon Thames,E09000021,4892 ,2474 ,2418 
E02000608,2007,Kingston upon Thames 011,Kingston upon Thames,E09000021,5388 ,2811 ,2577 
E02000609,2007,Kingston upon Thames 012,Kingston upon Thames,E09000021,4596 ,2282 ,2314 
E02000610,2007,Kingston upon Thames 013,Kingston upon Thames,E09000021,5500 ,2878 ,2622 
E02000611,2007,Kingston upon Thames 014,Kingston upon Thames,E09000021,4765 ,2386 ,2379 
E02000612,2007,Kingston upon Thames 015,Kingston upon Thames,E09000021,5161 ,2522 ,2639 
E02000613,2007,Kingston upon Thames 016,Kingston upon Thames,E09000021,5134 ,2468 ,2666 
E02000614,2007,Kingston upon Thames 017,Kingston upon Thames,E09000021,5623 ,2764 ,2859 
E02000615,2007,Kingston upon Thames 018,Kingston upon Thames,E09000021,4831 ,2404 ,2427 
E02000616,2007,Kingston upon Thames 019,Kingston upon Thames,E09000021,4077 ,1989 ,2088 
E02000617,2007,Kingston upon Thames 020,Kingston upon Thames,E09000021,5501 ,2646 ,2855 
E02000619,2007,Lambeth 002,Lambeth,E09000022,5330 ,2710 ,2620 
E02000620,2007,Lambeth 003,Lambeth,E09000022,6192 ,3274 ,2918 
E02000621,2007,Lambeth 004,Lambeth,E09000022,7272 ,3957 ,3315 
E02000622,2007,Lambeth 005,Lambeth,E09000022,5946 ,3206 ,2740 
E02000623,2007,Lambeth 006,Lambeth,E09000022,5661 ,2939 ,2722 
E02000624,2007,Lambeth 007,Lambeth,E09000022,5735 ,2912 ,2823 
E02000625,2007,Lambeth 008,Lambeth,E09000022,6020 ,3081 ,2939 
E02000626,2007,Lambeth 009,Lambeth,E09000022,5839 ,2960 ,2879 
E02000627,2007,Lambeth 010,Lambeth,E09000022,6858 ,3537 ,3321 
E02000628,2007,Lambeth 011,Lambeth,E09000022,6696 ,3354 ,3342 
E02000629,2007,Lambeth 012,Lambeth,E09000022,6860 ,3584 ,3276 
E02000630,2007,Lambeth 013,Lambeth,E09000022,5361 ,2751 ,2610 
E02000631,2007,Lambeth 014,Lambeth,E09000022,6304 ,3222 ,3082 
E02000632,2007,Lambeth 015,Lambeth,E09000022,7633 ,3988 ,3645 
E02000633,2007,Lambeth 016,Lambeth,E09000022,6079 ,3126 ,2953 
E02000634,2007,Lambeth 017,Lambeth,E09000022,5035 ,2527 ,2508 
E02000635,2007,Lambeth 018,Lambeth,E09000022,6578 ,3431 ,3147 
E02000636,2007,Lambeth 019,Lambeth,E09000022,5513 ,2829 ,2684 
E02000637,2007,Lambeth 020,Lambeth,E09000022,6307 ,3318 ,2989 
E02000638,2007,Lambeth 021,Lambeth,E09000022,6695 ,3402 ,3293 
E02000639,2007,Lambeth 022,Lambeth,E09000022,5925 ,2873 ,3052 
E02000640,2007,Lambeth 023,Lambeth,E09000022,6599 ,3287 ,3312 
E02000641,2007,Lambeth 024,Lambeth,E09000022,5738 ,2736 ,3002 
E02000642,2007,Lambeth 025,Lambeth,E09000022,6579 ,3204 ,3375 
E02000643,2007,Lambeth 026,Lambeth,E09000022,5644 ,2780 ,2864 
E02000644,2007,Lambeth 027,Lambeth,E09000022,5663 ,2876 ,2787 
E02000645,2007,Lambeth 028,Lambeth,E09000022,5999 ,2979 ,3020 
E02000646,2007,Lambeth 029,Lambeth,E09000022,5930 ,3003 ,2927 
E02000647,2007,Lambeth 030,Lambeth,E09000022,5385 ,2691 ,2694 
E02000648,2007,Lambeth 031,Lambeth,E09000022,4597 ,2154 ,2443 
E02000649,2007,Lambeth 032,Lambeth,E09000022,7204 ,3623 ,3581 
E02000650,2007,Lambeth 033,Lambeth,E09000022,5340 ,2606 ,2734 
E02000651,2007,Lambeth 034,Lambeth,E09000022,5601 ,2852 ,2749 
E02000652,2007,Lambeth 035,Lambeth,E09000022,4521 ,2247 ,2274 
E02006801,2007,Lambeth 036,Lambeth,E09000022,6186 ,3260 ,2926 
E02000653,2007,Lewisham 001,Lewisham,E09000023,5252 ,2642 ,2610 
E02000654,2007,Lewisham 002,Lewisham,E09000023,5007 ,2435 ,2572 
E02000655,2007,Lewisham 003,Lewisham,E09000023,5728 ,2879 ,2849 
E02000657,2007,Lewisham 005,Lewisham,E09000023,6622 ,3295 ,3327 
E02000658,2007,Lewisham 006,Lewisham,E09000023,5837 ,3031 ,2806 
E02000659,2007,Lewisham 007,Lewisham,E09000023,5434 ,2648 ,2786 
E02000660,2007,Lewisham 008,Lewisham,E09000023,5675 ,2859 ,2816 
E02000661,2007,Lewisham 009,Lewisham,E09000023,4341 ,2219 ,2122 
E02000662,2007,Lewisham 010,Lewisham,E09000023,5629 ,2787 ,2842 
E02000663,2007,Lewisham 011,Lewisham,E09000023,5328 ,2795 ,2533 
E02000664,2007,Lewisham 012,Lewisham,E09000023,6480 ,3376 ,3104 
E02000665,2007,Lewisham 013,Lewisham,E09000023,5145 ,2582 ,2563 
E02000666,2007,Lewisham 014,Lewisham,E09000023,5126 ,2530 ,2596 
E02000667,2007,Lewisham 015,Lewisham,E09000023,4576 ,2257 ,2319 
E02000668,2007,Lewisham 016,Lewisham,E09000023,4322 ,2152 ,2170 
E02000669,2007,Lewisham 017,Lewisham,E09000023,5256 ,2680 ,2576 
E02000670,2007,Lewisham 018,Lewisham,E09000023,4262 ,2085 ,2177 
E02000671,2007,Lewisham 019,Lewisham,E09000023,5765 ,2856 ,2909 
E02000672,2007,Lewisham 020,Lewisham,E09000023,5301 ,2707 ,2594 
E02000673,2007,Lewisham 021,Lewisham,E09000023,5395 ,2686 ,2709 
E02000674,2007,Lewisham 022,Lewisham,E09000023,5302 ,2531 ,2771 
E02000675,2007,Lewisham 023,Lewisham,E09000023,5342 ,2606 ,2736 
E02000676,2007,Lewisham 024,Lewisham,E09000023,5212 ,2580 ,2632 
E02000677,2007,Lewisham 025,Lewisham,E09000023,4733 ,2384 ,2349 
E02000678,2007,Lewisham 026,Lewisham,E09000023,3655 ,1728 ,1927 
E02000679,2007,Lewisham 027,Lewisham,E09000023,5255 ,2602 ,2653 
E02000680,2007,Lewisham 028,Lewisham,E09000023,4400 ,2205 ,2195 
E02000681,2007,Lewisham 029,Lewisham,E09000023,5075 ,2367 ,2708 
E02000682,2007,Lewisham 030,Lewisham,E09000023,4938 ,2365 ,2573 
E02000683,2007,Lewisham 031,Lewisham,E09000023,4111 ,1960 ,2151 
E02000685,2007,Lewisham 033,Lewisham,E09000023,5067 ,2442 ,2625 
E02000686,2007,Lewisham 034,Lewisham,E09000023,4384 ,1960 ,2424 
E02000687,2007,Lewisham 035,Lewisham,E09000023,5441 ,2703 ,2738 
E02006783,2007,Lewisham 037,Lewisham,E09000023,4237 ,1916 ,2321 
E02006784,2007,Lewisham 038,Lewisham,E09000023,4487 ,2218 ,2269 
E02006798,2007,Lewisham 039,Lewisham,E09000023,5391 ,2720 ,2671 
E02000689,2007,Merton 001,Merton,E09000024,5241 ,2626 ,2615 
E02000690,2007,Merton 002,Merton,E09000024,3572 ,1832 ,1740 
E02000691,2007,Merton 003,Merton,E09000024,5479 ,2751 ,2728 
E02000692,2007,Merton 004,Merton,E09000024,5710 ,2997 ,2713 
E02000693,2007,Merton 005,Merton,E09000024,6875 ,3576 ,3299 
E02000694,2007,Merton 006,Merton,E09000024,6595 ,3279 ,3316 
E02000695,2007,Merton 007,Merton,E09000024,5748 ,3014 ,2734 
E02000696,2007,Merton 008,Merton,E09000024,5892 ,2951 ,2941 
E02000697,2007,Merton 009,Merton,E09000024,6582 ,3369 ,3213 
E02000698,2007,Merton 010,Merton,E09000024,5219 ,2581 ,2638 
E02000699,2007,Merton 011,Merton,E09000024,5844 ,2937 ,2907 
E02000700,2007,Merton 012,Merton,E09000024,5891 ,2866 ,3025 
E02000701,2007,Merton 013,Merton,E09000024,5355 ,2657 ,2698 
E02000702,2007,Merton 014,Merton,E09000024,4944 ,2353 ,2591 
E02000703,2007,Merton 015,Merton,E09000024,5322 ,2671 ,2651 
E02000704,2007,Merton 016,Merton,E09000024,5537 ,2760 ,2777 
E02000705,2007,Merton 017,Merton,E09000024,5116 ,2424 ,2692 
E02000706,2007,Merton 018,Merton,E09000024,5278 ,2475 ,2803 
E02000707,2007,Merton 019,Merton,E09000024,4639 ,2216 ,2423 
E02000708,2007,Merton 020,Merton,E09000024,5468 ,2729 ,2739 
E02000709,2007,Merton 021,Merton,E09000024,5008 ,2468 ,2540 
E02000710,2007,Merton 022,Merton,E09000024,5086 ,2472 ,2614 
E02000711,2007,Merton 023,Merton,E09000024,5267 ,2657 ,2610 
E02000712,2007,Merton 024,Merton,E09000024,5122 ,2504 ,2618 
E02000713,2007,Merton 025,Merton,E09000024,4750 ,2341 ,2409 
E02000714,2007,Newham 001,Newham,E09000025,4738 ,2419 ,2319 
E02000715,2007,Newham 002,Newham,E09000025,4123 ,2137 ,1986 
E02000716,2007,Newham 003,Newham,E09000025,4422 ,2328 ,2094 
E02000717,2007,Newham 004,Newham,E09000025,4687 ,2483 ,2204 
E02000718,2007,Newham 005,Newham,E09000025,3731 ,1811 ,1920 
E02000719,2007,Newham 006,Newham,E09000025,5033 ,2563 ,2470 
E02000720,2007,Newham 007,Newham,E09000025,4661 ,2527 ,2134 
E02000721,2007,Newham 008,Newham,E09000025,5837 ,3193 ,2644 
E02000722,2007,Newham 009,Newham,E09000025,5045 ,2596 ,2449 
E02000723,2007,Newham 010,Newham,E09000025,6322 ,3511 ,2811 
E02000724,2007,Newham 011,Newham,E09000025,5720 ,3193 ,2527 
E02000725,2007,Newham 012,Newham,E09000025,5319 ,2777 ,2542 
E02000726,2007,Newham 013,Newham,E09000025,5331 ,2847 ,2484 
E02000727,2007,Newham 014,Newham,E09000025,5029 ,2873 ,2156 
E02000728,2007,Newham 015,Newham,E09000025,5489 ,3126 ,2363 
E02000729,2007,Newham 016,Newham,E09000025,4320 ,2283 ,2037 
E02000730,2007,Newham 017,Newham,E09000025,5455 ,3016 ,2439 
E02000731,2007,Newham 018,Newham,E09000025,5949 ,3450 ,2499 
E02000732,2007,Newham 019,Newham,E09000025,4245 ,2280 ,1965 
E02000733,2007,Newham 020,Newham,E09000025,5861 ,2897 ,2964 
E02000734,2007,Newham 021,Newham,E09000025,4109 ,2055 ,2054 
E02000735,2007,Newham 022,Newham,E09000025,4405 ,2372 ,2033 
E02000736,2007,Newham 023,Newham,E09000025,4969 ,2543 ,2426 
E02000737,2007,Newham 024,Newham,E09000025,5288 ,2659 ,2629 
E02000738,2007,Newham 025,Newham,E09000025,4886 ,2536 ,2350 
E02000739,2007,Newham 026,Newham,E09000025,4155 ,2099 ,2056 
E02000740,2007,Newham 027,Newham,E09000025,4184 ,2035 ,2149 
E02000741,2007,Newham 028,Newham,E09000025,4740 ,2379 ,2361 
E02000742,2007,Newham 029,Newham,E09000025,4397 ,2204 ,2193 
E02000743,2007,Newham 030,Newham,E09000025,4422 ,2227 ,2195 
E02000744,2007,Newham 031,Newham,E09000025,4515 ,2266 ,2249 
E02000745,2007,Newham 032,Newham,E09000025,5242 ,2589 ,2653 
E02000746,2007,Newham 033,Newham,E09000025,4272 ,2001 ,2271 
E02000747,2007,Newham 034,Newham,E09000025,6106 ,3155 ,2951 
E02000748,2007,Newham 035,Newham,E09000025,4145 ,2033 ,2112 
E02000749,2007,Newham 036,Newham,E09000025,4770 ,2284 ,2486 
E02000750,2007,Newham 037,Newham,E09000025,6145 ,3157 ,2988 
E02000751,2007,Redbridge 001,Redbridge,E09000026,6485 ,3159 ,3326 
E02000752,2007,Redbridge 002,Redbridge,E09000026,3844 ,1836 ,2008 
E02000753,2007,Redbridge 003,Redbridge,E09000026,3688 ,1708 ,1980 
E02000754,2007,Redbridge 004,Redbridge,E09000026,4152 ,1998 ,2154 
E02000755,2007,Redbridge 005,Redbridge,E09000026,3468 ,1671 ,1797 
E02000756,2007,Redbridge 006,Redbridge,E09000026,8014 ,3899 ,4115 
E02000757,2007,Redbridge 007,Redbridge,E09000026,7243 ,3627 ,3616 
E02000758,2007,Redbridge 008,Redbridge,E09000026,3767 ,1824 ,1943 
E02000759,2007,Redbridge 009,Redbridge,E09000026,7777 ,3858 ,3919 
E02000760,2007,Redbridge 010,Redbridge,E09000026,3966 ,1886 ,2080 
E02000762,2007,Redbridge 012,Redbridge,E09000026,3964 ,1994 ,1970 
E02000763,2007,Redbridge 013,Redbridge,E09000026,4347 ,2117 ,2230 
E02000764,2007,Redbridge 014,Redbridge,E09000026,7693 ,3783 ,3910 
E02000765,2007,Redbridge 015,Redbridge,E09000026,3787 ,1879 ,1908 
E02000767,2007,Redbridge 017,Redbridge,E09000026,4630 ,2227 ,2403 
E02000768,2007,Redbridge 018,Redbridge,E09000026,3856 ,1863 ,1993 
E02000769,2007,Redbridge 019,Redbridge,E09000026,8564 ,4072 ,4492 
E02000770,2007,Redbridge 020,Redbridge,E09000026,4666 ,2373 ,2293 
E02000772,2007,Redbridge 022,Redbridge,E09000026,4647 ,2377 ,2270 
E02000773,2007,Redbridge 023,Redbridge,E09000026,5437 ,2700 ,2737 
E02000774,2007,Redbridge 024,Redbridge,E09000026,4516 ,2372 ,2144 
E02000776,2007,Redbridge 026,Redbridge,E09000026,4033 ,2038 ,1995 
E02000777,2007,Redbridge 027,Redbridge,E09000026,3971 ,1990 ,1981 
E02000779,2007,Redbridge 029,Redbridge,E09000026,4947 ,2631 ,2316 
E02000780,2007,Redbridge 030,Redbridge,E09000026,8215 ,4260 ,3955 
E02000781,2007,Redbridge 031,Redbridge,E09000026,8136 ,4148 ,3988 
E02000782,2007,Redbridge 032,Redbridge,E09000026,5362 ,2791 ,2571 
E02000783,2007,Redbridge 033,Redbridge,E09000026,4174 ,2066 ,2108 
E02006800,2007,Redbridge 034,Redbridge,E09000026,8449 ,4269 ,4180 
E02006924,2007,Redbridge 035,Redbridge,E09000026,8238 ,4245 ,3993 
E02006925,2007,Redbridge 036,Redbridge,E09000026,8116 ,3949 ,4167 
E02000784,2007,Richmond upon Thames 001,Richmond upon Thames,E09000027,7118 ,3517 ,3601 
E02000785,2007,Richmond upon Thames 002,Richmond upon Thames,E09000027,6903 ,3459 ,3444 
E02000786,2007,Richmond upon Thames 003,Richmond upon Thames,E09000027,7594 ,3763 ,3831 
E02000787,2007,Richmond upon Thames 004,Richmond upon Thames,E09000027,7263 ,3585 ,3678 
E02000788,2007,Richmond upon Thames 005,Richmond upon Thames,E09000027,5757 ,2855 ,2902 
E02000789,2007,Richmond upon Thames 006,Richmond upon Thames,E09000027,4400 ,2258 ,2142 
E02000790,2007,Richmond upon Thames 007,Richmond upon Thames,E09000027,4199 ,2140 ,2059 
E02000791,2007,Richmond upon Thames 008,Richmond upon Thames,E09000027,4664 ,2466 ,2198 
E02000792,2007,Richmond upon Thames 009,Richmond upon Thames,E09000027,4787 ,2405 ,2382 
E02000793,2007,Richmond upon Thames 010,Richmond upon Thames,E09000027,5189 ,2580 ,2609 
E02000794,2007,Richmond upon Thames 011,Richmond upon Thames,E09000027,4411 ,2159 ,2252 
E02000795,2007,Richmond upon Thames 012,Richmond upon Thames,E09000027,4199 ,2130 ,2069 
E02000796,2007,Richmond upon Thames 013,Richmond upon Thames,E09000027,6522 ,3265 ,3257 
E02000797,2007,Richmond upon Thames 014,Richmond upon Thames,E09000027,5169 ,2656 ,2513 
E02000798,2007,Richmond upon Thames 015,Richmond upon Thames,E09000027,7220 ,3529 ,3691 
E02000799,2007,Richmond upon Thames 016,Richmond upon Thames,E09000027,4491 ,2222 ,2269 
E02000800,2007,Richmond upon Thames 017,Richmond upon Thames,E09000027,3381 ,1616 ,1765 
E02000801,2007,Richmond upon Thames 018,Richmond upon Thames,E09000027,4549 ,2205 ,2344 
E02000802,2007,Richmond upon Thames 019,Richmond upon Thames,E09000027,4323 ,2124 ,2199 
E02000803,2007,Richmond upon Thames 020,Richmond upon Thames,E09000027,6127 ,2967 ,3160 
E02000804,2007,Richmond upon Thames 021,Richmond upon Thames,E09000027,4630 ,2303 ,2327 
E02000805,2007,Richmond upon Thames 022,Richmond upon Thames,E09000027,6621 ,3229 ,3392 
E02000806,2007,Richmond upon Thames 023,Richmond upon Thames,E09000027,6367 ,3071 ,3296 
E02000807,2007,Southwark 001,Southwark,E09000028,6419 ,3465 ,2954 
E02000808,2007,Southwark 002,Southwark,E09000028,6681 ,3598 ,3083 
E02000809,2007,Southwark 003,Southwark,E09000028,8725 ,4910 ,3815 
E02000810,2007,Southwark 004,Southwark,E09000028,5576 ,2872 ,2704 
E02000812,2007,Southwark 006,Southwark,E09000028,7225 ,3702 ,3523 
E02000813,2007,Southwark 007,Southwark,E09000028,5805 ,3008 ,2797 
E02000814,2007,Southwark 008,Southwark,E09000028,6872 ,3706 ,3166 
E02000815,2007,Southwark 009,Southwark,E09000028,6437 ,3418 ,3019 
E02000816,2007,Southwark 010,Southwark,E09000028,5423 ,2661 ,2762 
E02000817,2007,Southwark 011,Southwark,E09000028,4072 ,1981 ,2091 
E02000818,2007,Southwark 012,Southwark,E09000028,5906 ,2918 ,2988 
E02000819,2007,Southwark 013,Southwark,E09000028,5160 ,2577 ,2583 
E02000820,2007,Southwark 014,Southwark,E09000028,5728 ,2935 ,2793 
E02000821,2007,Southwark 015,Southwark,E09000028,5702 ,2786 ,2916 
E02000822,2007,Southwark 016,Southwark,E09000028,5725 ,2835 ,2890 
E02000823,2007,Southwark 017,Southwark,E09000028,5333 ,2622 ,2711 
E02000824,2007,Southwark 018,Southwark,E09000028,6016 ,2893 ,3123 
E02000825,2007,Southwark 019,Southwark,E09000028,5763 ,2746 ,3017 
E02000826,2007,Southwark 020,Southwark,E09000028,5819 ,2828 ,2991 
E02000827,2007,Southwark 021,Southwark,E09000028,7161 ,3552 ,3609 
E02000828,2007,Southwark 022,Southwark,E09000028,5616 ,2784 ,2832 
E02000829,2007,Southwark 023,Southwark,E09000028,6624 ,3458 ,3166 
E02000830,2007,Southwark 024,Southwark,E09000028,6299 ,3097 ,3202 
E02000831,2007,Southwark 025,Southwark,E09000028,6144 ,3079 ,3065 
E02000832,2007,Southwark 026,Southwark,E09000028,6343 ,2975 ,3368 
E02000833,2007,Southwark 027,Southwark,E09000028,5491 ,2515 ,2976 
E02000834,2007,Southwark 028,Southwark,E09000028,6964 ,3328 ,3636 
E02000835,2007,Southwark 029,Southwark,E09000028,4718 ,2326 ,2392 
E02000836,2007,Southwark 030,Southwark,E09000028,5921 ,2866 ,3055 
E02000837,2007,Southwark 031,Southwark,E09000028,5388 ,2597 ,2791 
E02000838,2007,Southwark 032,Southwark,E09000028,6243 ,3039 ,3204 
E02000839,2007,Southwark 033,Southwark,E09000028,5385 ,2649 ,2736 
E02006802,2007,Southwark 034,Southwark,E09000028,6109 ,3147 ,2962 
E02000840,2007,Sutton 001,Sutton,E09000029,5110 ,2390 ,2720 
E02000841,2007,Sutton 002,Sutton,E09000029,5387 ,2543 ,2844 
E02000842,2007,Sutton 003,Sutton,E09000029,4969 ,2493 ,2476 
E02000843,2007,Sutton 004,Sutton,E09000029,5366 ,2606 ,2760 
E02000844,2007,Sutton 005,Sutton,E09000029,4963 ,2396 ,2567 
E02000845,2007,Sutton 006,Sutton,E09000029,5317 ,2565 ,2752 
E02000846,2007,Sutton 007,Sutton,E09000029,4407 ,2190 ,2217 
E02000847,2007,Sutton 008,Sutton,E09000029,5521 ,2717 ,2804 
E02000848,2007,Sutton 009,Sutton,E09000029,5025 ,2483 ,2542 
E02000849,2007,Sutton 010,Sutton,E09000029,4944 ,2460 ,2484 
E02000850,2007,Sutton 011,Sutton,E09000029,6732 ,3342 ,3390 
E02000851,2007,Sutton 012,Sutton,E09000029,5463 ,2831 ,2632 
E02000852,2007,Sutton 013,Sutton,E09000029,5065 ,2534 ,2531 
E02000853,2007,Sutton 014,Sutton,E09000029,4979 ,2402 ,2577 
E02000854,2007,Sutton 015,Sutton,E09000029,4609 ,2251 ,2358 
E02000855,2007,Sutton 016,Sutton,E09000029,4804 ,2352 ,2452 
E02000856,2007,Sutton 017,Sutton,E09000029,5375 ,2674 ,2701 
E02000857,2007,Sutton 018,Sutton,E09000029,5364 ,2708 ,2656 
E02000858,2007,Sutton 019,Sutton,E09000029,4584 ,2175 ,2409 
E02000859,2007,Sutton 020,Sutton,E09000029,5291 ,2583 ,2708 
E02000860,2007,Sutton 021,Sutton,E09000029,5010 ,2522 ,2488 
E02000861,2007,Sutton 022,Sutton,E09000029,5048 ,2484 ,2564 
E02000863,2007,Sutton 024,Sutton,E09000029,4123 ,2017 ,2106 
E02006836,2007,Sutton 025,Sutton,E09000029,5168 ,2560 ,2608 
E02000864,2007,Tower Hamlets 001,Tower Hamlets,E09000030,4833 ,2315 ,2518 
E02000865,2007,Tower Hamlets 002,Tower Hamlets,E09000030,4733 ,2371 ,2362 
E02000866,2007,Tower Hamlets 003,Tower Hamlets,E09000030,6523 ,3256 ,3267 
E02000867,2007,Tower Hamlets 004,Tower Hamlets,E09000030,5730 ,2894 ,2836 
E02000868,2007,Tower Hamlets 005,Tower Hamlets,E09000030,4615 ,2328 ,2287 
E02000869,2007,Tower Hamlets 006,Tower Hamlets,E09000030,3876 ,2012 ,1864 
E02000870,2007,Tower Hamlets 007,Tower Hamlets,E09000030,4172 ,2073 ,2099 
E02000871,2007,Tower Hamlets 008,Tower Hamlets,E09000030,5051 ,2628 ,2423 
E02000872,2007,Tower Hamlets 009,Tower Hamlets,E09000030,4973 ,2644 ,2329 
E02000873,2007,Tower Hamlets 010,Tower Hamlets,E09000030,5446 ,2721 ,2725 
E02000874,2007,Tower Hamlets 011,Tower Hamlets,E09000030,4987 ,2565 ,2422 
E02000875,2007,Tower Hamlets 012,Tower Hamlets,E09000030,5743 ,2943 ,2800 
E02000876,2007,Tower Hamlets 013,Tower Hamlets,E09000030,5103 ,2715 ,2388 
E02000877,2007,Tower Hamlets 014,Tower Hamlets,E09000030,6135 ,3142 ,2993 
E02000878,2007,Tower Hamlets 015,Tower Hamlets,E09000030,7424 ,4054 ,3370 
E02000879,2007,Tower Hamlets 016,Tower Hamlets,E09000030,4684 ,2322 ,2362 
E02000880,2007,Tower Hamlets 017,Tower Hamlets,E09000030,3926 ,2044 ,1882 
E02000881,2007,Tower Hamlets 018,Tower Hamlets,E09000030,4105 ,2053 ,2052 
E02000882,2007,Tower Hamlets 019,Tower Hamlets,E09000030,5004 ,2492 ,2512 
E02000883,2007,Tower Hamlets 020,Tower Hamlets,E09000030,4719 ,2319 ,2400 
E02000884,2007,Tower Hamlets 021,Tower Hamlets,E09000030,6023 ,3422 ,2601 
E02000885,2007,Tower Hamlets 022,Tower Hamlets,E09000030,4254 ,2159 ,2095 
E02000886,2007,Tower Hamlets 023,Tower Hamlets,E09000030,5056 ,2761 ,2295 
E02000887,2007,Tower Hamlets 024,Tower Hamlets,E09000030,5265 ,2594 ,2671 
E02000888,2007,Tower Hamlets 025,Tower Hamlets,E09000030,4942 ,2678 ,2264 
E02000889,2007,Tower Hamlets 026,Tower Hamlets,E09000030,4788 ,2604 ,2184 
E02000890,2007,Tower Hamlets 027,Tower Hamlets,E09000030,4474 ,2456 ,2018 
E02000891,2007,Tower Hamlets 028,Tower Hamlets,E09000030,7630 ,4111 ,3519 
E02000893,2007,Tower Hamlets 030,Tower Hamlets,E09000030,4893 ,2560 ,2333 
E02000894,2007,Tower Hamlets 031,Tower Hamlets,E09000030,7312 ,3971 ,3341 
E02006853,2007,Tower Hamlets 032,Tower Hamlets,E09000030,3695 ,1963 ,1732 
E02006854,2007,Tower Hamlets 033,Tower Hamlets,E09000030,3203 ,1851 ,1352 
E02000895,2007,Waltham Forest 001,Waltham Forest,E09000031,4590 ,2191 ,2399 
E02000896,2007,Waltham Forest 002,Waltham Forest,E09000031,5406 ,2682 ,2724 
E02000897,2007,Waltham Forest 003,Waltham Forest,E09000031,4808 ,2272 ,2536 
E02000898,2007,Waltham Forest 004,Waltham Forest,E09000031,4777 ,2276 ,2501 
E02000899,2007,Waltham Forest 005,Waltham Forest,E09000031,5044 ,2457 ,2587 
E02000900,2007,Waltham Forest 006,Waltham Forest,E09000031,5146 ,2434 ,2712 
E02000901,2007,Waltham Forest 007,Waltham Forest,E09000031,5977 ,2898 ,3079 
E02000902,2007,Waltham Forest 008,Waltham Forest,E09000031,5145 ,2475 ,2670 
E02000903,2007,Waltham Forest 009,Waltham Forest,E09000031,5595 ,2698 ,2897 
E02000904,2007,Waltham Forest 010,Waltham Forest,E09000031,4826 ,2391 ,2435 
E02000905,2007,Waltham Forest 011,Waltham Forest,E09000031,5753 ,2862 ,2891 
E02000906,2007,Waltham Forest 012,Waltham Forest,E09000031,5878 ,2897 ,2981 
E02000907,2007,Waltham Forest 013,Waltham Forest,E09000031,5802 ,2784 ,3018 
E02000908,2007,Waltham Forest 014,Waltham Forest,E09000031,6520 ,3493 ,3027 
E02000909,2007,Waltham Forest 015,Waltham Forest,E09000031,5458 ,2709 ,2749 
E02000910,2007,Waltham Forest 016,Waltham Forest,E09000031,7014 ,3623 ,3391 
E02000911,2007,Waltham Forest 017,Waltham Forest,E09000031,6816 ,3371 ,3445 
E02000912,2007,Waltham Forest 018,Waltham Forest,E09000031,5586 ,2758 ,2828 
E02000913,2007,Waltham Forest 019,Waltham Forest,E09000031,5591 ,2794 ,2797 
E02000914,2007,Waltham Forest 020,Waltham Forest,E09000031,6446 ,3340 ,3106 
E02000915,2007,Waltham Forest 021,Waltham Forest,E09000031,5973 ,3100 ,2873 
E02000916,2007,Waltham Forest 022,Waltham Forest,E09000031,5781 ,2887 ,2894 
E02000917,2007,Waltham Forest 023,Waltham Forest,E09000031,5788 ,2941 ,2847 
E02000918,2007,Waltham Forest 024,Waltham Forest,E09000031,6116 ,3217 ,2899 
E02000919,2007,Waltham Forest 025,Waltham Forest,E09000031,6090 ,3216 ,2874 
E02000920,2007,Waltham Forest 026,Waltham Forest,E09000031,6154 ,3101 ,3053 
E02000921,2007,Waltham Forest 027,Waltham Forest,E09000031,7019 ,3518 ,3501 
E02000922,2007,Waltham Forest 028,Waltham Forest,E09000031,6795 ,3615 ,3180 
E02000923,2007,Wandsworth 001,Wandsworth,E09000032,5209 ,2658 ,2551 
E02000924,2007,Wandsworth 002,Wandsworth,E09000032,7129 ,3504 ,3625 
E02000925,2007,Wandsworth 003,Wandsworth,E09000032,5072 ,2466 ,2606 
E02000926,2007,Wandsworth 004,Wandsworth,E09000032,5919 ,2989 ,2930 
E02000927,2007,Wandsworth 005,Wandsworth,E09000032,5229 ,2575 ,2654 
E02000928,2007,Wandsworth 006,Wandsworth,E09000032,6176 ,2973 ,3203 
E02000929,2007,Wandsworth 007,Wandsworth,E09000032,4834 ,2259 ,2575 
E02000930,2007,Wandsworth 008,Wandsworth,E09000032,7487 ,3692 ,3795 
E02000931,2007,Wandsworth 009,Wandsworth,E09000032,6705 ,3479 ,3226 
E02000932,2007,Wandsworth 010,Wandsworth,E09000032,7742 ,3868 ,3874 
E02000933,2007,Wandsworth 011,Wandsworth,E09000032,6181 ,2962 ,3219 
E02000934,2007,Wandsworth 012,Wandsworth,E09000032,6945 ,3473 ,3472 
E02000935,2007,Wandsworth 013,Wandsworth,E09000032,4714 ,1983 ,2731 
E02000936,2007,Wandsworth 014,Wandsworth,E09000032,6361 ,3051 ,3310 
E02000937,2007,Wandsworth 015,Wandsworth,E09000032,5805 ,2933 ,2872 
E02000938,2007,Wandsworth 016,Wandsworth,E09000032,6396 ,3043 ,3353 
E02000939,2007,Wandsworth 017,Wandsworth,E09000032,5478 ,2752 ,2726 
E02000940,2007,Wandsworth 018,Wandsworth,E09000032,5431 ,2629 ,2802 
E02000941,2007,Wandsworth 019,Wandsworth,E09000032,7754 ,4017 ,3737 
E02000942,2007,Wandsworth 020,Wandsworth,E09000032,6788 ,3323 ,3465 
E02000943,2007,Wandsworth 021,Wandsworth,E09000032,6339 ,3184 ,3155 
E02000944,2007,Wandsworth 022,Wandsworth,E09000032,4664 ,2153 ,2511 
E02000945,2007,Wandsworth 023,Wandsworth,E09000032,5108 ,2312 ,2796 
E02000946,2007,Wandsworth 024,Wandsworth,E09000032,5962 ,3109 ,2853 
E02000947,2007,Wandsworth 025,Wandsworth,E09000032,6594 ,3141 ,3453 
E02000948,2007,Wandsworth 026,Wandsworth,E09000032,7971 ,3915 ,4056 
E02000949,2007,Wandsworth 027,Wandsworth,E09000032,7183 ,3502 ,3681 
E02000950,2007,Wandsworth 028,Wandsworth,E09000032,5541 ,2646 ,2895 
E02000951,2007,Wandsworth 029,Wandsworth,E09000032,5205 ,2566 ,2639 
E02000952,2007,Wandsworth 030,Wandsworth,E09000032,4596 ,2304 ,2292 
E02000953,2007,Wandsworth 031,Wandsworth,E09000032,4830 ,2217 ,2613 
E02000954,2007,Wandsworth 032,Wandsworth,E09000032,4488 ,2197 ,2291 
E02000955,2007,Wandsworth 033,Wandsworth,E09000032,4691 ,2234 ,2457 
E02000956,2007,Wandsworth 034,Wandsworth,E09000032,5375 ,2523 ,2852 
E02000957,2007,Wandsworth 035,Wandsworth,E09000032,7438 ,3697 ,3741 
E02000958,2007,Wandsworth 036,Wandsworth,E09000032,5671 ,2730 ,2941 
E02000959,2007,Wandsworth 037,Wandsworth,E09000032,5072 ,2490 ,2582 
E02000960,2007,Westminster 001,Westminster,E09000033,4721 ,2200 ,2521 
E02000961,2007,Westminster 002,Westminster,E09000033,6108 ,2877 ,3231 
E02000962,2007,Westminster 003,Westminster,E09000033,6158 ,3048 ,3110 
E02000963,2007,Westminster 004,Westminster,E09000033,6728 ,3038 ,3690 
E02000964,2007,Westminster 005,Westminster,E09000033,8445 ,3950 ,4495 
E02000965,2007,Westminster 006,Westminster,E09000033,7217 ,3481 ,3736 
E02000966,2007,Westminster 007,Westminster,E09000033,7243 ,3552 ,3691 
E02000967,2007,Westminster 008,Westminster,E09000033,6208 ,3267 ,2941 
E02000968,2007,Westminster 009,Westminster,E09000033,9717 ,4596 ,5121 
E02000969,2007,Westminster 010,Westminster,E09000033,6543 ,3065 ,3478 
E02000970,2007,Westminster 011,Westminster,E09000033,7592 ,3982 ,3610 
E02000971,2007,Westminster 012,Westminster,E09000033,7505 ,3940 ,3565 
E02000972,2007,Westminster 013,Westminster,E09000033,6771 ,3833 ,2938 
E02000973,2007,Westminster 014,Westminster,E09000033,7686 ,3889 ,3797 
E02000974,2007,Westminster 015,Westminster,E09000033,6945 ,3769 ,3176 
E02000975,2007,Westminster 016,Westminster,E09000033,7478 ,4060 ,3418 
E02000976,2007,Westminster 017,Westminster,E09000033,8771 ,4695 ,4076 
E02000977,2007,Westminster 018,Westminster,E09000033,6298 ,3654 ,2644 
E02000978,2007,Westminster 019,Westminster,E09000033,7957 ,4063 ,3894 
E02000979,2007,Westminster 020,Westminster,E09000033,6585 ,3448 ,3137 
E02000980,2007,Westminster 021,Westminster,E09000033,6234 ,3116 ,3118 
E02000981,2007,Westminster 022,Westminster,E09000033,7292 ,3828 ,3464 
E02000982,2007,Westminster 023,Westminster,E09000033,5781 ,3024 ,2757 
E02000983,2007,Westminster 024,Westminster,E09000033,6239 ,3134 ,3105 
E02000001,2008,City of London 001,City of London,E09000001,5907 ,3371 ,2536 
E02000002,2008,Barking and Dagenham 001,Barking and Dagenham,E09000002,3747 ,1754 ,1993 
E02000003,2008,Barking and Dagenham 002,Barking and Dagenham,E09000002,6274 ,3022 ,3252 
E02000004,2008,Barking and Dagenham 003,Barking and Dagenham,E09000002,3823 ,1847 ,1976 
E02000005,2008,Barking and Dagenham 004,Barking and Dagenham,E09000002,5126 ,2408 ,2718 
E02000007,2008,Barking and Dagenham 006,Barking and Dagenham,E09000002,4925 ,2277 ,2648 
E02000008,2008,Barking and Dagenham 007,Barking and Dagenham,E09000002,6798 ,3160 ,3638 
E02000009,2008,Barking and Dagenham 008,Barking and Dagenham,E09000002,5526 ,2763 ,2763 
E02000010,2008,Barking and Dagenham 009,Barking and Dagenham,E09000002,5057 ,2384 ,2673 
E02000011,2008,Barking and Dagenham 010,Barking and Dagenham,E09000002,3749 ,1840 ,1909 
E02000012,2008,Barking and Dagenham 011,Barking and Dagenham,E09000002,5719 ,2814 ,2905 
E02000013,2008,Barking and Dagenham 012,Barking and Dagenham,E09000002,4812 ,2260 ,2552 
E02000014,2008,Barking and Dagenham 013,Barking and Dagenham,E09000002,5618 ,2685 ,2933 
E02000015,2008,Barking and Dagenham 014,Barking and Dagenham,E09000002,4416 ,2058 ,2358 
E02000016,2008,Barking and Dagenham 015,Barking and Dagenham,E09000002,4042 ,2201 ,1841 
E02000017,2008,Barking and Dagenham 016,Barking and Dagenham,E09000002,5461 ,3000 ,2461 
E02000018,2008,Barking and Dagenham 017,Barking and Dagenham,E09000002,5202 ,2430 ,2772 
E02000019,2008,Barking and Dagenham 018,Barking and Dagenham,E09000002,4886 ,2286 ,2600 
E02000020,2008,Barking and Dagenham 019,Barking and Dagenham,E09000002,5262 ,2623 ,2639 
E02000021,2008,Barking and Dagenham 020,Barking and Dagenham,E09000002,4818 ,2318 ,2500 
E02000022,2008,Barking and Dagenham 021,Barking and Dagenham,E09000002,4972 ,2433 ,2539 
E02000023,2008,Barking and Dagenham 022,Barking and Dagenham,E09000002,3941 ,1903 ,2038 
E02006799,2008,Barking and Dagenham 023,Barking and Dagenham,E09000002,5800 ,2790 ,3010 
E02000024,2008,Barnet 001,Barnet,E09000003,6439 ,3085 ,3354 
E02000025,2008,Barnet 002,Barnet,E09000003,5568 ,2748 ,2820 
E02000026,2008,Barnet 003,Barnet,E09000003,4145 ,1989 ,2156 
E02000027,2008,Barnet 004,Barnet,E09000003,6244 ,2902 ,3342 
E02000028,2008,Barnet 005,Barnet,E09000003,3979 ,1980 ,1999 
E02000029,2008,Barnet 006,Barnet,E09000003,5933 ,2947 ,2986 
E02000030,2008,Barnet 007,Barnet,E09000003,5898 ,2834 ,3064 
E02000031,2008,Barnet 008,Barnet,E09000003,4615 ,2276 ,2339 
E02000032,2008,Barnet 009,Barnet,E09000003,5008 ,2417 ,2591 
E02000033,2008,Barnet 010,Barnet,E09000003,5451 ,2639 ,2812 
E02000034,2008,Barnet 011,Barnet,E09000003,5632 ,2716 ,2916 
E02000035,2008,Barnet 012,Barnet,E09000003,5734 ,2865 ,2869 
E02000036,2008,Barnet 013,Barnet,E09000003,6810 ,3222 ,3588 
E02000037,2008,Barnet 014,Barnet,E09000003,5971 ,2871 ,3100 
E02000038,2008,Barnet 015,Barnet,E09000003,7139 ,3647 ,3492 
E02000039,2008,Barnet 016,Barnet,E09000003,4341 ,2144 ,2197 
E02000040,2008,Barnet 017,Barnet,E09000003,4291 ,2085 ,2206 
E02000041,2008,Barnet 018,Barnet,E09000003,5591 ,2783 ,2808 
E02000042,2008,Barnet 019,Barnet,E09000003,7310 ,3750 ,3560 
E02000043,2008,Barnet 020,Barnet,E09000003,5033 ,2436 ,2597 
E02000044,2008,Barnet 021,Barnet,E09000003,5284 ,2450 ,2834 
E02000045,2008,Barnet 022,Barnet,E09000003,6720 ,3255 ,3465 
E02000046,2008,Barnet 023,Barnet,E09000003,4638 ,2292 ,2346 
E02000047,2008,Barnet 024,Barnet,E09000003,6707 ,3070 ,3637 
E02000048,2008,Barnet 025,Barnet,E09000003,5978 ,2899 ,3079 
E02000049,2008,Barnet 026,Barnet,E09000003,5342 ,2376 ,2966 
E02000050,2008,Barnet 027,Barnet,E09000003,6653 ,3200 ,3453 
E02000051,2008,Barnet 028,Barnet,E09000003,5149 ,2528 ,2621 
E02000052,2008,Barnet 029,Barnet,E09000003,6661 ,3156 ,3505 
E02000053,2008,Barnet 030,Barnet,E09000003,5339 ,2732 ,2607 
E02000054,2008,Barnet 031,Barnet,E09000003,4947 ,2459 ,2488 
E02000055,2008,Barnet 032,Barnet,E09000003,7035 ,3582 ,3453 
E02000056,2008,Barnet 033,Barnet,E09000003,5502 ,2538 ,2964 
E02000057,2008,Barnet 034,Barnet,E09000003,4393 ,2177 ,2216 
E02000058,2008,Barnet 035,Barnet,E09000003,5841 ,2673 ,3168 
E02000059,2008,Barnet 036,Barnet,E09000003,6707 ,3337 ,3370 
E02000060,2008,Barnet 037,Barnet,E09000003,5959 ,2920 ,3039 
E02000061,2008,Barnet 038,Barnet,E09000003,5043 ,2506 ,2537 
E02000062,2008,Barnet 039,Barnet,E09000003,3878 ,1799 ,2079 
E02000063,2008,Barnet 040,Barnet,E09000003,4105 ,1949 ,2156 
E02000064,2008,Barnet 041,Barnet,E09000003,3807 ,1712 ,2095 
E02000065,2008,Bexley 001,Bexley,E09000004,4509 ,2142 ,2367 
E02000066,2008,Bexley 002,Bexley,E09000004,6367 ,3031 ,3336 
E02000067,2008,Bexley 003,Bexley,E09000004,5523 ,2633 ,2890 
E02000068,2008,Bexley 004,Bexley,E09000004,4493 ,2214 ,2279 
E02000069,2008,Bexley 005,Bexley,E09000004,3853 ,1894 ,1959 
E02000070,2008,Bexley 006,Bexley,E09000004,5083 ,2471 ,2612 
E02000071,2008,Bexley 007,Bexley,E09000004,4894 ,2351 ,2543 
E02000072,2008,Bexley 008,Bexley,E09000004,7318 ,3444 ,3874 
E02000073,2008,Bexley 009,Bexley,E09000004,6686 ,3318 ,3368 
E02000074,2008,Bexley 010,Bexley,E09000004,4796 ,2278 ,2518 
E02000075,2008,Bexley 011,Bexley,E09000004,5063 ,2483 ,2580 
E02000077,2008,Bexley 013,Bexley,E09000004,4916 ,2386 ,2530 
E02000078,2008,Bexley 014,Bexley,E09000004,5093 ,2492 ,2601 
E02000079,2008,Bexley 015,Bexley,E09000004,5041 ,2488 ,2553 
E02000080,2008,Bexley 016,Bexley,E09000004,5937 ,2935 ,3002 
E02000081,2008,Bexley 017,Bexley,E09000004,4749 ,2337 ,2412 
E02000082,2008,Bexley 018,Bexley,E09000004,5735 ,2885 ,2850 
E02000083,2008,Bexley 019,Bexley,E09000004,6083 ,2974 ,3109 
E02000084,2008,Bexley 020,Bexley,E09000004,6839 ,3361 ,3478 
E02000085,2008,Bexley 021,Bexley,E09000004,5025 ,2451 ,2574 
E02000086,2008,Bexley 022,Bexley,E09000004,4847 ,2336 ,2511 
E02000087,2008,Bexley 023,Bexley,E09000004,4510 ,2265 ,2245 
E02000088,2008,Bexley 024,Bexley,E09000004,4920 ,2435 ,2485 
E02000089,2008,Bexley 025,Bexley,E09000004,4868 ,2336 ,2532 
E02000090,2008,Bexley 026,Bexley,E09000004,5345 ,2564 ,2781 
E02000091,2008,Bexley 027,Bexley,E09000004,5899 ,2824 ,3075 
E02000092,2008,Bexley 028,Bexley,E09000004,3801 ,1781 ,2020 
E02006785,2008,Bexley 029,Bexley,E09000004,3966 ,1941 ,2025 
E02000093,2008,Brent 001,Brent,E09000005,7094 ,3537 ,3557 
E02000094,2008,Brent 002,Brent,E09000005,5397 ,2664 ,2733 
E02000095,2008,Brent 003,Brent,E09000005,6220 ,3129 ,3091 
E02000096,2008,Brent 004,Brent,E09000005,4747 ,2365 ,2382 
E02000097,2008,Brent 005,Brent,E09000005,5539 ,2790 ,2749 
E02000098,2008,Brent 006,Brent,E09000005,4905 ,2480 ,2425 
E02000099,2008,Brent 007,Brent,E09000005,5265 ,2650 ,2615 
E02000100,2008,Brent 008,Brent,E09000005,5562 ,2654 ,2908 
E02000101,2008,Brent 009,Brent,E09000005,5745 ,2798 ,2947 
E02000102,2008,Brent 010,Brent,E09000005,4952 ,2492 ,2460 
E02000103,2008,Brent 011,Brent,E09000005,5471 ,2772 ,2699 
E02000104,2008,Brent 012,Brent,E09000005,4291 ,2244 ,2047 
E02000105,2008,Brent 013,Brent,E09000005,5624 ,2914 ,2710 
E02000106,2008,Brent 014,Brent,E09000005,6940 ,3569 ,3371 
E02000107,2008,Brent 015,Brent,E09000005,7931 ,4181 ,3750 
E02000108,2008,Brent 016,Brent,E09000005,4296 ,2257 ,2039 
E02000109,2008,Brent 017,Brent,E09000005,6070 ,3212 ,2858 
E02000110,2008,Brent 018,Brent,E09000005,6013 ,3062 ,2951 
E02000111,2008,Brent 019,Brent,E09000005,5907 ,3026 ,2881 
E02000112,2008,Brent 020,Brent,E09000005,5944 ,3148 ,2796 
E02000113,2008,Brent 021,Brent,E09000005,5906 ,2748 ,3158 
E02000114,2008,Brent 022,Brent,E09000005,6544 ,3355 ,3189 
E02000115,2008,Brent 023,Brent,E09000005,6090 ,3092 ,2998 
E02000116,2008,Brent 024,Brent,E09000005,5251 ,2664 ,2587 
E02000117,2008,Brent 025,Brent,E09000005,7608 ,3733 ,3875 
E02000118,2008,Brent 026,Brent,E09000005,6072 ,3153 ,2919 
E02000119,2008,Brent 027,Brent,E09000005,4284 ,2065 ,2219 
E02000120,2008,Brent 028,Brent,E09000005,6660 ,3311 ,3349 
E02000121,2008,Brent 029,Brent,E09000005,5856 ,3033 ,2823 
E02000122,2008,Brent 030,Brent,E09000005,5304 ,2555 ,2749 
E02000123,2008,Brent 031,Brent,E09000005,9748 ,5042 ,4706 
E02000124,2008,Brent 032,Brent,E09000005,7208 ,3597 ,3611 
E02000125,2008,Brent 033,Brent,E09000005,7406 ,3704 ,3702 
E02000126,2008,Brent 034,Brent,E09000005,4908 ,2367 ,2541 
E02000127,2008,Bromley 001,Bromley,E09000006,5503 ,2527 ,2976 
E02000128,2008,Bromley 002,Bromley,E09000006,4756 ,2272 ,2484 
E02000130,2008,Bromley 004,Bromley,E09000006,5376 ,2545 ,2831 
E02000131,2008,Bromley 005,Bromley,E09000006,6502 ,3199 ,3303 
E02000132,2008,Bromley 006,Bromley,E09000006,5900 ,2923 ,2977 
E02000133,2008,Bromley 007,Bromley,E09000006,5862 ,2893 ,2969 
E02000134,2008,Bromley 008,Bromley,E09000006,7262 ,3589 ,3673 
E02000135,2008,Bromley 009,Bromley,E09000006,6563 ,3089 ,3474 
E02000136,2008,Bromley 010,Bromley,E09000006,3393 ,1649 ,1744 
E02000137,2008,Bromley 011,Bromley,E09000006,4973 ,2424 ,2549 
E02000138,2008,Bromley 012,Bromley,E09000006,5054 ,2554 ,2500 
E02000139,2008,Bromley 013,Bromley,E09000006,4945 ,2389 ,2556 
E02000140,2008,Bromley 014,Bromley,E09000006,4714 ,2191 ,2523 
E02000141,2008,Bromley 015,Bromley,E09000006,4957 ,2426 ,2531 
E02000142,2008,Bromley 016,Bromley,E09000006,5373 ,2644 ,2729 
E02000144,2008,Bromley 018,Bromley,E09000006,5818 ,2927 ,2891 
E02000145,2008,Bromley 019,Bromley,E09000006,4875 ,2281 ,2594 
E02000146,2008,Bromley 020,Bromley,E09000006,5234 ,2569 ,2665 
E02000147,2008,Bromley 021,Bromley,E09000006,4798 ,2347 ,2451 
E02000148,2008,Bromley 022,Bromley,E09000006,3964 ,1896 ,2068 
E02000149,2008,Bromley 023,Bromley,E09000006,4933 ,2344 ,2589 
E02000150,2008,Bromley 024,Bromley,E09000006,5210 ,2511 ,2699 
E02000151,2008,Bromley 025,Bromley,E09000006,4695 ,2260 ,2435 
E02000152,2008,Bromley 026,Bromley,E09000006,4086 ,1924 ,2162 
E02000153,2008,Bromley 027,Bromley,E09000006,4960 ,2385 ,2575 
E02000154,2008,Bromley 028,Bromley,E09000006,5048 ,2528 ,2520 
E02000155,2008,Bromley 029,Bromley,E09000006,4285 ,2106 ,2179 
E02000156,2008,Bromley 030,Bromley,E09000006,7450 ,3677 ,3773 
E02000157,2008,Bromley 031,Bromley,E09000006,4699 ,2301 ,2398 
E02000158,2008,Bromley 032,Bromley,E09000006,4499 ,2128 ,2371 
E02000159,2008,Bromley 033,Bromley,E09000006,4141 ,2017 ,2124 
E02000160,2008,Bromley 034,Bromley,E09000006,4928 ,2453 ,2475 
E02000161,2008,Bromley 035,Bromley,E09000006,5259 ,2566 ,2693 
E02000162,2008,Bromley 036,Bromley,E09000006,3958 ,1854 ,2104 
E02000163,2008,Bromley 037,Bromley,E09000006,4929 ,2437 ,2492 
E02000165,2008,Bromley 039,Bromley,E09000006,4909 ,2426 ,2483 
E02006782,2008,Bromley 040,Bromley,E09000006,4873 ,2300 ,2573 
E02006787,2008,Bromley 041,Bromley,E09000006,4892 ,2338 ,2554 
E02006789,2008,Bromley 042,Bromley,E09000006,4012 ,1956 ,2056 
E02000166,2008,Camden 001,Camden,E09000007,5442 ,2513 ,2929 
E02000167,2008,Camden 002,Camden,E09000007,5307 ,2586 ,2721 
E02000168,2008,Camden 003,Camden,E09000007,5747 ,2755 ,2992 
E02000169,2008,Camden 004,Camden,E09000007,4690 ,2180 ,2510 
E02000170,2008,Camden 005,Camden,E09000007,6110 ,3032 ,3078 
E02000171,2008,Camden 006,Camden,E09000007,5371 ,2571 ,2800 
E02000172,2008,Camden 007,Camden,E09000007,6631 ,3258 ,3373 
E02000173,2008,Camden 008,Camden,E09000007,5188 ,2505 ,2683 
E02000174,2008,Camden 009,Camden,E09000007,6236 ,2960 ,3276 
E02000175,2008,Camden 010,Camden,E09000007,6525 ,3166 ,3359 
E02000176,2008,Camden 011,Camden,E09000007,4546 ,2182 ,2364 
E02000177,2008,Camden 012,Camden,E09000007,5966 ,2758 ,3208 
E02000178,2008,Camden 013,Camden,E09000007,6826 ,3416 ,3410 
E02000179,2008,Camden 014,Camden,E09000007,4073 ,1916 ,2157 
E02000180,2008,Camden 015,Camden,E09000007,5924 ,2922 ,3002 
E02000181,2008,Camden 016,Camden,E09000007,5794 ,2757 ,3037 
E02000182,2008,Camden 017,Camden,E09000007,4114 ,1845 ,2269 
E02000183,2008,Camden 018,Camden,E09000007,5341 ,2609 ,2732 
E02000184,2008,Camden 019,Camden,E09000007,6204 ,3028 ,3176 
E02000185,2008,Camden 020,Camden,E09000007,5624 ,2689 ,2935 
E02000186,2008,Camden 021,Camden,E09000007,4963 ,2631 ,2332 
E02000187,2008,Camden 022,Camden,E09000007,5265 ,2443 ,2822 
E02000188,2008,Camden 023,Camden,E09000007,5813 ,3032 ,2781 
E02000189,2008,Camden 024,Camden,E09000007,4678 ,2437 ,2241 
E02000190,2008,Camden 025,Camden,E09000007,6032 ,3038 ,2994 
E02000191,2008,Camden 026,Camden,E09000007,5968 ,3194 ,2774 
E02000192,2008,Camden 027,Camden,E09000007,4970 ,2693 ,2277 
E02000193,2008,Camden 028,Camden,E09000007,6029 ,3181 ,2848 
E02000194,2008,Croydon 001,Croydon,E09000008,5725 ,2871 ,2854 
E02000195,2008,Croydon 002,Croydon,E09000008,5761 ,2878 ,2883 
E02000196,2008,Croydon 003,Croydon,E09000008,4694 ,2274 ,2420 
E02000197,2008,Croydon 004,Croydon,E09000008,5745 ,2774 ,2971 
E02000198,2008,Croydon 005,Croydon,E09000008,5289 ,2480 ,2809 
E02000199,2008,Croydon 006,Croydon,E09000008,5470 ,2594 ,2876 
E02000200,2008,Croydon 007,Croydon,E09000008,5838 ,2841 ,2997 
E02000201,2008,Croydon 008,Croydon,E09000008,5496 ,2658 ,2838 
E02000202,2008,Croydon 009,Croydon,E09000008,5854 ,2889 ,2965 
E02000203,2008,Croydon 010,Croydon,E09000008,5166 ,2493 ,2673 
E02000204,2008,Croydon 011,Croydon,E09000008,6489 ,3120 ,3369 
E02000206,2008,Croydon 013,Croydon,E09000008,6271 ,2984 ,3287 
E02000207,2008,Croydon 014,Croydon,E09000008,5692 ,2686 ,3006 
E02000208,2008,Croydon 015,Croydon,E09000008,5665 ,2800 ,2865 
E02000209,2008,Croydon 016,Croydon,E09000008,5503 ,2641 ,2862 
E02000210,2008,Croydon 017,Croydon,E09000008,5635 ,2706 ,2929 
E02000211,2008,Croydon 018,Croydon,E09000008,5109 ,2540 ,2569 
E02000212,2008,Croydon 019,Croydon,E09000008,5208 ,2519 ,2689 
E02000213,2008,Croydon 020,Croydon,E09000008,6345 ,3239 ,3106 
E02000214,2008,Croydon 021,Croydon,E09000008,4054 ,2055 ,1999 
E02000215,2008,Croydon 022,Croydon,E09000008,7289 ,3828 ,3461 
E02000216,2008,Croydon 023,Croydon,E09000008,4385 ,2322 ,2063 
E02000217,2008,Croydon 024,Croydon,E09000008,6049 ,2991 ,3058 
E02000218,2008,Croydon 025,Croydon,E09000008,4029 ,1829 ,2200 
E02000219,2008,Croydon 026,Croydon,E09000008,4766 ,2326 ,2440 
E02000220,2008,Croydon 027,Croydon,E09000008,6711 ,3564 ,3147 
E02000221,2008,Croydon 028,Croydon,E09000008,5915 ,2775 ,3140 
E02000222,2008,Croydon 029,Croydon,E09000008,5529 ,2789 ,2740 
E02000223,2008,Croydon 030,Croydon,E09000008,4743 ,2057 ,2686 
E02000224,2008,Croydon 031,Croydon,E09000008,5352 ,2719 ,2633 
E02000225,2008,Croydon 032,Croydon,E09000008,4694 ,2167 ,2527 
E02000226,2008,Croydon 033,Croydon,E09000008,4950 ,2473 ,2477 
E02000227,2008,Croydon 034,Croydon,E09000008,7672 ,3632 ,4040 
E02000228,2008,Croydon 035,Croydon,E09000008,4630 ,2271 ,2359 
E02000229,2008,Croydon 036,Croydon,E09000008,3602 ,1647 ,1955 
E02000230,2008,Croydon 037,Croydon,E09000008,6327 ,3199 ,3128 
E02000231,2008,Croydon 038,Croydon,E09000008,4990 ,2507 ,2483 
E02000232,2008,Croydon 039,Croydon,E09000008,3797 ,1825 ,1972 
E02000233,2008,Croydon 040,Croydon,E09000008,3817 ,1854 ,1963 
E02000234,2008,Croydon 041,Croydon,E09000008,5187 ,2513 ,2674 
E02000235,2008,Croydon 042,Croydon,E09000008,4479 ,2151 ,2328 
E02000236,2008,Croydon 043,Croydon,E09000008,4962 ,2451 ,2511 
E02000237,2008,Croydon 044,Croydon,E09000008,4582 ,2187 ,2395 
E02006788,2008,Croydon 045,Croydon,E09000008,4919 ,2180 ,2739 
E02000238,2008,Ealing 001,Ealing,E09000009,6527 ,3397 ,3130 
E02000239,2008,Ealing 002,Ealing,E09000009,6609 ,3569 ,3040 
E02000240,2008,Ealing 003,Ealing,E09000009,6579 ,3179 ,3400 
E02000241,2008,Ealing 004,Ealing,E09000009,4504 ,2308 ,2196 
E02000242,2008,Ealing 005,Ealing,E09000009,4740 ,2546 ,2194 
E02000243,2008,Ealing 006,Ealing,E09000009,5649 ,2812 ,2837 
E02000244,2008,Ealing 007,Ealing,E09000009,5345 ,2890 ,2455 
E02000245,2008,Ealing 008,Ealing,E09000009,5539 ,2693 ,2846 
E02000246,2008,Ealing 009,Ealing,E09000009,5835 ,2911 ,2924 
E02000247,2008,Ealing 010,Ealing,E09000009,6001 ,2804 ,3197 
E02000248,2008,Ealing 011,Ealing,E09000009,5157 ,2695 ,2462 
E02000249,2008,Ealing 012,Ealing,E09000009,4718 ,2333 ,2385 
E02000250,2008,Ealing 013,Ealing,E09000009,4257 ,2113 ,2144 
E02000251,2008,Ealing 014,Ealing,E09000009,5300 ,2659 ,2641 
E02000252,2008,Ealing 015,Ealing,E09000009,6974 ,3826 ,3148 
E02000253,2008,Ealing 016,Ealing,E09000009,6128 ,2845 ,3283 
E02000254,2008,Ealing 017,Ealing,E09000009,5870 ,2937 ,2933 
E02000255,2008,Ealing 018,Ealing,E09000009,6242 ,2956 ,3286 
E02000256,2008,Ealing 019,Ealing,E09000009,5734 ,2868 ,2866 
E02000257,2008,Ealing 020,Ealing,E09000009,9267 ,4728 ,4539 
E02000258,2008,Ealing 021,Ealing,E09000009,4701 ,2436 ,2265 
E02000259,2008,Ealing 022,Ealing,E09000009,4260 ,2075 ,2185 
E02000260,2008,Ealing 023,Ealing,E09000009,5397 ,2711 ,2686 
E02000261,2008,Ealing 024,Ealing,E09000009,7518 ,3825 ,3693 
E02000262,2008,Ealing 025,Ealing,E09000009,6024 ,3064 ,2960 
E02000263,2008,Ealing 026,Ealing,E09000009,7724 ,4170 ,3554 
E02000264,2008,Ealing 027,Ealing,E09000009,5996 ,3073 ,2923 
E02000265,2008,Ealing 028,Ealing,E09000009,7404 ,3647 ,3757 
E02000266,2008,Ealing 029,Ealing,E09000009,7669 ,3739 ,3930 
E02000267,2008,Ealing 030,Ealing,E09000009,4718 ,2285 ,2433 
E02000268,2008,Ealing 031,Ealing,E09000009,6627 ,3287 ,3340 
E02000269,2008,Ealing 032,Ealing,E09000009,5443 ,2619 ,2824 
E02000270,2008,Ealing 033,Ealing,E09000009,5738 ,2880 ,2858 
E02000271,2008,Ealing 034,Ealing,E09000009,4681 ,2307 ,2374 
E02000272,2008,Ealing 035,Ealing,E09000009,4578 ,2260 ,2318 
E02000274,2008,Ealing 037,Ealing,E09000009,7150 ,3615 ,3535 
E02000275,2008,Ealing 038,Ealing,E09000009,4226 ,2095 ,2131 
E02000276,2008,Ealing 039,Ealing,E09000009,4967 ,2580 ,2387 
E02006791,2008,Ealing 040,Ealing,E09000009,5154 ,2518 ,2636 
E02000277,2008,Enfield 001,Enfield,E09000010,4493 ,2127 ,2366 
E02000278,2008,Enfield 002,Enfield,E09000010,5139 ,2411 ,2728 
E02000279,2008,Enfield 003,Enfield,E09000010,6860 ,3170 ,3690 
E02000280,2008,Enfield 004,Enfield,E09000010,5337 ,2531 ,2806 
E02000281,2008,Enfield 005,Enfield,E09000010,5432 ,2578 ,2854 
E02000282,2008,Enfield 006,Enfield,E09000010,5462 ,2587 ,2875 
E02000283,2008,Enfield 007,Enfield,E09000010,5199 ,2489 ,2710 
E02000284,2008,Enfield 008,Enfield,E09000010,5244 ,2524 ,2720 
E02000285,2008,Enfield 009,Enfield,E09000010,4176 ,2032 ,2144 
E02000286,2008,Enfield 010,Enfield,E09000010,5332 ,2726 ,2606 
E02000287,2008,Enfield 011,Enfield,E09000010,4382 ,2222 ,2160 
E02000288,2008,Enfield 012,Enfield,E09000010,6279 ,3052 ,3227 
E02000289,2008,Enfield 013,Enfield,E09000010,4101 ,1992 ,2109 
E02000290,2008,Enfield 014,Enfield,E09000010,4608 ,2202 ,2406 
E02000291,2008,Enfield 015,Enfield,E09000010,5653 ,2828 ,2825 
E02000292,2008,Enfield 016,Enfield,E09000010,6169 ,3011 ,3158 
E02000293,2008,Enfield 017,Enfield,E09000010,3875 ,1932 ,1943 
E02000294,2008,Enfield 018,Enfield,E09000010,5534 ,2651 ,2883 
E02000295,2008,Enfield 019,Enfield,E09000010,5492 ,2666 ,2826 
E02000296,2008,Enfield 020,Enfield,E09000010,6085 ,2954 ,3131 
E02000297,2008,Enfield 021,Enfield,E09000010,6161 ,3077 ,3084 
E02000298,2008,Enfield 022,Enfield,E09000010,5266 ,2635 ,2631 
E02000299,2008,Enfield 023,Enfield,E09000010,5627 ,2729 ,2898 
E02000300,2008,Enfield 024,Enfield,E09000010,5263 ,2501 ,2762 
E02000301,2008,Enfield 025,Enfield,E09000010,6057 ,2870 ,3187 
E02000302,2008,Enfield 026,Enfield,E09000010,5380 ,2661 ,2719 
E02000303,2008,Enfield 027,Enfield,E09000010,5075 ,2380 ,2695 
E02000304,2008,Enfield 028,Enfield,E09000010,5224 ,2576 ,2648 
E02000305,2008,Enfield 029,Enfield,E09000010,5861 ,3018 ,2843 
E02000306,2008,Enfield 030,Enfield,E09000010,5192 ,2364 ,2828 
E02000307,2008,Enfield 031,Enfield,E09000010,6257 ,3025 ,3232 
E02000308,2008,Enfield 032,Enfield,E09000010,5208 ,2669 ,2539 
E02000309,2008,Enfield 033,Enfield,E09000010,6308 ,3043 ,3265 
E02000311,2008,Enfield 035,Enfield,E09000010,6363 ,3022 ,3341 
E02000312,2008,Enfield 036,Enfield,E09000010,7014 ,3583 ,3431 
E02006793,2008,Enfield 037,Enfield,E09000010,5587 ,2602 ,2985 
E02000313,2008,Greenwich 001,Greenwich,E09000011,3833 ,1863 ,1970 
E02000314,2008,Greenwich 002,Greenwich,E09000011,6988 ,3608 ,3380 
E02000315,2008,Greenwich 003,Greenwich,E09000011,5318 ,2500 ,2818 
E02000316,2008,Greenwich 004,Greenwich,E09000011,6484 ,3338 ,3146 
E02000317,2008,Greenwich 005,Greenwich,E09000011,5531 ,2730 ,2801 
E02000318,2008,Greenwich 006,Greenwich,E09000011,6200 ,3167 ,3033 
E02000319,2008,Greenwich 007,Greenwich,E09000011,6816 ,3547 ,3269 
E02000320,2008,Greenwich 008,Greenwich,E09000011,4163 ,1977 ,2186 
E02000321,2008,Greenwich 009,Greenwich,E09000011,4565 ,2276 ,2289 
E02000323,2008,Greenwich 011,Greenwich,E09000011,6607 ,3283 ,3324 
E02000324,2008,Greenwich 012,Greenwich,E09000011,4469 ,2205 ,2264 
E02000326,2008,Greenwich 014,Greenwich,E09000011,4638 ,2255 ,2383 
E02000327,2008,Greenwich 015,Greenwich,E09000011,4116 ,2196 ,1920 
E02000328,2008,Greenwich 016,Greenwich,E09000011,4368 ,2197 ,2171 
E02000329,2008,Greenwich 017,Greenwich,E09000011,4104 ,2062 ,2042 
E02000331,2008,Greenwich 019,Greenwich,E09000011,5226 ,2574 ,2652 
E02000332,2008,Greenwich 020,Greenwich,E09000011,4814 ,2397 ,2417 
E02000333,2008,Greenwich 021,Greenwich,E09000011,4349 ,2262 ,2087 
E02000334,2008,Greenwich 022,Greenwich,E09000011,4222 ,2116 ,2106 
E02000335,2008,Greenwich 023,Greenwich,E09000011,4245 ,2098 ,2147 
E02000337,2008,Greenwich 025,Greenwich,E09000011,5158 ,2493 ,2665 
E02000339,2008,Greenwich 027,Greenwich,E09000011,3914 ,1946 ,1968 
E02000340,2008,Greenwich 028,Greenwich,E09000011,3809 ,1925 ,1884 
E02000341,2008,Greenwich 029,Greenwich,E09000011,4916 ,2289 ,2627 
E02000342,2008,Greenwich 030,Greenwich,E09000011,4341 ,2034 ,2307 
E02000343,2008,Greenwich 031,Greenwich,E09000011,4212 ,2099 ,2113 
E02000344,2008,Greenwich 032,Greenwich,E09000011,4154 ,2069 ,2085 
E02006786,2008,Greenwich 033,Greenwich,E09000011,4503 ,2231 ,2272 
E02006927,2008,Greenwich 034,Greenwich,E09000011,6635 ,3254 ,3381 
E02006928,2008,Greenwich 035,Greenwich,E09000011,5070 ,2572 ,2498 
E02006929,2008,Greenwich 036,Greenwich,E09000011,4904 ,2482 ,2422 
E02006930,2008,Greenwich 037,Greenwich,E09000011,4877 ,2476 ,2401 
E02006931,2008,Greenwich 038,Greenwich,E09000011,6344 ,3257 ,3087 
E02000345,2008,Hackney 001,Hackney,E09000012,5083 ,2660 ,2423 
E02000346,2008,Hackney 002,Hackney,E09000012,4627 ,2363 ,2264 
E02000347,2008,Hackney 003,Hackney,E09000012,4932 ,2523 ,2409 
E02000348,2008,Hackney 004,Hackney,E09000012,4888 ,2408 ,2480 
E02000350,2008,Hackney 006,Hackney,E09000012,6595 ,3285 ,3310 
E02000351,2008,Hackney 007,Hackney,E09000012,6337 ,3181 ,3156 
E02000352,2008,Hackney 008,Hackney,E09000012,4525 ,2165 ,2360 
E02000353,2008,Hackney 009,Hackney,E09000012,5754 ,2779 ,2975 
E02000354,2008,Hackney 010,Hackney,E09000012,6242 ,3130 ,3112 
E02000355,2008,Hackney 011,Hackney,E09000012,6001 ,2991 ,3010 
E02000356,2008,Hackney 012,Hackney,E09000012,5423 ,2679 ,2744 
E02000357,2008,Hackney 013,Hackney,E09000012,3991 ,1883 ,2108 
E02000358,2008,Hackney 014,Hackney,E09000012,8128 ,4020 ,4108 
E02000359,2008,Hackney 015,Hackney,E09000012,4496 ,2121 ,2375 
E02000360,2008,Hackney 016,Hackney,E09000012,7534 ,3727 ,3807 
E02000361,2008,Hackney 017,Hackney,E09000012,5284 ,2673 ,2611 
E02000362,2008,Hackney 018,Hackney,E09000012,4145 ,1993 ,2152 
E02000363,2008,Hackney 019,Hackney,E09000012,6904 ,3359 ,3545 
E02000364,2008,Hackney 020,Hackney,E09000012,6151 ,3077 ,3074 
E02000365,2008,Hackney 021,Hackney,E09000012,8839 ,4500 ,4339 
E02000366,2008,Hackney 022,Hackney,E09000012,5766 ,2781 ,2985 
E02000367,2008,Hackney 023,Hackney,E09000012,6579 ,3134 ,3445 
E02000368,2008,Hackney 024,Hackney,E09000012,6727 ,3318 ,3409 
E02000369,2008,Hackney 025,Hackney,E09000012,7805 ,3903 ,3902 
E02000370,2008,Hackney 026,Hackney,E09000012,5241 ,2673 ,2568 
E02000371,2008,Hackney 027,Hackney,E09000012,8248 ,4521 ,3727 
E02006918,2008,Hackney 028,Hackney,E09000012,4129 ,2037 ,2092 
E02006921,2008,Hackney 029,Hackney,E09000012,4950 ,2414 ,2536 
E02000372,2008,Hammersmith and Fulham 001,Hammersmith and Fulham,E09000013,6114 ,2889 ,3225 
E02000373,2008,Hammersmith and Fulham 002,Hammersmith and Fulham,E09000013,4425 ,2041 ,2384 
E02000374,2008,Hammersmith and Fulham 003,Hammersmith and Fulham,E09000013,4708 ,2291 ,2417 
E02000375,2008,Hammersmith and Fulham 004,Hammersmith and Fulham,E09000013,5304 ,2697 ,2607 
E02000376,2008,Hammersmith and Fulham 005,Hammersmith and Fulham,E09000013,5439 ,2737 ,2702 
E02000377,2008,Hammersmith and Fulham 006,Hammersmith and Fulham,E09000013,5915 ,2937 ,2978 
E02000378,2008,Hammersmith and Fulham 007,Hammersmith and Fulham,E09000013,5189 ,2581 ,2608 
E02000379,2008,Hammersmith and Fulham 008,Hammersmith and Fulham,E09000013,4932 ,2507 ,2425 
E02000380,2008,Hammersmith and Fulham 009,Hammersmith and Fulham,E09000013,4645 ,2395 ,2250 
E02000381,2008,Hammersmith and Fulham 010,Hammersmith and Fulham,E09000013,5889 ,2854 ,3035 
E02000382,2008,Hammersmith and Fulham 011,Hammersmith and Fulham,E09000013,4455 ,2222 ,2233 
E02000383,2008,Hammersmith and Fulham 012,Hammersmith and Fulham,E09000013,7510 ,3810 ,3700 
E02000384,2008,Hammersmith and Fulham 013,Hammersmith and Fulham,E09000013,5494 ,2638 ,2856 
E02000385,2008,Hammersmith and Fulham 014,Hammersmith and Fulham,E09000013,5532 ,2848 ,2684 
E02000386,2008,Hammersmith and Fulham 015,Hammersmith and Fulham,E09000013,6135 ,3023 ,3112 
E02000387,2008,Hammersmith and Fulham 016,Hammersmith and Fulham,E09000013,4690 ,2235 ,2455 
E02000388,2008,Hammersmith and Fulham 017,Hammersmith and Fulham,E09000013,6167 ,2994 ,3173 
E02000389,2008,Hammersmith and Fulham 018,Hammersmith and Fulham,E09000013,5890 ,2763 ,3127 
E02000390,2008,Hammersmith and Fulham 019,Hammersmith and Fulham,E09000013,4767 ,2274 ,2493 
E02000391,2008,Hammersmith and Fulham 020,Hammersmith and Fulham,E09000013,5320 ,2541 ,2779 
E02000392,2008,Hammersmith and Fulham 021,Hammersmith and Fulham,E09000013,6922 ,3203 ,3719 
E02000393,2008,Hammersmith and Fulham 022,Hammersmith and Fulham,E09000013,4371 ,2048 ,2323 
E02000394,2008,Hammersmith and Fulham 023,Hammersmith and Fulham,E09000013,4819 ,2284 ,2535 
E02000395,2008,Hammersmith and Fulham 024,Hammersmith and Fulham,E09000013,4243 ,1998 ,2245 
E02000396,2008,Hammersmith and Fulham 025,Hammersmith and Fulham,E09000013,4534 ,2153 ,2381 
E02000397,2008,Haringey 001,Haringey,E09000014,5398 ,2712 ,2686 
E02000398,2008,Haringey 002,Haringey,E09000014,4690 ,2312 ,2378 
E02000400,2008,Haringey 004,Haringey,E09000014,4987 ,2434 ,2553 
E02000401,2008,Haringey 005,Haringey,E09000014,4376 ,2051 ,2325 
E02000402,2008,Haringey 006,Haringey,E09000014,4188 ,1902 ,2286 
E02000403,2008,Haringey 007,Haringey,E09000014,5152 ,2576 ,2576 
E02000404,2008,Haringey 008,Haringey,E09000014,4839 ,2311 ,2528 
E02000405,2008,Haringey 009,Haringey,E09000014,4463 ,2152 ,2311 
E02000406,2008,Haringey 010,Haringey,E09000014,4829 ,2289 ,2540 
E02000407,2008,Haringey 011,Haringey,E09000014,4511 ,2148 ,2363 
E02000408,2008,Haringey 012,Haringey,E09000014,4700 ,2279 ,2421 
E02000409,2008,Haringey 013,Haringey,E09000014,4399 ,2165 ,2234 
E02000410,2008,Haringey 014,Haringey,E09000014,4694 ,2265 ,2429 
E02000411,2008,Haringey 015,Haringey,E09000014,4999 ,2506 ,2493 
E02000412,2008,Haringey 016,Haringey,E09000014,4727 ,2348 ,2379 
E02000413,2008,Haringey 017,Haringey,E09000014,4692 ,2245 ,2447 
E02000414,2008,Haringey 018,Haringey,E09000014,4640 ,2285 ,2355 
E02000415,2008,Haringey 019,Haringey,E09000014,4798 ,2520 ,2278 
E02000416,2008,Haringey 020,Haringey,E09000014,5212 ,2594 ,2618 
E02000417,2008,Haringey 021,Haringey,E09000014,4796 ,2414 ,2382 
E02000418,2008,Haringey 022,Haringey,E09000014,3787 ,1806 ,1981 
E02000419,2008,Haringey 023,Haringey,E09000014,5837 ,2957 ,2880 
E02000420,2008,Haringey 024,Haringey,E09000014,4839 ,2364 ,2475 
E02000421,2008,Haringey 025,Haringey,E09000014,4856 ,2347 ,2509 
E02000422,2008,Haringey 026,Haringey,E09000014,5320 ,2733 ,2587 
E02000423,2008,Haringey 027,Haringey,E09000014,5116 ,2759 ,2357 
E02000424,2008,Haringey 028,Haringey,E09000014,5238 ,2580 ,2658 
E02000425,2008,Haringey 029,Haringey,E09000014,4009 ,2047 ,1962 
E02000426,2008,Haringey 030,Haringey,E09000014,4678 ,2351 ,2327 
E02000427,2008,Haringey 031,Haringey,E09000014,5347 ,2784 ,2563 
E02000428,2008,Haringey 032,Haringey,E09000014,4714 ,2359 ,2355 
E02000429,2008,Haringey 033,Haringey,E09000014,5203 ,2648 ,2555 
E02000430,2008,Haringey 034,Haringey,E09000014,5697 ,2866 ,2831 
E02000431,2008,Haringey 035,Haringey,E09000014,5161 ,2650 ,2511 
E02000432,2008,Haringey 036,Haringey,E09000014,4877 ,2372 ,2505 
E02006794,2008,Haringey 037,Haringey,E09000014,4460 ,2156 ,2304 
E02000433,2008,Harrow 001,Harrow,E09000015,4365 ,2049 ,2316 
E02000434,2008,Harrow 002,Harrow,E09000015,5085 ,2489 ,2596 
E02000435,2008,Harrow 003,Harrow,E09000015,4645 ,2197 ,2448 
E02000436,2008,Harrow 004,Harrow,E09000015,3629 ,1720 ,1909 
E02000437,2008,Harrow 005,Harrow,E09000015,5225 ,2528 ,2697 
E02000438,2008,Harrow 006,Harrow,E09000015,4726 ,2237 ,2489 
E02000439,2008,Harrow 007,Harrow,E09000015,5410 ,2756 ,2654 
E02000440,2008,Harrow 008,Harrow,E09000015,5987 ,2927 ,3060 
E02000441,2008,Harrow 009,Harrow,E09000015,4504 ,2161 ,2343 
E02000442,2008,Harrow 010,Harrow,E09000015,5664 ,2914 ,2750 
E02000443,2008,Harrow 011,Harrow,E09000015,6041 ,3048 ,2993 
E02000444,2008,Harrow 012,Harrow,E09000015,5316 ,2614 ,2702 
E02000445,2008,Harrow 013,Harrow,E09000015,6588 ,3299 ,3289 
E02000447,2008,Harrow 015,Harrow,E09000015,4673 ,2260 ,2413 
E02000448,2008,Harrow 016,Harrow,E09000015,4109 ,2054 ,2055 
E02000449,2008,Harrow 017,Harrow,E09000015,5429 ,2735 ,2694 
E02000451,2008,Harrow 019,Harrow,E09000015,4292 ,2156 ,2136 
E02000452,2008,Harrow 020,Harrow,E09000015,5564 ,2839 ,2725 
E02000453,2008,Harrow 021,Harrow,E09000015,4907 ,2463 ,2444 
E02000454,2008,Harrow 022,Harrow,E09000015,4476 ,2175 ,2301 
E02000455,2008,Harrow 023,Harrow,E09000015,5518 ,2804 ,2714 
E02000456,2008,Harrow 024,Harrow,E09000015,4610 ,2283 ,2327 
E02000457,2008,Harrow 025,Harrow,E09000015,4095 ,2058 ,2037 
E02000459,2008,Harrow 027,Harrow,E09000015,4986 ,2537 ,2449 
E02000460,2008,Harrow 028,Harrow,E09000015,4413 ,2208 ,2205 
E02000461,2008,Harrow 029,Harrow,E09000015,4674 ,2583 ,2091 
E02000462,2008,Harrow 030,Harrow,E09000015,4301 ,2221 ,2080 
E02000463,2008,Harrow 031,Harrow,E09000015,5653 ,2795 ,2858 
E02006795,2008,Harrow 032,Harrow,E09000015,5286 ,2642 ,2644 
E02006882,2008,Harrow 033,Harrow,E09000015,9501 ,4691 ,4810 
E02000464,2008,Havering 001,Havering,E09000016,3815 ,1866 ,1949 
E02000465,2008,Havering 002,Havering,E09000016,5006 ,2451 ,2555 
E02000466,2008,Havering 003,Havering,E09000016,5123 ,2454 ,2669 
E02000467,2008,Havering 004,Havering,E09000016,5999 ,2873 ,3126 
E02000468,2008,Havering 005,Havering,E09000016,4846 ,2309 ,2537 
E02000469,2008,Havering 006,Havering,E09000016,3992 ,1903 ,2089 
E02000470,2008,Havering 007,Havering,E09000016,5100 ,2535 ,2565 
E02000471,2008,Havering 008,Havering,E09000016,4739 ,2304 ,2435 
E02000472,2008,Havering 009,Havering,E09000016,5690 ,2804 ,2886 
E02000473,2008,Havering 010,Havering,E09000016,6001 ,2934 ,3067 
E02000474,2008,Havering 011,Havering,E09000016,5058 ,2481 ,2577 
E02000475,2008,Havering 012,Havering,E09000016,5868 ,2872 ,2996 
E02000476,2008,Havering 013,Havering,E09000016,5042 ,2529 ,2513 
E02000477,2008,Havering 014,Havering,E09000016,6069 ,2993 ,3076 
E02000478,2008,Havering 015,Havering,E09000016,3668 ,1849 ,1819 
E02000479,2008,Havering 016,Havering,E09000016,5587 ,2758 ,2829 
E02000480,2008,Havering 017,Havering,E09000016,6080 ,3048 ,3032 
E02000481,2008,Havering 018,Havering,E09000016,4546 ,2226 ,2320 
E02000482,2008,Havering 019,Havering,E09000016,3859 ,1931 ,1928 
E02000483,2008,Havering 020,Havering,E09000016,4790 ,2374 ,2416 
E02000484,2008,Havering 021,Havering,E09000016,5513 ,2741 ,2772 
E02000485,2008,Havering 022,Havering,E09000016,4992 ,2471 ,2521 
E02000486,2008,Havering 023,Havering,E09000016,4865 ,2417 ,2448 
E02000487,2008,Havering 024,Havering,E09000016,4947 ,2469 ,2478 
E02000488,2008,Havering 025,Havering,E09000016,4967 ,2466 ,2501 
E02000489,2008,Havering 026,Havering,E09000016,4890 ,2379 ,2511 
E02000490,2008,Havering 027,Havering,E09000016,4720 ,2289 ,2431 
E02000491,2008,Havering 028,Havering,E09000016,5505 ,2733 ,2772 
E02000492,2008,Havering 029,Havering,E09000016,3936 ,1972 ,1964 
E02000493,2008,Havering 030,Havering,E09000016,4099 ,1975 ,2124 
E02000494,2008,Hillingdon 001,Hillingdon,E09000017,4862 ,2344 ,2518 
E02000495,2008,Hillingdon 002,Hillingdon,E09000017,6168 ,2950 ,3218 
E02000496,2008,Hillingdon 003,Hillingdon,E09000017,4821 ,2365 ,2456 
E02000497,2008,Hillingdon 004,Hillingdon,E09000017,5205 ,2543 ,2662 
E02000498,2008,Hillingdon 005,Hillingdon,E09000017,3879 ,1874 ,2005 
E02000499,2008,Hillingdon 006,Hillingdon,E09000017,4774 ,2334 ,2440 
E02000500,2008,Hillingdon 007,Hillingdon,E09000017,4823 ,2426 ,2397 
E02000501,2008,Hillingdon 008,Hillingdon,E09000017,5290 ,2569 ,2721 
E02000502,2008,Hillingdon 009,Hillingdon,E09000017,4808 ,2407 ,2401 
E02000503,2008,Hillingdon 010,Hillingdon,E09000017,5917 ,2985 ,2932 
E02000504,2008,Hillingdon 011,Hillingdon,E09000017,4543 ,2274 ,2269 
E02000506,2008,Hillingdon 013,Hillingdon,E09000017,4852 ,2417 ,2435 
E02000507,2008,Hillingdon 014,Hillingdon,E09000017,5192 ,2652 ,2540 
E02000508,2008,Hillingdon 015,Hillingdon,E09000017,6391 ,3453 ,2938 
E02000509,2008,Hillingdon 016,Hillingdon,E09000017,7086 ,3589 ,3497 
E02000510,2008,Hillingdon 017,Hillingdon,E09000017,5693 ,2874 ,2819 
E02000511,2008,Hillingdon 018,Hillingdon,E09000017,6013 ,2967 ,3046 
E02000512,2008,Hillingdon 019,Hillingdon,E09000017,5219 ,2575 ,2644 
E02000513,2008,Hillingdon 020,Hillingdon,E09000017,5583 ,2623 ,2960 
E02000514,2008,Hillingdon 021,Hillingdon,E09000017,6305 ,3118 ,3187 
E02000515,2008,Hillingdon 022,Hillingdon,E09000017,6700 ,3420 ,3280 
E02000516,2008,Hillingdon 023,Hillingdon,E09000017,5307 ,2565 ,2742 
E02000517,2008,Hillingdon 024,Hillingdon,E09000017,5030 ,2385 ,2645 
E02000518,2008,Hillingdon 025,Hillingdon,E09000017,5499 ,2767 ,2732 
E02000519,2008,Hillingdon 026,Hillingdon,E09000017,5371 ,2681 ,2690 
E02000520,2008,Hillingdon 027,Hillingdon,E09000017,6951 ,3477 ,3474 
E02000521,2008,Hillingdon 028,Hillingdon,E09000017,5655 ,2786 ,2869 
E02000522,2008,Hillingdon 029,Hillingdon,E09000017,5199 ,2546 ,2653 
E02000523,2008,Hillingdon 030,Hillingdon,E09000017,5723 ,2944 ,2779 
E02000524,2008,Hillingdon 031,Hillingdon,E09000017,4579 ,2499 ,2080 
E02000525,2008,Hillingdon 032,Hillingdon,E09000017,5580 ,2799 ,2781 
E02006796,2008,Hillingdon 033,Hillingdon,E09000017,5627 ,2833 ,2794 
E02000526,2008,Hounslow 001,Hounslow,E09000018,6440 ,3254 ,3186 
E02000528,2008,Hounslow 003,Hounslow,E09000018,6670 ,3287 ,3383 
E02000529,2008,Hounslow 004,Hounslow,E09000018,5622 ,2865 ,2757 
E02000530,2008,Hounslow 005,Hounslow,E09000018,4345 ,2145 ,2200 
E02000531,2008,Hounslow 006,Hounslow,E09000018,6956 ,3352 ,3604 
E02000532,2008,Hounslow 007,Hounslow,E09000018,6338 ,3156 ,3182 
E02000533,2008,Hounslow 008,Hounslow,E09000018,5340 ,2656 ,2684 
E02000534,2008,Hounslow 009,Hounslow,E09000018,4652 ,2385 ,2267 
E02000535,2008,Hounslow 010,Hounslow,E09000018,6190 ,3199 ,2991 
E02000536,2008,Hounslow 011,Hounslow,E09000018,5975 ,2938 ,3037 
E02000537,2008,Hounslow 012,Hounslow,E09000018,6026 ,3134 ,2892 
E02000538,2008,Hounslow 013,Hounslow,E09000018,5628 ,2909 ,2719 
E02000539,2008,Hounslow 014,Hounslow,E09000018,6737 ,3259 ,3478 
E02000540,2008,Hounslow 015,Hounslow,E09000018,6322 ,3352 ,2970 
E02000541,2008,Hounslow 016,Hounslow,E09000018,5298 ,2621 ,2677 
E02000542,2008,Hounslow 017,Hounslow,E09000018,5628 ,2836 ,2792 
E02000543,2008,Hounslow 018,Hounslow,E09000018,7469 ,3856 ,3613 
E02000544,2008,Hounslow 019,Hounslow,E09000018,5628 ,2876 ,2752 
E02000545,2008,Hounslow 020,Hounslow,E09000018,5829 ,2867 ,2962 
E02000546,2008,Hounslow 021,Hounslow,E09000018,6682 ,3461 ,3221 
E02000547,2008,Hounslow 022,Hounslow,E09000018,5763 ,2823 ,2940 
E02000548,2008,Hounslow 023,Hounslow,E09000018,5716 ,2895 ,2821 
E02000549,2008,Hounslow 024,Hounslow,E09000018,6807 ,3430 ,3377 
E02000550,2008,Hounslow 025,Hounslow,E09000018,6539 ,3192 ,3347 
E02000551,2008,Hounslow 026,Hounslow,E09000018,5525 ,2680 ,2845 
E02000552,2008,Hounslow 027,Hounslow,E09000018,5604 ,2927 ,2677 
E02000553,2008,Hounslow 028,Hounslow,E09000018,4484 ,2234 ,2250 
E02006792,2008,Hounslow 029,Hounslow,E09000018,6179 ,3189 ,2990 
E02000554,2008,Islington 001,Islington,E09000019,6616 ,3073 ,3543 
E02000555,2008,Islington 002,Islington,E09000019,6337 ,2970 ,3367 
E02000556,2008,Islington 003,Islington,E09000019,7611 ,3688 ,3923 
E02000557,2008,Islington 004,Islington,E09000019,5819 ,2777 ,3042 
E02000558,2008,Islington 005,Islington,E09000019,5710 ,2743 ,2967 
E02000559,2008,Islington 006,Islington,E09000019,5593 ,2808 ,2785 
E02000560,2008,Islington 007,Islington,E09000019,5349 ,2680 ,2669 
E02000561,2008,Islington 008,Islington,E09000019,5322 ,2544 ,2778 
E02000562,2008,Islington 009,Islington,E09000019,5397 ,2552 ,2845 
E02000563,2008,Islington 010,Islington,E09000019,6175 ,2813 ,3362 
E02000564,2008,Islington 011,Islington,E09000019,6747 ,3350 ,3397 
E02000565,2008,Islington 012,Islington,E09000019,5694 ,2679 ,3015 
E02000566,2008,Islington 013,Islington,E09000019,5407 ,2610 ,2797 
E02000567,2008,Islington 014,Islington,E09000019,7518 ,3628 ,3890 
E02000568,2008,Islington 015,Islington,E09000019,6393 ,3384 ,3009 
E02000569,2008,Islington 016,Islington,E09000019,7073 ,3365 ,3708 
E02000570,2008,Islington 017,Islington,E09000019,6080 ,2930 ,3150 
E02000571,2008,Islington 018,Islington,E09000019,5665 ,2835 ,2830 
E02000572,2008,Islington 019,Islington,E09000019,5400 ,2534 ,2866 
E02000573,2008,Islington 020,Islington,E09000019,6602 ,3389 ,3213 
E02000574,2008,Islington 021,Islington,E09000019,6460 ,3202 ,3258 
E02000575,2008,Islington 022,Islington,E09000019,8828 ,4690 ,4138 
E02000576,2008,Islington 023,Islington,E09000019,6386 ,3321 ,3065 
E02000577,2008,Kensington and Chelsea 001,Kensington and Chelsea,E09000020,5087 ,2501 ,2586 
E02000578,2008,Kensington and Chelsea 002,Kensington and Chelsea,E09000020,4006 ,1893 ,2113 
E02000579,2008,Kensington and Chelsea 003,Kensington and Chelsea,E09000020,5819 ,2699 ,3120 
E02000580,2008,Kensington and Chelsea 004,Kensington and Chelsea,E09000020,6620 ,3272 ,3348 
E02000581,2008,Kensington and Chelsea 005,Kensington and Chelsea,E09000020,5033 ,2374 ,2659 
E02000582,2008,Kensington and Chelsea 006,Kensington and Chelsea,E09000020,6178 ,3162 ,3016 
E02000583,2008,Kensington and Chelsea 007,Kensington and Chelsea,E09000020,5390 ,2599 ,2791 
E02000584,2008,Kensington and Chelsea 008,Kensington and Chelsea,E09000020,6234 ,3038 ,3196 
E02000585,2008,Kensington and Chelsea 009,Kensington and Chelsea,E09000020,6478 ,3235 ,3243 
E02000586,2008,Kensington and Chelsea 010,Kensington and Chelsea,E09000020,6329 ,3149 ,3180 
E02000587,2008,Kensington and Chelsea 011,Kensington and Chelsea,E09000020,5586 ,2830 ,2756 
E02000588,2008,Kensington and Chelsea 012,Kensington and Chelsea,E09000020,6294 ,3162 ,3132 
E02000589,2008,Kensington and Chelsea 013,Kensington and Chelsea,E09000020,7107 ,3892 ,3215 
E02000590,2008,Kensington and Chelsea 014,Kensington and Chelsea,E09000020,5360 ,2483 ,2877 
E02000591,2008,Kensington and Chelsea 015,Kensington and Chelsea,E09000020,5529 ,2944 ,2585 
E02000592,2008,Kensington and Chelsea 016,Kensington and Chelsea,E09000020,5376 ,2688 ,2688 
E02000593,2008,Kensington and Chelsea 017,Kensington and Chelsea,E09000020,5908 ,3083 ,2825 
E02000594,2008,Kensington and Chelsea 018,Kensington and Chelsea,E09000020,5068 ,2412 ,2656 
E02000595,2008,Kensington and Chelsea 019,Kensington and Chelsea,E09000020,5350 ,2576 ,2774 
E02000596,2008,Kensington and Chelsea 020,Kensington and Chelsea,E09000020,6131 ,3082 ,3049 
E02000597,2008,Kensington and Chelsea 021,Kensington and Chelsea,E09000020,5129 ,2349 ,2780 
E02000598,2008,Kingston upon Thames 001,Kingston upon Thames,E09000021,4755 ,2242 ,2513 
E02000599,2008,Kingston upon Thames 002,Kingston upon Thames,E09000021,4938 ,2411 ,2527 
E02000600,2008,Kingston upon Thames 003,Kingston upon Thames,E09000021,6157 ,3042 ,3115 
E02000601,2008,Kingston upon Thames 004,Kingston upon Thames,E09000021,6982 ,3410 ,3572 
E02000602,2008,Kingston upon Thames 005,Kingston upon Thames,E09000021,6688 ,3354 ,3334 
E02000603,2008,Kingston upon Thames 006,Kingston upon Thames,E09000021,5271 ,2576 ,2695 
E02000604,2008,Kingston upon Thames 007,Kingston upon Thames,E09000021,5778 ,2905 ,2873 
E02000605,2008,Kingston upon Thames 008,Kingston upon Thames,E09000021,5329 ,2657 ,2672 
E02000606,2008,Kingston upon Thames 009,Kingston upon Thames,E09000021,7711 ,3988 ,3723 
E02000607,2008,Kingston upon Thames 010,Kingston upon Thames,E09000021,4929 ,2460 ,2469 
E02000608,2008,Kingston upon Thames 011,Kingston upon Thames,E09000021,5455 ,2850 ,2605 
E02000609,2008,Kingston upon Thames 012,Kingston upon Thames,E09000021,4599 ,2277 ,2322 
E02000610,2008,Kingston upon Thames 013,Kingston upon Thames,E09000021,5647 ,2927 ,2720 
E02000611,2008,Kingston upon Thames 014,Kingston upon Thames,E09000021,4691 ,2352 ,2339 
E02000612,2008,Kingston upon Thames 015,Kingston upon Thames,E09000021,5153 ,2553 ,2600 
E02000613,2008,Kingston upon Thames 016,Kingston upon Thames,E09000021,5125 ,2475 ,2650 
E02000614,2008,Kingston upon Thames 017,Kingston upon Thames,E09000021,5580 ,2745 ,2835 
E02000615,2008,Kingston upon Thames 018,Kingston upon Thames,E09000021,4822 ,2396 ,2426 
E02000616,2008,Kingston upon Thames 019,Kingston upon Thames,E09000021,4030 ,1952 ,2078 
E02000617,2008,Kingston upon Thames 020,Kingston upon Thames,E09000021,5467 ,2641 ,2826 
E02000619,2008,Lambeth 002,Lambeth,E09000022,5549 ,2848 ,2701 
E02000620,2008,Lambeth 003,Lambeth,E09000022,6379 ,3398 ,2981 
E02000621,2008,Lambeth 004,Lambeth,E09000022,7542 ,4168 ,3374 
E02000622,2008,Lambeth 005,Lambeth,E09000022,6000 ,3239 ,2761 
E02000623,2008,Lambeth 006,Lambeth,E09000022,5614 ,2962 ,2652 
E02000624,2008,Lambeth 007,Lambeth,E09000022,5764 ,2973 ,2791 
E02000625,2008,Lambeth 008,Lambeth,E09000022,5854 ,3003 ,2851 
E02000626,2008,Lambeth 009,Lambeth,E09000022,5939 ,2996 ,2943 
E02000627,2008,Lambeth 010,Lambeth,E09000022,7014 ,3645 ,3369 
E02000628,2008,Lambeth 011,Lambeth,E09000022,6857 ,3429 ,3428 
E02000629,2008,Lambeth 012,Lambeth,E09000022,7028 ,3675 ,3353 
E02000630,2008,Lambeth 013,Lambeth,E09000022,5402 ,2781 ,2621 
E02000631,2008,Lambeth 014,Lambeth,E09000022,6423 ,3263 ,3160 
E02000632,2008,Lambeth 015,Lambeth,E09000022,7847 ,4090 ,3757 
E02000633,2008,Lambeth 016,Lambeth,E09000022,6183 ,3155 ,3028 
E02000634,2008,Lambeth 017,Lambeth,E09000022,5154 ,2605 ,2549 
E02000635,2008,Lambeth 018,Lambeth,E09000022,6734 ,3468 ,3266 
E02000636,2008,Lambeth 019,Lambeth,E09000022,5516 ,2801 ,2715 
E02000637,2008,Lambeth 020,Lambeth,E09000022,6356 ,3306 ,3050 
E02000638,2008,Lambeth 021,Lambeth,E09000022,6768 ,3417 ,3351 
E02000639,2008,Lambeth 022,Lambeth,E09000022,5875 ,2862 ,3013 
E02000640,2008,Lambeth 023,Lambeth,E09000022,6561 ,3236 ,3325 
E02000641,2008,Lambeth 024,Lambeth,E09000022,5725 ,2687 ,3038 
E02000642,2008,Lambeth 025,Lambeth,E09000022,6606 ,3226 ,3380 
E02000643,2008,Lambeth 026,Lambeth,E09000022,5770 ,2794 ,2976 
E02000644,2008,Lambeth 027,Lambeth,E09000022,5810 ,2934 ,2876 
E02000645,2008,Lambeth 028,Lambeth,E09000022,6198 ,3063 ,3135 
E02000646,2008,Lambeth 029,Lambeth,E09000022,6189 ,3130 ,3059 
E02000647,2008,Lambeth 030,Lambeth,E09000022,5610 ,2807 ,2803 
E02000648,2008,Lambeth 031,Lambeth,E09000022,4657 ,2133 ,2524 
E02000649,2008,Lambeth 032,Lambeth,E09000022,7545 ,3751 ,3794 
E02000650,2008,Lambeth 033,Lambeth,E09000022,5428 ,2630 ,2798 
E02000651,2008,Lambeth 034,Lambeth,E09000022,5779 ,2934 ,2845 
E02000652,2008,Lambeth 035,Lambeth,E09000022,4565 ,2242 ,2323 
E02006801,2008,Lambeth 036,Lambeth,E09000022,6340 ,3357 ,2983 
E02000653,2008,Lewisham 001,Lewisham,E09000023,5522 ,2821 ,2701 
E02000654,2008,Lewisham 002,Lewisham,E09000023,5182 ,2535 ,2647 
E02000655,2008,Lewisham 003,Lewisham,E09000023,5935 ,2965 ,2970 
E02000657,2008,Lewisham 005,Lewisham,E09000023,6886 ,3434 ,3452 
E02000658,2008,Lewisham 006,Lewisham,E09000023,5897 ,3078 ,2819 
E02000659,2008,Lewisham 007,Lewisham,E09000023,5527 ,2697 ,2830 
E02000660,2008,Lewisham 008,Lewisham,E09000023,5949 ,2956 ,2993 
E02000661,2008,Lewisham 009,Lewisham,E09000023,4435 ,2274 ,2161 
E02000662,2008,Lewisham 010,Lewisham,E09000023,5802 ,2846 ,2956 
E02000663,2008,Lewisham 011,Lewisham,E09000023,5480 ,2911 ,2569 
E02000664,2008,Lewisham 012,Lewisham,E09000023,6660 ,3437 ,3223 
E02000665,2008,Lewisham 013,Lewisham,E09000023,5257 ,2646 ,2611 
E02000666,2008,Lewisham 014,Lewisham,E09000023,5198 ,2531 ,2667 
E02000667,2008,Lewisham 015,Lewisham,E09000023,4596 ,2267 ,2329 
E02000668,2008,Lewisham 016,Lewisham,E09000023,4392 ,2200 ,2192 
E02000669,2008,Lewisham 017,Lewisham,E09000023,5605 ,2859 ,2746 
E02000670,2008,Lewisham 018,Lewisham,E09000023,4291 ,2032 ,2259 
E02000671,2008,Lewisham 019,Lewisham,E09000023,5953 ,2918 ,3035 
E02000672,2008,Lewisham 020,Lewisham,E09000023,5536 ,2835 ,2701 
E02000673,2008,Lewisham 021,Lewisham,E09000023,5626 ,2828 ,2798 
E02000674,2008,Lewisham 022,Lewisham,E09000023,5276 ,2491 ,2785 
E02000675,2008,Lewisham 023,Lewisham,E09000023,5414 ,2588 ,2826 
E02000676,2008,Lewisham 024,Lewisham,E09000023,5376 ,2657 ,2719 
E02000677,2008,Lewisham 025,Lewisham,E09000023,4876 ,2458 ,2418 
E02000678,2008,Lewisham 026,Lewisham,E09000023,3668 ,1707 ,1961 
E02000679,2008,Lewisham 027,Lewisham,E09000023,5346 ,2628 ,2718 
E02000680,2008,Lewisham 028,Lewisham,E09000023,4573 ,2254 ,2319 
E02000681,2008,Lewisham 029,Lewisham,E09000023,5224 ,2434 ,2790 
E02000682,2008,Lewisham 030,Lewisham,E09000023,4980 ,2353 ,2627 
E02000683,2008,Lewisham 031,Lewisham,E09000023,4190 ,2000 ,2190 
E02000685,2008,Lewisham 033,Lewisham,E09000023,5128 ,2464 ,2664 
E02000686,2008,Lewisham 034,Lewisham,E09000023,4382 ,1944 ,2438 
E02000687,2008,Lewisham 035,Lewisham,E09000023,5526 ,2736 ,2790 
E02006783,2008,Lewisham 037,Lewisham,E09000023,4353 ,1960 ,2393 
E02006784,2008,Lewisham 038,Lewisham,E09000023,4555 ,2205 ,2350 
E02006798,2008,Lewisham 039,Lewisham,E09000023,5419 ,2709 ,2710 
E02000689,2008,Merton 001,Merton,E09000024,5238 ,2620 ,2618 
E02000690,2008,Merton 002,Merton,E09000024,3591 ,1837 ,1754 
E02000691,2008,Merton 003,Merton,E09000024,5445 ,2713 ,2732 
E02000692,2008,Merton 004,Merton,E09000024,5731 ,3027 ,2704 
E02000693,2008,Merton 005,Merton,E09000024,7014 ,3681 ,3333 
E02000694,2008,Merton 006,Merton,E09000024,6560 ,3250 ,3310 
E02000695,2008,Merton 007,Merton,E09000024,5679 ,3001 ,2678 
E02000696,2008,Merton 008,Merton,E09000024,6012 ,3006 ,3006 
E02000697,2008,Merton 009,Merton,E09000024,6628 ,3386 ,3242 
E02000698,2008,Merton 010,Merton,E09000024,5266 ,2622 ,2644 
E02000699,2008,Merton 011,Merton,E09000024,5846 ,2945 ,2901 
E02000700,2008,Merton 012,Merton,E09000024,5861 ,2875 ,2986 
E02000701,2008,Merton 013,Merton,E09000024,5480 ,2739 ,2741 
E02000702,2008,Merton 014,Merton,E09000024,4986 ,2375 ,2611 
E02000703,2008,Merton 015,Merton,E09000024,5291 ,2672 ,2619 
E02000704,2008,Merton 016,Merton,E09000024,5564 ,2816 ,2748 
E02000705,2008,Merton 017,Merton,E09000024,5241 ,2460 ,2781 
E02000706,2008,Merton 018,Merton,E09000024,5362 ,2512 ,2850 
E02000707,2008,Merton 019,Merton,E09000024,4757 ,2240 ,2517 
E02000708,2008,Merton 020,Merton,E09000024,5543 ,2739 ,2804 
E02000709,2008,Merton 021,Merton,E09000024,4989 ,2462 ,2527 
E02000710,2008,Merton 022,Merton,E09000024,5203 ,2520 ,2683 
E02000711,2008,Merton 023,Merton,E09000024,5413 ,2730 ,2683 
E02000712,2008,Merton 024,Merton,E09000024,5287 ,2610 ,2677 
E02000713,2008,Merton 025,Merton,E09000024,4767 ,2366 ,2401 
E02000714,2008,Newham 001,Newham,E09000025,5015 ,2573 ,2442 
E02000715,2008,Newham 002,Newham,E09000025,4296 ,2248 ,2048 
E02000716,2008,Newham 003,Newham,E09000025,4561 ,2434 ,2127 
E02000717,2008,Newham 004,Newham,E09000025,4957 ,2644 ,2313 
E02000718,2008,Newham 005,Newham,E09000025,3885 ,1883 ,2002 
E02000719,2008,Newham 006,Newham,E09000025,5295 ,2706 ,2589 
E02000720,2008,Newham 007,Newham,E09000025,4855 ,2638 ,2217 
E02000721,2008,Newham 008,Newham,E09000025,6213 ,3392 ,2821 
E02000722,2008,Newham 009,Newham,E09000025,5294 ,2751 ,2543 
E02000723,2008,Newham 010,Newham,E09000025,6726 ,3761 ,2965 
E02000724,2008,Newham 011,Newham,E09000025,5993 ,3363 ,2630 
E02000725,2008,Newham 012,Newham,E09000025,5640 ,2906 ,2734 
E02000726,2008,Newham 013,Newham,E09000025,5554 ,2988 ,2566 
E02000727,2008,Newham 014,Newham,E09000025,5279 ,3028 ,2251 
E02000728,2008,Newham 015,Newham,E09000025,5568 ,3146 ,2422 
E02000729,2008,Newham 016,Newham,E09000025,4513 ,2357 ,2156 
E02000730,2008,Newham 017,Newham,E09000025,5732 ,3181 ,2551 
E02000731,2008,Newham 018,Newham,E09000025,6184 ,3594 ,2590 
E02000732,2008,Newham 019,Newham,E09000025,4509 ,2421 ,2088 
E02000733,2008,Newham 020,Newham,E09000025,6071 ,3028 ,3043 
E02000734,2008,Newham 021,Newham,E09000025,4354 ,2183 ,2171 
E02000735,2008,Newham 022,Newham,E09000025,4574 ,2495 ,2079 
E02000736,2008,Newham 023,Newham,E09000025,5045 ,2555 ,2490 
E02000737,2008,Newham 024,Newham,E09000025,5391 ,2703 ,2688 
E02000738,2008,Newham 025,Newham,E09000025,5135 ,2679 ,2456 
E02000739,2008,Newham 026,Newham,E09000025,4321 ,2208 ,2113 
E02000740,2008,Newham 027,Newham,E09000025,4307 ,2091 ,2216 
E02000741,2008,Newham 028,Newham,E09000025,4953 ,2496 ,2457 
E02000742,2008,Newham 029,Newham,E09000025,4531 ,2258 ,2273 
E02000743,2008,Newham 030,Newham,E09000025,4580 ,2305 ,2275 
E02000744,2008,Newham 031,Newham,E09000025,4705 ,2321 ,2384 
E02000745,2008,Newham 032,Newham,E09000025,5366 ,2632 ,2734 
E02000746,2008,Newham 033,Newham,E09000025,4577 ,2140 ,2437 
E02000747,2008,Newham 034,Newham,E09000025,6487 ,3369 ,3118 
E02000748,2008,Newham 035,Newham,E09000025,4223 ,2072 ,2151 
E02000749,2008,Newham 036,Newham,E09000025,4988 ,2407 ,2581 
E02000750,2008,Newham 037,Newham,E09000025,6565 ,3386 ,3179 
E02000751,2008,Redbridge 001,Redbridge,E09000026,6581 ,3221 ,3360 
E02000752,2008,Redbridge 002,Redbridge,E09000026,3978 ,1894 ,2084 
E02000753,2008,Redbridge 003,Redbridge,E09000026,3814 ,1775 ,2039 
E02000754,2008,Redbridge 004,Redbridge,E09000026,4181 ,2032 ,2149 
E02000755,2008,Redbridge 005,Redbridge,E09000026,3429 ,1635 ,1794 
E02000756,2008,Redbridge 006,Redbridge,E09000026,8192 ,3988 ,4204 
E02000757,2008,Redbridge 007,Redbridge,E09000026,7541 ,3798 ,3743 
E02000758,2008,Redbridge 008,Redbridge,E09000026,3749 ,1818 ,1931 
E02000759,2008,Redbridge 009,Redbridge,E09000026,7954 ,3944 ,4010 
E02000760,2008,Redbridge 010,Redbridge,E09000026,4073 ,1924 ,2149 
E02000762,2008,Redbridge 012,Redbridge,E09000026,4027 ,2028 ,1999 
E02000763,2008,Redbridge 013,Redbridge,E09000026,4363 ,2132 ,2231 
E02000764,2008,Redbridge 014,Redbridge,E09000026,7858 ,3893 ,3965 
E02000765,2008,Redbridge 015,Redbridge,E09000026,3945 ,1951 ,1994 
E02000767,2008,Redbridge 017,Redbridge,E09000026,4814 ,2340 ,2474 
E02000768,2008,Redbridge 018,Redbridge,E09000026,3882 ,1895 ,1987 
E02000769,2008,Redbridge 019,Redbridge,E09000026,8850 ,4245 ,4605 
E02000770,2008,Redbridge 020,Redbridge,E09000026,4739 ,2429 ,2310 
E02000772,2008,Redbridge 022,Redbridge,E09000026,4880 ,2511 ,2369 
E02000773,2008,Redbridge 023,Redbridge,E09000026,5622 ,2781 ,2841 
E02000774,2008,Redbridge 024,Redbridge,E09000026,4740 ,2487 ,2253 
E02000776,2008,Redbridge 026,Redbridge,E09000026,4112 ,2072 ,2040 
E02000777,2008,Redbridge 027,Redbridge,E09000026,4117 ,2046 ,2071 
E02000779,2008,Redbridge 029,Redbridge,E09000026,5089 ,2714 ,2375 
E02000780,2008,Redbridge 030,Redbridge,E09000026,8590 ,4436 ,4154 
E02000781,2008,Redbridge 031,Redbridge,E09000026,8206 ,4165 ,4041 
E02000782,2008,Redbridge 032,Redbridge,E09000026,5427 ,2788 ,2639 
E02000783,2008,Redbridge 033,Redbridge,E09000026,4159 ,2081 ,2078 
E02006800,2008,Redbridge 034,Redbridge,E09000026,8676 ,4429 ,4247 
E02006924,2008,Redbridge 035,Redbridge,E09000026,8280 ,4276 ,4004 
E02006925,2008,Redbridge 036,Redbridge,E09000026,8352 ,4058 ,4294 
E02000784,2008,Richmond upon Thames 001,Richmond upon Thames,E09000027,7092 ,3518 ,3574 
E02000785,2008,Richmond upon Thames 002,Richmond upon Thames,E09000027,6829 ,3419 ,3410 
E02000786,2008,Richmond upon Thames 003,Richmond upon Thames,E09000027,7607 ,3763 ,3844 
E02000787,2008,Richmond upon Thames 004,Richmond upon Thames,E09000027,7359 ,3620 ,3739 
E02000788,2008,Richmond upon Thames 005,Richmond upon Thames,E09000027,5724 ,2845 ,2879 
E02000789,2008,Richmond upon Thames 006,Richmond upon Thames,E09000027,4407 ,2279 ,2128 
E02000790,2008,Richmond upon Thames 007,Richmond upon Thames,E09000027,4209 ,2157 ,2052 
E02000791,2008,Richmond upon Thames 008,Richmond upon Thames,E09000027,4615 ,2442 ,2173 
E02000792,2008,Richmond upon Thames 009,Richmond upon Thames,E09000027,4757 ,2379 ,2378 
E02000793,2008,Richmond upon Thames 010,Richmond upon Thames,E09000027,5302 ,2639 ,2663 
E02000794,2008,Richmond upon Thames 011,Richmond upon Thames,E09000027,4470 ,2209 ,2261 
E02000795,2008,Richmond upon Thames 012,Richmond upon Thames,E09000027,4168 ,2110 ,2058 
E02000796,2008,Richmond upon Thames 013,Richmond upon Thames,E09000027,6585 ,3291 ,3294 
E02000797,2008,Richmond upon Thames 014,Richmond upon Thames,E09000027,5152 ,2642 ,2510 
E02000798,2008,Richmond upon Thames 015,Richmond upon Thames,E09000027,7199 ,3524 ,3675 
E02000799,2008,Richmond upon Thames 016,Richmond upon Thames,E09000027,4566 ,2253 ,2313 
E02000800,2008,Richmond upon Thames 017,Richmond upon Thames,E09000027,3302 ,1567 ,1735 
E02000801,2008,Richmond upon Thames 018,Richmond upon Thames,E09000027,4495 ,2156 ,2339 
E02000802,2008,Richmond upon Thames 019,Richmond upon Thames,E09000027,4344 ,2136 ,2208 
E02000803,2008,Richmond upon Thames 020,Richmond upon Thames,E09000027,6122 ,2950 ,3172 
E02000804,2008,Richmond upon Thames 021,Richmond upon Thames,E09000027,4619 ,2262 ,2357 
E02000805,2008,Richmond upon Thames 022,Richmond upon Thames,E09000027,6719 ,3297 ,3422 
E02000806,2008,Richmond upon Thames 023,Richmond upon Thames,E09000027,6304 ,3085 ,3219 
E02000807,2008,Southwark 001,Southwark,E09000028,6518 ,3534 ,2984 
E02000808,2008,Southwark 002,Southwark,E09000028,6938 ,3703 ,3235 
E02000809,2008,Southwark 003,Southwark,E09000028,9144 ,5131 ,4013 
E02000810,2008,Southwark 004,Southwark,E09000028,5818 ,2940 ,2878 
E02000812,2008,Southwark 006,Southwark,E09000028,7428 ,3761 ,3667 
E02000813,2008,Southwark 007,Southwark,E09000028,5790 ,2983 ,2807 
E02000814,2008,Southwark 008,Southwark,E09000028,6963 ,3708 ,3255 
E02000815,2008,Southwark 009,Southwark,E09000028,6293 ,3321 ,2972 
E02000816,2008,Southwark 010,Southwark,E09000028,5643 ,2736 ,2907 
E02000817,2008,Southwark 011,Southwark,E09000028,4250 ,2039 ,2211 
E02000818,2008,Southwark 012,Southwark,E09000028,5777 ,2891 ,2886 
E02000819,2008,Southwark 013,Southwark,E09000028,5306 ,2644 ,2662 
E02000820,2008,Southwark 014,Southwark,E09000028,5986 ,3064 ,2922 
E02000821,2008,Southwark 015,Southwark,E09000028,5695 ,2765 ,2930 
E02000822,2008,Southwark 016,Southwark,E09000028,5707 ,2842 ,2865 
E02000823,2008,Southwark 017,Southwark,E09000028,5429 ,2704 ,2725 
E02000824,2008,Southwark 018,Southwark,E09000028,6050 ,2895 ,3155 
E02000825,2008,Southwark 019,Southwark,E09000028,6023 ,2851 ,3172 
E02000826,2008,Southwark 020,Southwark,E09000028,6015 ,2955 ,3060 
E02000827,2008,Southwark 021,Southwark,E09000028,7362 ,3701 ,3661 
E02000828,2008,Southwark 022,Southwark,E09000028,5734 ,2836 ,2898 
E02000829,2008,Southwark 023,Southwark,E09000028,6933 ,3619 ,3314 
E02000830,2008,Southwark 024,Southwark,E09000028,6432 ,3167 ,3265 
E02000831,2008,Southwark 025,Southwark,E09000028,6388 ,3199 ,3189 
E02000832,2008,Southwark 026,Southwark,E09000028,6512 ,3057 ,3455 
E02000833,2008,Southwark 027,Southwark,E09000028,5603 ,2580 ,3023 
E02000834,2008,Southwark 028,Southwark,E09000028,7027 ,3354 ,3673 
E02000835,2008,Southwark 029,Southwark,E09000028,4894 ,2412 ,2482 
E02000836,2008,Southwark 030,Southwark,E09000028,5972 ,2890 ,3082 
E02000837,2008,Southwark 031,Southwark,E09000028,5457 ,2654 ,2803 
E02000838,2008,Southwark 032,Southwark,E09000028,6372 ,3073 ,3299 
E02000839,2008,Southwark 033,Southwark,E09000028,5489 ,2710 ,2779 
E02006802,2008,Southwark 034,Southwark,E09000028,6101 ,3156 ,2945 
E02000840,2008,Sutton 001,Sutton,E09000029,5192 ,2441 ,2751 
E02000841,2008,Sutton 002,Sutton,E09000029,5564 ,2649 ,2915 
E02000842,2008,Sutton 003,Sutton,E09000029,4986 ,2500 ,2486 
E02000843,2008,Sutton 004,Sutton,E09000029,5385 ,2623 ,2762 
E02000844,2008,Sutton 005,Sutton,E09000029,4919 ,2377 ,2542 
E02000845,2008,Sutton 006,Sutton,E09000029,5590 ,2679 ,2911 
E02000846,2008,Sutton 007,Sutton,E09000029,4420 ,2203 ,2217 
E02000847,2008,Sutton 008,Sutton,E09000029,5550 ,2737 ,2813 
E02000848,2008,Sutton 009,Sutton,E09000029,5071 ,2499 ,2572 
E02000849,2008,Sutton 010,Sutton,E09000029,4980 ,2460 ,2520 
E02000850,2008,Sutton 011,Sutton,E09000029,6758 ,3351 ,3407 
E02000851,2008,Sutton 012,Sutton,E09000029,5620 ,2926 ,2694 
E02000852,2008,Sutton 013,Sutton,E09000029,5185 ,2581 ,2604 
E02000853,2008,Sutton 014,Sutton,E09000029,4952 ,2392 ,2560 
E02000854,2008,Sutton 015,Sutton,E09000029,4644 ,2268 ,2376 
E02000855,2008,Sutton 016,Sutton,E09000029,4891 ,2401 ,2490 
E02000856,2008,Sutton 017,Sutton,E09000029,5465 ,2711 ,2754 
E02000857,2008,Sutton 018,Sutton,E09000029,5460 ,2769 ,2691 
E02000858,2008,Sutton 019,Sutton,E09000029,4651 ,2182 ,2469 
E02000859,2008,Sutton 020,Sutton,E09000029,5322 ,2628 ,2694 
E02000860,2008,Sutton 021,Sutton,E09000029,5106 ,2607 ,2499 
E02000861,2008,Sutton 022,Sutton,E09000029,5074 ,2475 ,2599 
E02000863,2008,Sutton 024,Sutton,E09000029,4131 ,2022 ,2109 
E02006836,2008,Sutton 025,Sutton,E09000029,5195 ,2564 ,2631 
E02000864,2008,Tower Hamlets 001,Tower Hamlets,E09000030,5156 ,2502 ,2654 
E02000865,2008,Tower Hamlets 002,Tower Hamlets,E09000030,4815 ,2416 ,2399 
E02000866,2008,Tower Hamlets 003,Tower Hamlets,E09000030,6769 ,3377 ,3392 
E02000867,2008,Tower Hamlets 004,Tower Hamlets,E09000030,6251 ,3173 ,3078 
E02000868,2008,Tower Hamlets 005,Tower Hamlets,E09000030,4796 ,2451 ,2345 
E02000869,2008,Tower Hamlets 006,Tower Hamlets,E09000030,3918 ,2026 ,1892 
E02000870,2008,Tower Hamlets 007,Tower Hamlets,E09000030,4351 ,2140 ,2211 
E02000871,2008,Tower Hamlets 008,Tower Hamlets,E09000030,5243 ,2718 ,2525 
E02000872,2008,Tower Hamlets 009,Tower Hamlets,E09000030,5167 ,2762 ,2405 
E02000873,2008,Tower Hamlets 010,Tower Hamlets,E09000030,6120 ,3035 ,3085 
E02000874,2008,Tower Hamlets 011,Tower Hamlets,E09000030,5097 ,2595 ,2502 
E02000875,2008,Tower Hamlets 012,Tower Hamlets,E09000030,6060 ,3100 ,2960 
E02000876,2008,Tower Hamlets 013,Tower Hamlets,E09000030,5011 ,2673 ,2338 
E02000877,2008,Tower Hamlets 014,Tower Hamlets,E09000030,6399 ,3326 ,3073 
E02000878,2008,Tower Hamlets 015,Tower Hamlets,E09000030,7466 ,4065 ,3401 
E02000879,2008,Tower Hamlets 016,Tower Hamlets,E09000030,4844 ,2411 ,2433 
E02000880,2008,Tower Hamlets 017,Tower Hamlets,E09000030,4007 ,2104 ,1903 
E02000881,2008,Tower Hamlets 018,Tower Hamlets,E09000030,4283 ,2151 ,2132 
E02000882,2008,Tower Hamlets 019,Tower Hamlets,E09000030,5241 ,2622 ,2619 
E02000883,2008,Tower Hamlets 020,Tower Hamlets,E09000030,4924 ,2434 ,2490 
E02000884,2008,Tower Hamlets 021,Tower Hamlets,E09000030,6096 ,3486 ,2610 
E02000885,2008,Tower Hamlets 022,Tower Hamlets,E09000030,4438 ,2245 ,2193 
E02000886,2008,Tower Hamlets 023,Tower Hamlets,E09000030,5252 ,2876 ,2376 
E02000887,2008,Tower Hamlets 024,Tower Hamlets,E09000030,5473 ,2739 ,2734 
E02000888,2008,Tower Hamlets 025,Tower Hamlets,E09000030,5230 ,2848 ,2382 
E02000889,2008,Tower Hamlets 026,Tower Hamlets,E09000030,4831 ,2626 ,2205 
E02000890,2008,Tower Hamlets 027,Tower Hamlets,E09000030,4453 ,2414 ,2039 
E02000891,2008,Tower Hamlets 028,Tower Hamlets,E09000030,8280 ,4494 ,3786 
E02000893,2008,Tower Hamlets 030,Tower Hamlets,E09000030,5016 ,2609 ,2407 
E02000894,2008,Tower Hamlets 031,Tower Hamlets,E09000030,7529 ,4077 ,3452 
E02006853,2008,Tower Hamlets 032,Tower Hamlets,E09000030,4002 ,2126 ,1876 
E02006854,2008,Tower Hamlets 033,Tower Hamlets,E09000030,3317 ,1961 ,1356 
E02000895,2008,Waltham Forest 001,Waltham Forest,E09000031,4694 ,2269 ,2425 
E02000896,2008,Waltham Forest 002,Waltham Forest,E09000031,5484 ,2707 ,2777 
E02000897,2008,Waltham Forest 003,Waltham Forest,E09000031,4919 ,2333 ,2586 
E02000898,2008,Waltham Forest 004,Waltham Forest,E09000031,4805 ,2296 ,2509 
E02000899,2008,Waltham Forest 005,Waltham Forest,E09000031,5108 ,2472 ,2636 
E02000900,2008,Waltham Forest 006,Waltham Forest,E09000031,5177 ,2432 ,2745 
E02000901,2008,Waltham Forest 007,Waltham Forest,E09000031,6135 ,2945 ,3190 
E02000902,2008,Waltham Forest 008,Waltham Forest,E09000031,5242 ,2538 ,2704 
E02000903,2008,Waltham Forest 009,Waltham Forest,E09000031,5712 ,2759 ,2953 
E02000904,2008,Waltham Forest 010,Waltham Forest,E09000031,5077 ,2490 ,2587 
E02000905,2008,Waltham Forest 011,Waltham Forest,E09000031,6040 ,3001 ,3039 
E02000906,2008,Waltham Forest 012,Waltham Forest,E09000031,6039 ,2999 ,3040 
E02000907,2008,Waltham Forest 013,Waltham Forest,E09000031,6006 ,2859 ,3147 
E02000908,2008,Waltham Forest 014,Waltham Forest,E09000031,6805 ,3659 ,3146 
E02000909,2008,Waltham Forest 015,Waltham Forest,E09000031,5612 ,2783 ,2829 
E02000910,2008,Waltham Forest 016,Waltham Forest,E09000031,7221 ,3788 ,3433 
E02000911,2008,Waltham Forest 017,Waltham Forest,E09000031,7133 ,3556 ,3577 
E02000912,2008,Waltham Forest 018,Waltham Forest,E09000031,5809 ,2840 ,2969 
E02000913,2008,Waltham Forest 019,Waltham Forest,E09000031,5762 ,2917 ,2845 
E02000914,2008,Waltham Forest 020,Waltham Forest,E09000031,6748 ,3481 ,3267 
E02000915,2008,Waltham Forest 021,Waltham Forest,E09000031,6284 ,3303 ,2981 
E02000916,2008,Waltham Forest 022,Waltham Forest,E09000031,5995 ,3000 ,2995 
E02000917,2008,Waltham Forest 023,Waltham Forest,E09000031,5928 ,2979 ,2949 
E02000918,2008,Waltham Forest 024,Waltham Forest,E09000031,6446 ,3405 ,3041 
E02000919,2008,Waltham Forest 025,Waltham Forest,E09000031,6261 ,3289 ,2972 
E02000920,2008,Waltham Forest 026,Waltham Forest,E09000031,6243 ,3091 ,3152 
E02000921,2008,Waltham Forest 027,Waltham Forest,E09000031,7293 ,3672 ,3621 
E02000922,2008,Waltham Forest 028,Waltham Forest,E09000031,7015 ,3805 ,3210 
E02000923,2008,Wandsworth 001,Wandsworth,E09000032,5154 ,2606 ,2548 
E02000924,2008,Wandsworth 002,Wandsworth,E09000032,7478 ,3668 ,3810 
E02000925,2008,Wandsworth 003,Wandsworth,E09000032,5090 ,2453 ,2637 
E02000926,2008,Wandsworth 004,Wandsworth,E09000032,6201 ,3135 ,3066 
E02000927,2008,Wandsworth 005,Wandsworth,E09000032,5102 ,2483 ,2619 
E02000928,2008,Wandsworth 006,Wandsworth,E09000032,6233 ,2998 ,3235 
E02000929,2008,Wandsworth 007,Wandsworth,E09000032,4813 ,2231 ,2582 
E02000930,2008,Wandsworth 008,Wandsworth,E09000032,7675 ,3828 ,3847 
E02000931,2008,Wandsworth 009,Wandsworth,E09000032,6572 ,3327 ,3245 
E02000932,2008,Wandsworth 010,Wandsworth,E09000032,7936 ,3965 ,3971 
E02000933,2008,Wandsworth 011,Wandsworth,E09000032,6308 ,3053 ,3255 
E02000934,2008,Wandsworth 012,Wandsworth,E09000032,7159 ,3620 ,3539 
E02000935,2008,Wandsworth 013,Wandsworth,E09000032,4879 ,2030 ,2849 
E02000936,2008,Wandsworth 014,Wandsworth,E09000032,6446 ,3107 ,3339 
E02000937,2008,Wandsworth 015,Wandsworth,E09000032,5812 ,2944 ,2868 
E02000938,2008,Wandsworth 016,Wandsworth,E09000032,6498 ,3092 ,3406 
E02000939,2008,Wandsworth 017,Wandsworth,E09000032,5383 ,2695 ,2688 
E02000940,2008,Wandsworth 018,Wandsworth,E09000032,5575 ,2711 ,2864 
E02000941,2008,Wandsworth 019,Wandsworth,E09000032,7779 ,4084 ,3695 
E02000942,2008,Wandsworth 020,Wandsworth,E09000032,6693 ,3243 ,3450 
E02000943,2008,Wandsworth 021,Wandsworth,E09000032,6452 ,3277 ,3175 
E02000944,2008,Wandsworth 022,Wandsworth,E09000032,4883 ,2238 ,2645 
E02000945,2008,Wandsworth 023,Wandsworth,E09000032,5325 ,2400 ,2925 
E02000946,2008,Wandsworth 024,Wandsworth,E09000032,6064 ,3217 ,2847 
E02000947,2008,Wandsworth 025,Wandsworth,E09000032,6599 ,3130 ,3469 
E02000948,2008,Wandsworth 026,Wandsworth,E09000032,7847 ,3912 ,3935 
E02000949,2008,Wandsworth 027,Wandsworth,E09000032,7154 ,3529 ,3625 
E02000950,2008,Wandsworth 028,Wandsworth,E09000032,5660 ,2726 ,2934 
E02000951,2008,Wandsworth 029,Wandsworth,E09000032,5139 ,2544 ,2595 
E02000952,2008,Wandsworth 030,Wandsworth,E09000032,4639 ,2324 ,2315 
E02000953,2008,Wandsworth 031,Wandsworth,E09000032,4914 ,2259 ,2655 
E02000954,2008,Wandsworth 032,Wandsworth,E09000032,4435 ,2126 ,2309 
E02000955,2008,Wandsworth 033,Wandsworth,E09000032,4598 ,2199 ,2399 
E02000956,2008,Wandsworth 034,Wandsworth,E09000032,5353 ,2555 ,2798 
E02000957,2008,Wandsworth 035,Wandsworth,E09000032,7349 ,3646 ,3703 
E02000958,2008,Wandsworth 036,Wandsworth,E09000032,5761 ,2759 ,3002 
E02000959,2008,Wandsworth 037,Wandsworth,E09000032,5194 ,2570 ,2624 
E02000960,2008,Westminster 001,Westminster,E09000033,4716 ,2241 ,2475 
E02000961,2008,Westminster 002,Westminster,E09000033,6203 ,2947 ,3256 
E02000962,2008,Westminster 003,Westminster,E09000033,6150 ,3044 ,3106 
E02000963,2008,Westminster 004,Westminster,E09000033,6666 ,3059 ,3607 
E02000964,2008,Westminster 005,Westminster,E09000033,8729 ,4120 ,4609 
E02000965,2008,Westminster 006,Westminster,E09000033,7118 ,3496 ,3622 
E02000966,2008,Westminster 007,Westminster,E09000033,7240 ,3603 ,3637 
E02000967,2008,Westminster 008,Westminster,E09000033,6015 ,3256 ,2759 
E02000968,2008,Westminster 009,Westminster,E09000033,9706 ,4651 ,5055 
E02000969,2008,Westminster 010,Westminster,E09000033,6517 ,3115 ,3402 
E02000970,2008,Westminster 011,Westminster,E09000033,7611 ,4087 ,3524 
E02000971,2008,Westminster 012,Westminster,E09000033,7392 ,4003 ,3389 
E02000972,2008,Westminster 013,Westminster,E09000033,6911 ,3925 ,2986 
E02000973,2008,Westminster 014,Westminster,E09000033,7558 ,3813 ,3745 
E02000974,2008,Westminster 015,Westminster,E09000033,6904 ,3766 ,3138 
E02000975,2008,Westminster 016,Westminster,E09000033,7581 ,4109 ,3472 
E02000976,2008,Westminster 017,Westminster,E09000033,8151 ,4307 ,3844 
E02000977,2008,Westminster 018,Westminster,E09000033,6341 ,3676 ,2665 
E02000978,2008,Westminster 019,Westminster,E09000033,7425 ,3809 ,3616 
E02000979,2008,Westminster 020,Westminster,E09000033,6129 ,3178 ,2951 
E02000980,2008,Westminster 021,Westminster,E09000033,6121 ,3051 ,3070 
E02000981,2008,Westminster 022,Westminster,E09000033,7115 ,3686 ,3429 
E02000982,2008,Westminster 023,Westminster,E09000033,5550 ,2836 ,2714 
E02000983,2008,Westminster 024,Westminster,E09000033,6052 ,3007 ,3045 
E02000001,2009,City of London 001,City of London,E09000001,5932 ,3376 ,2556 
E02000002,2009,Barking and Dagenham 001,Barking and Dagenham,E09000002,3869 ,1801 ,2068 
E02000003,2009,Barking and Dagenham 002,Barking and Dagenham,E09000002,6520 ,3148 ,3372 
E02000004,2009,Barking and Dagenham 003,Barking and Dagenham,E09000002,3984 ,1949 ,2035 
E02000005,2009,Barking and Dagenham 004,Barking and Dagenham,E09000002,5322 ,2522 ,2800 
E02000007,2009,Barking and Dagenham 006,Barking and Dagenham,E09000002,5107 ,2398 ,2709 
E02000008,2009,Barking and Dagenham 007,Barking and Dagenham,E09000002,7147 ,3312 ,3835 
E02000009,2009,Barking and Dagenham 008,Barking and Dagenham,E09000002,5326 ,2617 ,2709 
E02000010,2009,Barking and Dagenham 009,Barking and Dagenham,E09000002,5300 ,2462 ,2838 
E02000011,2009,Barking and Dagenham 010,Barking and Dagenham,E09000002,3934 ,1961 ,1973 
E02000012,2009,Barking and Dagenham 011,Barking and Dagenham,E09000002,6008 ,2953 ,3055 
E02000013,2009,Barking and Dagenham 012,Barking and Dagenham,E09000002,5079 ,2416 ,2663 
E02000014,2009,Barking and Dagenham 013,Barking and Dagenham,E09000002,5897 ,2804 ,3093 
E02000015,2009,Barking and Dagenham 014,Barking and Dagenham,E09000002,4620 ,2201 ,2419 
E02000016,2009,Barking and Dagenham 015,Barking and Dagenham,E09000002,4279 ,2246 ,2033 
E02000017,2009,Barking and Dagenham 016,Barking and Dagenham,E09000002,5320 ,2845 ,2475 
E02000018,2009,Barking and Dagenham 017,Barking and Dagenham,E09000002,5332 ,2498 ,2834 
E02000019,2009,Barking and Dagenham 018,Barking and Dagenham,E09000002,5052 ,2399 ,2653 
E02000020,2009,Barking and Dagenham 019,Barking and Dagenham,E09000002,5410 ,2675 ,2735 
E02000021,2009,Barking and Dagenham 020,Barking and Dagenham,E09000002,4894 ,2351 ,2543 
E02000022,2009,Barking and Dagenham 021,Barking and Dagenham,E09000002,4948 ,2375 ,2573 
E02000023,2009,Barking and Dagenham 022,Barking and Dagenham,E09000002,3976 ,1920 ,2056 
E02006799,2009,Barking and Dagenham 023,Barking and Dagenham,E09000002,5968 ,2891 ,3077 
E02000024,2009,Barnet 001,Barnet,E09000003,6626 ,3238 ,3388 
E02000025,2009,Barnet 002,Barnet,E09000003,5565 ,2742 ,2823 
E02000026,2009,Barnet 003,Barnet,E09000003,4186 ,2004 ,2182 
E02000027,2009,Barnet 004,Barnet,E09000003,6440 ,3052 ,3388 
E02000028,2009,Barnet 005,Barnet,E09000003,4098 ,2048 ,2050 
E02000029,2009,Barnet 006,Barnet,E09000003,5902 ,2919 ,2983 
E02000030,2009,Barnet 007,Barnet,E09000003,5816 ,2774 ,3042 
E02000031,2009,Barnet 008,Barnet,E09000003,4535 ,2242 ,2293 
E02000032,2009,Barnet 009,Barnet,E09000003,5053 ,2441 ,2612 
E02000033,2009,Barnet 010,Barnet,E09000003,5604 ,2749 ,2855 
E02000034,2009,Barnet 011,Barnet,E09000003,5681 ,2705 ,2976 
E02000035,2009,Barnet 012,Barnet,E09000003,5544 ,2702 ,2842 
E02000036,2009,Barnet 013,Barnet,E09000003,6793 ,3255 ,3538 
E02000037,2009,Barnet 014,Barnet,E09000003,6009 ,2920 ,3089 
E02000038,2009,Barnet 015,Barnet,E09000003,7177 ,3644 ,3533 
E02000039,2009,Barnet 016,Barnet,E09000003,4277 ,2062 ,2215 
E02000040,2009,Barnet 017,Barnet,E09000003,4390 ,2086 ,2304 
E02000041,2009,Barnet 018,Barnet,E09000003,5566 ,2720 ,2846 
E02000042,2009,Barnet 019,Barnet,E09000003,7242 ,3614 ,3628 
E02000043,2009,Barnet 020,Barnet,E09000003,4957 ,2371 ,2586 
E02000044,2009,Barnet 021,Barnet,E09000003,5212 ,2420 ,2792 
E02000045,2009,Barnet 022,Barnet,E09000003,7126 ,3500 ,3626 
E02000046,2009,Barnet 023,Barnet,E09000003,4814 ,2362 ,2452 
E02000047,2009,Barnet 024,Barnet,E09000003,7005 ,3268 ,3737 
E02000048,2009,Barnet 025,Barnet,E09000003,6174 ,2996 ,3178 
E02000049,2009,Barnet 026,Barnet,E09000003,5423 ,2476 ,2947 
E02000050,2009,Barnet 027,Barnet,E09000003,6725 ,3180 ,3545 
E02000051,2009,Barnet 028,Barnet,E09000003,5404 ,2679 ,2725 
E02000052,2009,Barnet 029,Barnet,E09000003,6674 ,3181 ,3493 
E02000053,2009,Barnet 030,Barnet,E09000003,5919 ,3013 ,2906 
E02000054,2009,Barnet 031,Barnet,E09000003,4860 ,2362 ,2498 
E02000055,2009,Barnet 032,Barnet,E09000003,7132 ,3521 ,3611 
E02000056,2009,Barnet 033,Barnet,E09000003,5426 ,2544 ,2882 
E02000057,2009,Barnet 034,Barnet,E09000003,4544 ,2241 ,2303 
E02000058,2009,Barnet 035,Barnet,E09000003,6128 ,2824 ,3304 
E02000059,2009,Barnet 036,Barnet,E09000003,7022 ,3540 ,3482 
E02000060,2009,Barnet 037,Barnet,E09000003,6231 ,3034 ,3197 
E02000061,2009,Barnet 038,Barnet,E09000003,5163 ,2523 ,2640 
E02000062,2009,Barnet 039,Barnet,E09000003,4140 ,1966 ,2174 
E02000063,2009,Barnet 040,Barnet,E09000003,4524 ,2171 ,2353 
E02000064,2009,Barnet 041,Barnet,E09000003,4106 ,1923 ,2183 
E02000065,2009,Bexley 001,Bexley,E09000004,4528 ,2158 ,2370 
E02000066,2009,Bexley 002,Bexley,E09000004,6386 ,3051 ,3335 
E02000067,2009,Bexley 003,Bexley,E09000004,5543 ,2669 ,2874 
E02000068,2009,Bexley 004,Bexley,E09000004,4694 ,2304 ,2390 
E02000069,2009,Bexley 005,Bexley,E09000004,3870 ,1901 ,1969 
E02000070,2009,Bexley 006,Bexley,E09000004,5011 ,2417 ,2594 
E02000071,2009,Bexley 007,Bexley,E09000004,4934 ,2378 ,2556 
E02000072,2009,Bexley 008,Bexley,E09000004,7287 ,3424 ,3863 
E02000073,2009,Bexley 009,Bexley,E09000004,6669 ,3304 ,3365 
E02000074,2009,Bexley 010,Bexley,E09000004,4782 ,2267 ,2515 
E02000075,2009,Bexley 011,Bexley,E09000004,5048 ,2468 ,2580 
E02000077,2009,Bexley 013,Bexley,E09000004,4966 ,2406 ,2560 
E02000078,2009,Bexley 014,Bexley,E09000004,5118 ,2516 ,2602 
E02000079,2009,Bexley 015,Bexley,E09000004,5080 ,2506 ,2574 
E02000080,2009,Bexley 016,Bexley,E09000004,5972 ,2973 ,2999 
E02000081,2009,Bexley 017,Bexley,E09000004,4765 ,2359 ,2406 
E02000082,2009,Bexley 018,Bexley,E09000004,5761 ,2884 ,2877 
E02000083,2009,Bexley 019,Bexley,E09000004,6152 ,3001 ,3151 
E02000084,2009,Bexley 020,Bexley,E09000004,6965 ,3408 ,3557 
E02000085,2009,Bexley 021,Bexley,E09000004,4984 ,2436 ,2548 
E02000086,2009,Bexley 022,Bexley,E09000004,4856 ,2338 ,2518 
E02000087,2009,Bexley 023,Bexley,E09000004,4549 ,2303 ,2246 
E02000088,2009,Bexley 024,Bexley,E09000004,4936 ,2433 ,2503 
E02000089,2009,Bexley 025,Bexley,E09000004,4913 ,2383 ,2530 
E02000090,2009,Bexley 026,Bexley,E09000004,5441 ,2621 ,2820 
E02000091,2009,Bexley 027,Bexley,E09000004,6018 ,2892 ,3126 
E02000092,2009,Bexley 028,Bexley,E09000004,3878 ,1807 ,2071 
E02006785,2009,Bexley 029,Bexley,E09000004,3994 ,1951 ,2043 
E02000093,2009,Brent 001,Brent,E09000005,7111 ,3509 ,3602 
E02000094,2009,Brent 002,Brent,E09000005,5493 ,2719 ,2774 
E02000095,2009,Brent 003,Brent,E09000005,6423 ,3252 ,3171 
E02000096,2009,Brent 004,Brent,E09000005,4750 ,2366 ,2384 
E02000097,2009,Brent 005,Brent,E09000005,5720 ,2881 ,2839 
E02000098,2009,Brent 006,Brent,E09000005,5060 ,2546 ,2514 
E02000099,2009,Brent 007,Brent,E09000005,5417 ,2691 ,2726 
E02000100,2009,Brent 008,Brent,E09000005,5726 ,2714 ,3012 
E02000101,2009,Brent 009,Brent,E09000005,5850 ,2877 ,2973 
E02000102,2009,Brent 010,Brent,E09000005,5040 ,2520 ,2520 
E02000103,2009,Brent 011,Brent,E09000005,5656 ,2861 ,2795 
E02000104,2009,Brent 012,Brent,E09000005,4361 ,2283 ,2078 
E02000105,2009,Brent 013,Brent,E09000005,5812 ,3016 ,2796 
E02000106,2009,Brent 014,Brent,E09000005,7041 ,3655 ,3386 
E02000107,2009,Brent 015,Brent,E09000005,8275 ,4408 ,3867 
E02000108,2009,Brent 016,Brent,E09000005,4393 ,2307 ,2086 
E02000109,2009,Brent 017,Brent,E09000005,6184 ,3259 ,2925 
E02000110,2009,Brent 018,Brent,E09000005,6209 ,3195 ,3014 
E02000111,2009,Brent 019,Brent,E09000005,6172 ,3182 ,2990 
E02000112,2009,Brent 020,Brent,E09000005,6062 ,3208 ,2854 
E02000113,2009,Brent 021,Brent,E09000005,6033 ,2835 ,3198 
E02000114,2009,Brent 022,Brent,E09000005,6812 ,3501 ,3311 
E02000115,2009,Brent 023,Brent,E09000005,6345 ,3237 ,3108 
E02000116,2009,Brent 024,Brent,E09000005,5505 ,2803 ,2702 
E02000117,2009,Brent 025,Brent,E09000005,7799 ,3834 ,3965 
E02000118,2009,Brent 026,Brent,E09000005,6246 ,3229 ,3017 
E02000119,2009,Brent 027,Brent,E09000005,4316 ,2069 ,2247 
E02000120,2009,Brent 028,Brent,E09000005,6673 ,3282 ,3391 
E02000121,2009,Brent 029,Brent,E09000005,6027 ,3140 ,2887 
E02000122,2009,Brent 030,Brent,E09000005,5414 ,2597 ,2817 
E02000123,2009,Brent 031,Brent,E09000005,10074 ,5175 ,4899 
E02000124,2009,Brent 032,Brent,E09000005,7392 ,3667 ,3725 
E02000125,2009,Brent 033,Brent,E09000005,7501 ,3699 ,3802 
E02000126,2009,Brent 034,Brent,E09000005,5022 ,2423 ,2599 
E02000127,2009,Bromley 001,Bromley,E09000006,5523 ,2525 ,2998 
E02000128,2009,Bromley 002,Bromley,E09000006,4749 ,2246 ,2503 
E02000130,2009,Bromley 004,Bromley,E09000006,5438 ,2591 ,2847 
E02000131,2009,Bromley 005,Bromley,E09000006,6628 ,3261 ,3367 
E02000132,2009,Bromley 006,Bromley,E09000006,6009 ,2991 ,3018 
E02000133,2009,Bromley 007,Bromley,E09000006,5923 ,2915 ,3008 
E02000134,2009,Bromley 008,Bromley,E09000006,7425 ,3671 ,3754 
E02000135,2009,Bromley 009,Bromley,E09000006,6671 ,3145 ,3526 
E02000136,2009,Bromley 010,Bromley,E09000006,3366 ,1645 ,1721 
E02000137,2009,Bromley 011,Bromley,E09000006,5044 ,2478 ,2566 
E02000138,2009,Bromley 012,Bromley,E09000006,5066 ,2579 ,2487 
E02000139,2009,Bromley 013,Bromley,E09000006,4988 ,2386 ,2602 
E02000140,2009,Bromley 014,Bromley,E09000006,4789 ,2212 ,2577 
E02000141,2009,Bromley 015,Bromley,E09000006,4890 ,2402 ,2488 
E02000142,2009,Bromley 016,Bromley,E09000006,5411 ,2645 ,2766 
E02000144,2009,Bromley 018,Bromley,E09000006,5824 ,2938 ,2886 
E02000145,2009,Bromley 019,Bromley,E09000006,4919 ,2273 ,2646 
E02000146,2009,Bromley 020,Bromley,E09000006,5306 ,2609 ,2697 
E02000147,2009,Bromley 021,Bromley,E09000006,4852 ,2417 ,2435 
E02000148,2009,Bromley 022,Bromley,E09000006,4022 ,1926 ,2096 
E02000149,2009,Bromley 023,Bromley,E09000006,4975 ,2373 ,2602 
E02000150,2009,Bromley 024,Bromley,E09000006,5271 ,2550 ,2721 
E02000151,2009,Bromley 025,Bromley,E09000006,4662 ,2239 ,2423 
E02000152,2009,Bromley 026,Bromley,E09000006,4099 ,1927 ,2172 
E02000153,2009,Bromley 027,Bromley,E09000006,4949 ,2402 ,2547 
E02000154,2009,Bromley 028,Bromley,E09000006,5095 ,2540 ,2555 
E02000155,2009,Bromley 029,Bromley,E09000006,4242 ,2077 ,2165 
E02000156,2009,Bromley 030,Bromley,E09000006,7405 ,3619 ,3786 
E02000157,2009,Bromley 031,Bromley,E09000006,4738 ,2303 ,2435 
E02000158,2009,Bromley 032,Bromley,E09000006,4463 ,2125 ,2338 
E02000159,2009,Bromley 033,Bromley,E09000006,4158 ,2000 ,2158 
E02000160,2009,Bromley 034,Bromley,E09000006,4934 ,2452 ,2482 
E02000161,2009,Bromley 035,Bromley,E09000006,5273 ,2578 ,2695 
E02000162,2009,Bromley 036,Bromley,E09000006,3967 ,1847 ,2120 
E02000163,2009,Bromley 037,Bromley,E09000006,4880 ,2423 ,2457 
E02000165,2009,Bromley 039,Bromley,E09000006,4870 ,2372 ,2498 
E02006782,2009,Bromley 040,Bromley,E09000006,4879 ,2292 ,2587 
E02006787,2009,Bromley 041,Bromley,E09000006,4957 ,2351 ,2606 
E02006789,2009,Bromley 042,Bromley,E09000006,4013 ,1928 ,2085 
E02000166,2009,Camden 001,Camden,E09000007,5354 ,2467 ,2887 
E02000167,2009,Camden 002,Camden,E09000007,5362 ,2622 ,2740 
E02000168,2009,Camden 003,Camden,E09000007,5765 ,2787 ,2978 
E02000169,2009,Camden 004,Camden,E09000007,4894 ,2273 ,2621 
E02000170,2009,Camden 005,Camden,E09000007,5997 ,2939 ,3058 
E02000171,2009,Camden 006,Camden,E09000007,5478 ,2646 ,2832 
E02000172,2009,Camden 007,Camden,E09000007,6874 ,3421 ,3453 
E02000173,2009,Camden 008,Camden,E09000007,5439 ,2652 ,2787 
E02000174,2009,Camden 009,Camden,E09000007,6310 ,2986 ,3324 
E02000175,2009,Camden 010,Camden,E09000007,6668 ,3184 ,3484 
E02000176,2009,Camden 011,Camden,E09000007,4691 ,2277 ,2414 
E02000177,2009,Camden 012,Camden,E09000007,5978 ,2794 ,3184 
E02000178,2009,Camden 013,Camden,E09000007,6861 ,3473 ,3388 
E02000179,2009,Camden 014,Camden,E09000007,4093 ,1937 ,2156 
E02000180,2009,Camden 015,Camden,E09000007,6054 ,2986 ,3068 
E02000181,2009,Camden 016,Camden,E09000007,5821 ,2776 ,3045 
E02000182,2009,Camden 017,Camden,E09000007,4339 ,1956 ,2383 
E02000183,2009,Camden 018,Camden,E09000007,5518 ,2705 ,2813 
E02000184,2009,Camden 019,Camden,E09000007,6304 ,3115 ,3189 
E02000185,2009,Camden 020,Camden,E09000007,5715 ,2739 ,2976 
E02000186,2009,Camden 021,Camden,E09000007,4808 ,2564 ,2244 
E02000187,2009,Camden 022,Camden,E09000007,5322 ,2511 ,2811 
E02000188,2009,Camden 023,Camden,E09000007,5739 ,2994 ,2745 
E02000189,2009,Camden 024,Camden,E09000007,4503 ,2271 ,2232 
E02000190,2009,Camden 025,Camden,E09000007,6095 ,3071 ,3024 
E02000191,2009,Camden 026,Camden,E09000007,6087 ,3298 ,2789 
E02000192,2009,Camden 027,Camden,E09000007,5002 ,2694 ,2308 
E02000193,2009,Camden 028,Camden,E09000007,6196 ,3272 ,2924 
E02000194,2009,Croydon 001,Croydon,E09000008,5881 ,2925 ,2956 
E02000195,2009,Croydon 002,Croydon,E09000008,5884 ,2899 ,2985 
E02000196,2009,Croydon 003,Croydon,E09000008,4816 ,2366 ,2450 
E02000197,2009,Croydon 004,Croydon,E09000008,5850 ,2817 ,3033 
E02000198,2009,Croydon 005,Croydon,E09000008,5331 ,2513 ,2818 
E02000199,2009,Croydon 006,Croydon,E09000008,5558 ,2616 ,2942 
E02000200,2009,Croydon 007,Croydon,E09000008,5861 ,2875 ,2986 
E02000201,2009,Croydon 008,Croydon,E09000008,5575 ,2678 ,2897 
E02000202,2009,Croydon 009,Croydon,E09000008,5740 ,2838 ,2902 
E02000203,2009,Croydon 010,Croydon,E09000008,5102 ,2488 ,2614 
E02000204,2009,Croydon 011,Croydon,E09000008,6292 ,3065 ,3227 
E02000206,2009,Croydon 013,Croydon,E09000008,6280 ,3031 ,3249 
E02000207,2009,Croydon 014,Croydon,E09000008,5808 ,2731 ,3077 
E02000208,2009,Croydon 015,Croydon,E09000008,5906 ,2906 ,3000 
E02000209,2009,Croydon 016,Croydon,E09000008,5361 ,2553 ,2808 
E02000210,2009,Croydon 017,Croydon,E09000008,5676 ,2737 ,2939 
E02000211,2009,Croydon 018,Croydon,E09000008,5095 ,2531 ,2564 
E02000212,2009,Croydon 019,Croydon,E09000008,5241 ,2536 ,2705 
E02000213,2009,Croydon 020,Croydon,E09000008,6435 ,3333 ,3102 
E02000214,2009,Croydon 021,Croydon,E09000008,4092 ,2063 ,2029 
E02000215,2009,Croydon 022,Croydon,E09000008,7471 ,3940 ,3531 
E02000216,2009,Croydon 023,Croydon,E09000008,4386 ,2309 ,2077 
E02000217,2009,Croydon 024,Croydon,E09000008,6171 ,3101 ,3070 
E02000218,2009,Croydon 025,Croydon,E09000008,4056 ,1838 ,2218 
E02000219,2009,Croydon 026,Croydon,E09000008,4764 ,2306 ,2458 
E02000220,2009,Croydon 027,Croydon,E09000008,6923 ,3692 ,3231 
E02000221,2009,Croydon 028,Croydon,E09000008,6081 ,2856 ,3225 
E02000222,2009,Croydon 029,Croydon,E09000008,5649 ,2834 ,2815 
E02000223,2009,Croydon 030,Croydon,E09000008,4799 ,2059 ,2740 
E02000224,2009,Croydon 031,Croydon,E09000008,5391 ,2744 ,2647 
E02000225,2009,Croydon 032,Croydon,E09000008,4706 ,2187 ,2519 
E02000226,2009,Croydon 033,Croydon,E09000008,4997 ,2501 ,2496 
E02000227,2009,Croydon 034,Croydon,E09000008,7683 ,3647 ,4036 
E02000228,2009,Croydon 035,Croydon,E09000008,4657 ,2280 ,2377 
E02000229,2009,Croydon 036,Croydon,E09000008,3652 ,1648 ,2004 
E02000230,2009,Croydon 037,Croydon,E09000008,6517 ,3274 ,3243 
E02000231,2009,Croydon 038,Croydon,E09000008,4979 ,2495 ,2484 
E02000232,2009,Croydon 039,Croydon,E09000008,3812 ,1834 ,1978 
E02000233,2009,Croydon 040,Croydon,E09000008,3846 ,1859 ,1987 
E02000234,2009,Croydon 041,Croydon,E09000008,5252 ,2542 ,2710 
E02000235,2009,Croydon 042,Croydon,E09000008,4497 ,2166 ,2331 
E02000236,2009,Croydon 043,Croydon,E09000008,4915 ,2414 ,2501 
E02000237,2009,Croydon 044,Croydon,E09000008,4531 ,2156 ,2375 
E02006788,2009,Croydon 045,Croydon,E09000008,4965 ,2166 ,2799 
E02000238,2009,Ealing 001,Ealing,E09000009,6329 ,3259 ,3070 
E02000239,2009,Ealing 002,Ealing,E09000009,6077 ,3141 ,2936 
E02000240,2009,Ealing 003,Ealing,E09000009,6445 ,3059 ,3386 
E02000241,2009,Ealing 004,Ealing,E09000009,4428 ,2250 ,2178 
E02000242,2009,Ealing 005,Ealing,E09000009,4533 ,2370 ,2163 
E02000243,2009,Ealing 006,Ealing,E09000009,5847 ,2944 ,2903 
E02000244,2009,Ealing 007,Ealing,E09000009,4887 ,2529 ,2358 
E02000245,2009,Ealing 008,Ealing,E09000009,5167 ,2444 ,2723 
E02000246,2009,Ealing 009,Ealing,E09000009,5519 ,2672 ,2847 
E02000247,2009,Ealing 010,Ealing,E09000009,6398 ,3038 ,3360 
E02000248,2009,Ealing 011,Ealing,E09000009,4920 ,2503 ,2417 
E02000249,2009,Ealing 012,Ealing,E09000009,5059 ,2572 ,2487 
E02000250,2009,Ealing 013,Ealing,E09000009,4225 ,2076 ,2149 
E02000251,2009,Ealing 014,Ealing,E09000009,5412 ,2733 ,2679 
E02000252,2009,Ealing 015,Ealing,E09000009,6808 ,3614 ,3194 
E02000253,2009,Ealing 016,Ealing,E09000009,6274 ,2980 ,3294 
E02000254,2009,Ealing 017,Ealing,E09000009,6020 ,3062 ,2958 
E02000255,2009,Ealing 018,Ealing,E09000009,6427 ,3063 ,3364 
E02000256,2009,Ealing 019,Ealing,E09000009,6295 ,3212 ,3083 
E02000257,2009,Ealing 020,Ealing,E09000009,9606 ,4881 ,4725 
E02000258,2009,Ealing 021,Ealing,E09000009,4974 ,2623 ,2351 
E02000259,2009,Ealing 022,Ealing,E09000009,4401 ,2154 ,2247 
E02000260,2009,Ealing 023,Ealing,E09000009,5582 ,2876 ,2706 
E02000261,2009,Ealing 024,Ealing,E09000009,7188 ,3559 ,3629 
E02000262,2009,Ealing 025,Ealing,E09000009,6405 ,3278 ,3127 
E02000263,2009,Ealing 026,Ealing,E09000009,7841 ,4286 ,3555 
E02000264,2009,Ealing 027,Ealing,E09000009,6237 ,3202 ,3035 
E02000265,2009,Ealing 028,Ealing,E09000009,7866 ,3958 ,3908 
E02000266,2009,Ealing 029,Ealing,E09000009,8100 ,4020 ,4080 
E02000267,2009,Ealing 030,Ealing,E09000009,4918 ,2418 ,2500 
E02000268,2009,Ealing 031,Ealing,E09000009,6907 ,3472 ,3435 
E02000269,2009,Ealing 032,Ealing,E09000009,5736 ,2812 ,2924 
E02000270,2009,Ealing 033,Ealing,E09000009,5789 ,2915 ,2874 
E02000271,2009,Ealing 034,Ealing,E09000009,4861 ,2425 ,2436 
E02000272,2009,Ealing 035,Ealing,E09000009,4718 ,2365 ,2353 
E02000274,2009,Ealing 037,Ealing,E09000009,7593 ,3906 ,3687 
E02000275,2009,Ealing 038,Ealing,E09000009,4457 ,2269 ,2188 
E02000276,2009,Ealing 039,Ealing,E09000009,5067 ,2652 ,2415 
E02006791,2009,Ealing 040,Ealing,E09000009,5327 ,2645 ,2682 
E02000277,2009,Enfield 001,Enfield,E09000010,4516 ,2127 ,2389 
E02000278,2009,Enfield 002,Enfield,E09000010,5250 ,2439 ,2811 
E02000279,2009,Enfield 003,Enfield,E09000010,6916 ,3192 ,3724 
E02000280,2009,Enfield 004,Enfield,E09000010,5411 ,2522 ,2889 
E02000281,2009,Enfield 005,Enfield,E09000010,5500 ,2597 ,2903 
E02000282,2009,Enfield 006,Enfield,E09000010,5499 ,2579 ,2920 
E02000283,2009,Enfield 007,Enfield,E09000010,5267 ,2523 ,2744 
E02000284,2009,Enfield 008,Enfield,E09000010,5275 ,2504 ,2771 
E02000285,2009,Enfield 009,Enfield,E09000010,4181 ,2011 ,2170 
E02000286,2009,Enfield 010,Enfield,E09000010,5361 ,2723 ,2638 
E02000287,2009,Enfield 011,Enfield,E09000010,4377 ,2218 ,2159 
E02000288,2009,Enfield 012,Enfield,E09000010,6347 ,3036 ,3311 
E02000289,2009,Enfield 013,Enfield,E09000010,4063 ,1977 ,2086 
E02000290,2009,Enfield 014,Enfield,E09000010,4542 ,2132 ,2410 
E02000291,2009,Enfield 015,Enfield,E09000010,5764 ,2855 ,2909 
E02000292,2009,Enfield 016,Enfield,E09000010,6232 ,3001 ,3231 
E02000293,2009,Enfield 017,Enfield,E09000010,3897 ,1937 ,1960 
E02000294,2009,Enfield 018,Enfield,E09000010,5531 ,2620 ,2911 
E02000295,2009,Enfield 019,Enfield,E09000010,5536 ,2712 ,2824 
E02000296,2009,Enfield 020,Enfield,E09000010,6256 ,3034 ,3222 
E02000297,2009,Enfield 021,Enfield,E09000010,6105 ,3044 ,3061 
E02000298,2009,Enfield 022,Enfield,E09000010,5255 ,2653 ,2602 
E02000299,2009,Enfield 023,Enfield,E09000010,5654 ,2675 ,2979 
E02000300,2009,Enfield 024,Enfield,E09000010,5269 ,2506 ,2763 
E02000301,2009,Enfield 025,Enfield,E09000010,6154 ,2866 ,3288 
E02000302,2009,Enfield 026,Enfield,E09000010,5379 ,2613 ,2766 
E02000303,2009,Enfield 027,Enfield,E09000010,5098 ,2369 ,2729 
E02000304,2009,Enfield 028,Enfield,E09000010,5288 ,2604 ,2684 
E02000305,2009,Enfield 029,Enfield,E09000010,6061 ,3132 ,2929 
E02000306,2009,Enfield 030,Enfield,E09000010,5510 ,2515 ,2995 
E02000307,2009,Enfield 031,Enfield,E09000010,6378 ,3111 ,3267 
E02000308,2009,Enfield 032,Enfield,E09000010,5321 ,2716 ,2605 
E02000309,2009,Enfield 033,Enfield,E09000010,6489 ,3173 ,3316 
E02000311,2009,Enfield 035,Enfield,E09000010,6524 ,3141 ,3383 
E02000312,2009,Enfield 036,Enfield,E09000010,7339 ,3791 ,3548 
E02006793,2009,Enfield 037,Enfield,E09000010,5768 ,2675 ,3093 
E02000313,2009,Greenwich 001,Greenwich,E09000011,3903 ,1925 ,1978 
E02000314,2009,Greenwich 002,Greenwich,E09000011,7245 ,3686 ,3559 
E02000315,2009,Greenwich 003,Greenwich,E09000011,5415 ,2562 ,2853 
E02000316,2009,Greenwich 004,Greenwich,E09000011,6837 ,3525 ,3312 
E02000317,2009,Greenwich 005,Greenwich,E09000011,5495 ,2692 ,2803 
E02000318,2009,Greenwich 006,Greenwich,E09000011,6301 ,3204 ,3097 
E02000319,2009,Greenwich 007,Greenwich,E09000011,7040 ,3689 ,3351 
E02000320,2009,Greenwich 008,Greenwich,E09000011,4237 ,2016 ,2221 
E02000321,2009,Greenwich 009,Greenwich,E09000011,4635 ,2299 ,2336 
E02000323,2009,Greenwich 011,Greenwich,E09000011,6682 ,3322 ,3360 
E02000324,2009,Greenwich 012,Greenwich,E09000011,4516 ,2237 ,2279 
E02000326,2009,Greenwich 014,Greenwich,E09000011,4785 ,2347 ,2438 
E02000327,2009,Greenwich 015,Greenwich,E09000011,4173 ,2194 ,1979 
E02000328,2009,Greenwich 016,Greenwich,E09000011,4392 ,2193 ,2199 
E02000329,2009,Greenwich 017,Greenwich,E09000011,4131 ,2066 ,2065 
E02000331,2009,Greenwich 019,Greenwich,E09000011,5380 ,2644 ,2736 
E02000332,2009,Greenwich 020,Greenwich,E09000011,4927 ,2462 ,2465 
E02000333,2009,Greenwich 021,Greenwich,E09000011,4418 ,2274 ,2144 
E02000334,2009,Greenwich 022,Greenwich,E09000011,4363 ,2156 ,2207 
E02000335,2009,Greenwich 023,Greenwich,E09000011,4285 ,2125 ,2160 
E02000337,2009,Greenwich 025,Greenwich,E09000011,5247 ,2539 ,2708 
E02000339,2009,Greenwich 027,Greenwich,E09000011,3971 ,1986 ,1985 
E02000340,2009,Greenwich 028,Greenwich,E09000011,3908 ,1987 ,1921 
E02000341,2009,Greenwich 029,Greenwich,E09000011,4935 ,2298 ,2637 
E02000342,2009,Greenwich 030,Greenwich,E09000011,4327 ,2003 ,2324 
E02000343,2009,Greenwich 031,Greenwich,E09000011,4274 ,2137 ,2137 
E02000344,2009,Greenwich 032,Greenwich,E09000011,4243 ,2129 ,2114 
E02006786,2009,Greenwich 033,Greenwich,E09000011,4554 ,2286 ,2268 
E02006927,2009,Greenwich 034,Greenwich,E09000011,6231 ,3103 ,3128 
E02006928,2009,Greenwich 035,Greenwich,E09000011,5296 ,2672 ,2624 
E02006929,2009,Greenwich 036,Greenwich,E09000011,5094 ,2531 ,2563 
E02006930,2009,Greenwich 037,Greenwich,E09000011,4983 ,2555 ,2428 
E02006931,2009,Greenwich 038,Greenwich,E09000011,6449 ,3314 ,3135 
E02000345,2009,Hackney 001,Hackney,E09000012,5095 ,2623 ,2472 
E02000346,2009,Hackney 002,Hackney,E09000012,4478 ,2247 ,2231 
E02000347,2009,Hackney 003,Hackney,E09000012,4998 ,2540 ,2458 
E02000348,2009,Hackney 004,Hackney,E09000012,4864 ,2396 ,2468 
E02000350,2009,Hackney 006,Hackney,E09000012,6786 ,3336 ,3450 
E02000351,2009,Hackney 007,Hackney,E09000012,6653 ,3362 ,3291 
E02000352,2009,Hackney 008,Hackney,E09000012,4606 ,2193 ,2413 
E02000353,2009,Hackney 009,Hackney,E09000012,5857 ,2852 ,3005 
E02000354,2009,Hackney 010,Hackney,E09000012,6580 ,3273 ,3307 
E02000355,2009,Hackney 011,Hackney,E09000012,6123 ,3027 ,3096 
E02000356,2009,Hackney 012,Hackney,E09000012,5519 ,2733 ,2786 
E02000357,2009,Hackney 013,Hackney,E09000012,3899 ,1839 ,2060 
E02000358,2009,Hackney 014,Hackney,E09000012,8244 ,4058 ,4186 
E02000359,2009,Hackney 015,Hackney,E09000012,4590 ,2172 ,2418 
E02000360,2009,Hackney 016,Hackney,E09000012,7558 ,3671 ,3887 
E02000361,2009,Hackney 017,Hackney,E09000012,5399 ,2704 ,2695 
E02000362,2009,Hackney 018,Hackney,E09000012,4373 ,2137 ,2236 
E02000363,2009,Hackney 019,Hackney,E09000012,6991 ,3385 ,3606 
E02000364,2009,Hackney 020,Hackney,E09000012,6407 ,3170 ,3237 
E02000365,2009,Hackney 021,Hackney,E09000012,9379 ,4787 ,4592 
E02000366,2009,Hackney 022,Hackney,E09000012,5993 ,2920 ,3073 
E02000367,2009,Hackney 023,Hackney,E09000012,7101 ,3445 ,3656 
E02000368,2009,Hackney 024,Hackney,E09000012,6780 ,3339 ,3441 
E02000369,2009,Hackney 025,Hackney,E09000012,7992 ,4032 ,3960 
E02000370,2009,Hackney 026,Hackney,E09000012,5617 ,2891 ,2726 
E02000371,2009,Hackney 027,Hackney,E09000012,9140 ,4913 ,4227 
E02006918,2009,Hackney 028,Hackney,E09000012,4415 ,2200 ,2215 
E02006921,2009,Hackney 029,Hackney,E09000012,4841 ,2333 ,2508 
E02000372,2009,Hammersmith and Fulham 001,Hammersmith and Fulham,E09000013,6330 ,3063 ,3267 
E02000373,2009,Hammersmith and Fulham 002,Hammersmith and Fulham,E09000013,4419 ,2032 ,2387 
E02000374,2009,Hammersmith and Fulham 003,Hammersmith and Fulham,E09000013,4853 ,2364 ,2489 
E02000375,2009,Hammersmith and Fulham 004,Hammersmith and Fulham,E09000013,5272 ,2633 ,2639 
E02000376,2009,Hammersmith and Fulham 005,Hammersmith and Fulham,E09000013,5521 ,2854 ,2667 
E02000377,2009,Hammersmith and Fulham 006,Hammersmith and Fulham,E09000013,6133 ,3131 ,3002 
E02000378,2009,Hammersmith and Fulham 007,Hammersmith and Fulham,E09000013,5294 ,2640 ,2654 
E02000379,2009,Hammersmith and Fulham 008,Hammersmith and Fulham,E09000013,5127 ,2595 ,2532 
E02000380,2009,Hammersmith and Fulham 009,Hammersmith and Fulham,E09000013,4611 ,2433 ,2178 
E02000381,2009,Hammersmith and Fulham 010,Hammersmith and Fulham,E09000013,5890 ,2836 ,3054 
E02000382,2009,Hammersmith and Fulham 011,Hammersmith and Fulham,E09000013,4558 ,2308 ,2250 
E02000383,2009,Hammersmith and Fulham 012,Hammersmith and Fulham,E09000013,7551 ,3790 ,3761 
E02000384,2009,Hammersmith and Fulham 013,Hammersmith and Fulham,E09000013,5637 ,2791 ,2846 
E02000385,2009,Hammersmith and Fulham 014,Hammersmith and Fulham,E09000013,5611 ,2883 ,2728 
E02000386,2009,Hammersmith and Fulham 015,Hammersmith and Fulham,E09000013,6163 ,3037 ,3126 
E02000387,2009,Hammersmith and Fulham 016,Hammersmith and Fulham,E09000013,4805 ,2354 ,2451 
E02000388,2009,Hammersmith and Fulham 017,Hammersmith and Fulham,E09000013,6204 ,3028 ,3176 
E02000389,2009,Hammersmith and Fulham 018,Hammersmith and Fulham,E09000013,6081 ,2899 ,3182 
E02000390,2009,Hammersmith and Fulham 019,Hammersmith and Fulham,E09000013,4902 ,2398 ,2504 
E02000391,2009,Hammersmith and Fulham 020,Hammersmith and Fulham,E09000013,5386 ,2604 ,2782 
E02000392,2009,Hammersmith and Fulham 021,Hammersmith and Fulham,E09000013,6931 ,3197 ,3734 
E02000393,2009,Hammersmith and Fulham 022,Hammersmith and Fulham,E09000013,4510 ,2128 ,2382 
E02000394,2009,Hammersmith and Fulham 023,Hammersmith and Fulham,E09000013,5356 ,2574 ,2782 
E02000395,2009,Hammersmith and Fulham 024,Hammersmith and Fulham,E09000013,4225 ,2028 ,2197 
E02000396,2009,Hammersmith and Fulham 025,Hammersmith and Fulham,E09000013,4519 ,2133 ,2386 
E02000397,2009,Haringey 001,Haringey,E09000014,5582 ,2824 ,2758 
E02000398,2009,Haringey 002,Haringey,E09000014,4778 ,2395 ,2383 
E02000400,2009,Haringey 004,Haringey,E09000014,5173 ,2524 ,2649 
E02000401,2009,Haringey 005,Haringey,E09000014,4383 ,2057 ,2326 
E02000402,2009,Haringey 006,Haringey,E09000014,4322 ,1980 ,2342 
E02000403,2009,Haringey 007,Haringey,E09000014,5407 ,2740 ,2667 
E02000404,2009,Haringey 008,Haringey,E09000014,4985 ,2406 ,2579 
E02000405,2009,Haringey 009,Haringey,E09000014,4475 ,2167 ,2308 
E02000406,2009,Haringey 010,Haringey,E09000014,4937 ,2339 ,2598 
E02000407,2009,Haringey 011,Haringey,E09000014,4722 ,2269 ,2453 
E02000408,2009,Haringey 012,Haringey,E09000014,4911 ,2371 ,2540 
E02000409,2009,Haringey 013,Haringey,E09000014,4437 ,2191 ,2246 
E02000410,2009,Haringey 014,Haringey,E09000014,4736 ,2288 ,2448 
E02000411,2009,Haringey 015,Haringey,E09000014,5212 ,2635 ,2577 
E02000412,2009,Haringey 016,Haringey,E09000014,4879 ,2434 ,2445 
E02000413,2009,Haringey 017,Haringey,E09000014,4794 ,2266 ,2528 
E02000414,2009,Haringey 018,Haringey,E09000014,4806 ,2387 ,2419 
E02000415,2009,Haringey 019,Haringey,E09000014,4919 ,2593 ,2326 
E02000416,2009,Haringey 020,Haringey,E09000014,5349 ,2680 ,2669 
E02000417,2009,Haringey 021,Haringey,E09000014,4785 ,2358 ,2427 
E02000418,2009,Haringey 022,Haringey,E09000014,3853 ,1847 ,2006 
E02000419,2009,Haringey 023,Haringey,E09000014,5903 ,3001 ,2902 
E02000420,2009,Haringey 024,Haringey,E09000014,5076 ,2528 ,2548 
E02000421,2009,Haringey 025,Haringey,E09000014,4889 ,2395 ,2494 
E02000422,2009,Haringey 026,Haringey,E09000014,5572 ,2895 ,2677 
E02000423,2009,Haringey 027,Haringey,E09000014,5138 ,2736 ,2402 
E02000424,2009,Haringey 028,Haringey,E09000014,5381 ,2685 ,2696 
E02000425,2009,Haringey 029,Haringey,E09000014,4067 ,2041 ,2026 
E02000426,2009,Haringey 030,Haringey,E09000014,4599 ,2255 ,2344 
E02000427,2009,Haringey 031,Haringey,E09000014,5322 ,2759 ,2563 
E02000428,2009,Haringey 032,Haringey,E09000014,4918 ,2442 ,2476 
E02000429,2009,Haringey 033,Haringey,E09000014,5172 ,2648 ,2524 
E02000430,2009,Haringey 034,Haringey,E09000014,5819 ,2954 ,2865 
E02000431,2009,Haringey 035,Haringey,E09000014,5167 ,2618 ,2549 
E02000432,2009,Haringey 036,Haringey,E09000014,5085 ,2488 ,2597 
E02006794,2009,Haringey 037,Haringey,E09000014,4795 ,2353 ,2442 
E02000433,2009,Harrow 001,Harrow,E09000015,4417 ,2102 ,2315 
E02000434,2009,Harrow 002,Harrow,E09000015,5160 ,2492 ,2668 
E02000435,2009,Harrow 003,Harrow,E09000015,4716 ,2236 ,2480 
E02000436,2009,Harrow 004,Harrow,E09000015,3632 ,1729 ,1903 
E02000437,2009,Harrow 005,Harrow,E09000015,5330 ,2579 ,2751 
E02000438,2009,Harrow 006,Harrow,E09000015,4834 ,2293 ,2541 
E02000439,2009,Harrow 007,Harrow,E09000015,5276 ,2609 ,2667 
E02000440,2009,Harrow 008,Harrow,E09000015,6164 ,3004 ,3160 
E02000441,2009,Harrow 009,Harrow,E09000015,4548 ,2173 ,2375 
E02000442,2009,Harrow 010,Harrow,E09000015,5682 ,2877 ,2805 
E02000443,2009,Harrow 011,Harrow,E09000015,6168 ,3077 ,3091 
E02000444,2009,Harrow 012,Harrow,E09000015,5454 ,2663 ,2791 
E02000445,2009,Harrow 013,Harrow,E09000015,6670 ,3347 ,3323 
E02000447,2009,Harrow 015,Harrow,E09000015,4702 ,2264 ,2438 
E02000448,2009,Harrow 016,Harrow,E09000015,4307 ,2138 ,2169 
E02000449,2009,Harrow 017,Harrow,E09000015,5541 ,2796 ,2745 
E02000451,2009,Harrow 019,Harrow,E09000015,4355 ,2204 ,2151 
E02000452,2009,Harrow 020,Harrow,E09000015,5675 ,2891 ,2784 
E02000453,2009,Harrow 021,Harrow,E09000015,5014 ,2459 ,2555 
E02000454,2009,Harrow 022,Harrow,E09000015,4540 ,2193 ,2347 
E02000455,2009,Harrow 023,Harrow,E09000015,5757 ,2942 ,2815 
E02000456,2009,Harrow 024,Harrow,E09000015,4709 ,2333 ,2376 
E02000457,2009,Harrow 025,Harrow,E09000015,4053 ,2039 ,2014 
E02000459,2009,Harrow 027,Harrow,E09000015,5238 ,2651 ,2587 
E02000460,2009,Harrow 028,Harrow,E09000015,4440 ,2225 ,2215 
E02000461,2009,Harrow 029,Harrow,E09000015,4933 ,2795 ,2138 
E02000462,2009,Harrow 030,Harrow,E09000015,4338 ,2239 ,2099 
E02000463,2009,Harrow 031,Harrow,E09000015,5693 ,2807 ,2886 
E02006795,2009,Harrow 032,Harrow,E09000015,5366 ,2713 ,2653 
E02006882,2009,Harrow 033,Harrow,E09000015,9570 ,4709 ,4861 
E02000464,2009,Havering 001,Havering,E09000016,3866 ,1865 ,2001 
E02000465,2009,Havering 002,Havering,E09000016,5182 ,2525 ,2657 
E02000466,2009,Havering 003,Havering,E09000016,5218 ,2494 ,2724 
E02000467,2009,Havering 004,Havering,E09000016,6129 ,2944 ,3185 
E02000468,2009,Havering 005,Havering,E09000016,4855 ,2323 ,2532 
E02000469,2009,Havering 006,Havering,E09000016,4038 ,1928 ,2110 
E02000470,2009,Havering 007,Havering,E09000016,5113 ,2540 ,2573 
E02000471,2009,Havering 008,Havering,E09000016,4755 ,2338 ,2417 
E02000472,2009,Havering 009,Havering,E09000016,5767 ,2843 ,2924 
E02000473,2009,Havering 010,Havering,E09000016,6065 ,3001 ,3064 
E02000474,2009,Havering 011,Havering,E09000016,5166 ,2509 ,2657 
E02000475,2009,Havering 012,Havering,E09000016,5925 ,2913 ,3012 
E02000476,2009,Havering 013,Havering,E09000016,5230 ,2589 ,2641 
E02000477,2009,Havering 014,Havering,E09000016,6122 ,3024 ,3098 
E02000478,2009,Havering 015,Havering,E09000016,3698 ,1869 ,1829 
E02000479,2009,Havering 016,Havering,E09000016,5675 ,2777 ,2898 
E02000480,2009,Havering 017,Havering,E09000016,6188 ,3046 ,3142 
E02000481,2009,Havering 018,Havering,E09000016,4580 ,2239 ,2341 
E02000482,2009,Havering 019,Havering,E09000016,3838 ,1925 ,1913 
E02000483,2009,Havering 020,Havering,E09000016,4851 ,2396 ,2455 
E02000484,2009,Havering 021,Havering,E09000016,5605 ,2789 ,2816 
E02000485,2009,Havering 022,Havering,E09000016,5033 ,2477 ,2556 
E02000486,2009,Havering 023,Havering,E09000016,4888 ,2443 ,2445 
E02000487,2009,Havering 024,Havering,E09000016,4886 ,2445 ,2441 
E02000488,2009,Havering 025,Havering,E09000016,4968 ,2466 ,2502 
E02000489,2009,Havering 026,Havering,E09000016,4932 ,2408 ,2524 
E02000490,2009,Havering 027,Havering,E09000016,4803 ,2341 ,2462 
E02000491,2009,Havering 028,Havering,E09000016,5489 ,2744 ,2745 
E02000492,2009,Havering 029,Havering,E09000016,3958 ,2003 ,1955 
E02000493,2009,Havering 030,Havering,E09000016,4065 ,1935 ,2130 
E02000494,2009,Hillingdon 001,Hillingdon,E09000017,4852 ,2322 ,2530 
E02000495,2009,Hillingdon 002,Hillingdon,E09000017,6112 ,2913 ,3199 
E02000496,2009,Hillingdon 003,Hillingdon,E09000017,4824 ,2372 ,2452 
E02000497,2009,Hillingdon 004,Hillingdon,E09000017,5248 ,2565 ,2683 
E02000498,2009,Hillingdon 005,Hillingdon,E09000017,3899 ,1895 ,2004 
E02000499,2009,Hillingdon 006,Hillingdon,E09000017,4769 ,2340 ,2429 
E02000500,2009,Hillingdon 007,Hillingdon,E09000017,4846 ,2446 ,2400 
E02000501,2009,Hillingdon 008,Hillingdon,E09000017,5289 ,2560 ,2729 
E02000502,2009,Hillingdon 009,Hillingdon,E09000017,4962 ,2433 ,2529 
E02000503,2009,Hillingdon 010,Hillingdon,E09000017,5973 ,3014 ,2959 
E02000504,2009,Hillingdon 011,Hillingdon,E09000017,4544 ,2264 ,2280 
E02000506,2009,Hillingdon 013,Hillingdon,E09000017,4819 ,2413 ,2406 
E02000507,2009,Hillingdon 014,Hillingdon,E09000017,5179 ,2623 ,2556 
E02000508,2009,Hillingdon 015,Hillingdon,E09000017,6642 ,3586 ,3056 
E02000509,2009,Hillingdon 016,Hillingdon,E09000017,7932 ,3943 ,3989 
E02000510,2009,Hillingdon 017,Hillingdon,E09000017,5741 ,2886 ,2855 
E02000511,2009,Hillingdon 018,Hillingdon,E09000017,6051 ,2983 ,3068 
E02000512,2009,Hillingdon 019,Hillingdon,E09000017,5264 ,2636 ,2628 
E02000513,2009,Hillingdon 020,Hillingdon,E09000017,5697 ,2695 ,3002 
E02000514,2009,Hillingdon 021,Hillingdon,E09000017,6384 ,3194 ,3190 
E02000515,2009,Hillingdon 022,Hillingdon,E09000017,6942 ,3538 ,3404 
E02000516,2009,Hillingdon 023,Hillingdon,E09000017,5310 ,2593 ,2717 
E02000517,2009,Hillingdon 024,Hillingdon,E09000017,5072 ,2407 ,2665 
E02000518,2009,Hillingdon 025,Hillingdon,E09000017,5611 ,2802 ,2809 
E02000519,2009,Hillingdon 026,Hillingdon,E09000017,5463 ,2758 ,2705 
E02000520,2009,Hillingdon 027,Hillingdon,E09000017,7093 ,3556 ,3537 
E02000521,2009,Hillingdon 028,Hillingdon,E09000017,5955 ,2922 ,3033 
E02000522,2009,Hillingdon 029,Hillingdon,E09000017,5382 ,2633 ,2749 
E02000523,2009,Hillingdon 030,Hillingdon,E09000017,5810 ,2941 ,2869 
E02000524,2009,Hillingdon 031,Hillingdon,E09000017,4640 ,2549 ,2091 
E02000525,2009,Hillingdon 032,Hillingdon,E09000017,5657 ,2840 ,2817 
E02006796,2009,Hillingdon 033,Hillingdon,E09000017,5780 ,2888 ,2892 
E02000526,2009,Hounslow 001,Hounslow,E09000018,5834 ,2857 ,2977 
E02000528,2009,Hounslow 003,Hounslow,E09000018,6894 ,3364 ,3530 
E02000529,2009,Hounslow 004,Hounslow,E09000018,5559 ,2778 ,2781 
E02000530,2009,Hounslow 005,Hounslow,E09000018,4096 ,1991 ,2105 
E02000531,2009,Hounslow 006,Hounslow,E09000018,7365 ,3579 ,3786 
E02000532,2009,Hounslow 007,Hounslow,E09000018,6238 ,3097 ,3141 
E02000533,2009,Hounslow 008,Hounslow,E09000018,5840 ,2964 ,2876 
E02000534,2009,Hounslow 009,Hounslow,E09000018,5390 ,2809 ,2581 
E02000535,2009,Hounslow 010,Hounslow,E09000018,6291 ,3264 ,3027 
E02000536,2009,Hounslow 011,Hounslow,E09000018,6231 ,3149 ,3082 
E02000537,2009,Hounslow 012,Hounslow,E09000018,6213 ,3285 ,2928 
E02000538,2009,Hounslow 013,Hounslow,E09000018,5781 ,3011 ,2770 
E02000539,2009,Hounslow 014,Hounslow,E09000018,7081 ,3461 ,3620 
E02000540,2009,Hounslow 015,Hounslow,E09000018,6430 ,3424 ,3006 
E02000541,2009,Hounslow 016,Hounslow,E09000018,5810 ,2993 ,2817 
E02000542,2009,Hounslow 017,Hounslow,E09000018,6180 ,3248 ,2932 
E02000543,2009,Hounslow 018,Hounslow,E09000018,7863 ,4077 ,3786 
E02000544,2009,Hounslow 019,Hounslow,E09000018,5601 ,2826 ,2775 
E02000545,2009,Hounslow 020,Hounslow,E09000018,5574 ,2703 ,2871 
E02000546,2009,Hounslow 021,Hounslow,E09000018,6602 ,3417 ,3185 
E02000547,2009,Hounslow 022,Hounslow,E09000018,6061 ,3030 ,3031 
E02000548,2009,Hounslow 023,Hounslow,E09000018,5820 ,2913 ,2907 
E02000549,2009,Hounslow 024,Hounslow,E09000018,7104 ,3633 ,3471 
E02000550,2009,Hounslow 025,Hounslow,E09000018,6803 ,3313 ,3490 
E02000551,2009,Hounslow 026,Hounslow,E09000018,5444 ,2607 ,2837 
E02000552,2009,Hounslow 027,Hounslow,E09000018,5585 ,2901 ,2684 
E02000553,2009,Hounslow 028,Hounslow,E09000018,4416 ,2167 ,2249 
E02006792,2009,Hounslow 029,Hounslow,E09000018,5974 ,3043 ,2931 
E02000554,2009,Islington 001,Islington,E09000019,6671 ,3105 ,3566 
E02000555,2009,Islington 002,Islington,E09000019,6604 ,3113 ,3491 
E02000556,2009,Islington 003,Islington,E09000019,7574 ,3673 ,3901 
E02000557,2009,Islington 004,Islington,E09000019,5941 ,2864 ,3077 
E02000558,2009,Islington 005,Islington,E09000019,5551 ,2672 ,2879 
E02000559,2009,Islington 006,Islington,E09000019,5908 ,2984 ,2924 
E02000560,2009,Islington 007,Islington,E09000019,5640 ,2806 ,2834 
E02000561,2009,Islington 008,Islington,E09000019,5480 ,2629 ,2851 
E02000562,2009,Islington 009,Islington,E09000019,5559 ,2643 ,2916 
E02000563,2009,Islington 010,Islington,E09000019,6160 ,2836 ,3324 
E02000564,2009,Islington 011,Islington,E09000019,7376 ,3675 ,3701 
E02000565,2009,Islington 012,Islington,E09000019,5714 ,2685 ,3029 
E02000566,2009,Islington 013,Islington,E09000019,5750 ,2781 ,2969 
E02000567,2009,Islington 014,Islington,E09000019,7551 ,3605 ,3946 
E02000568,2009,Islington 015,Islington,E09000019,6716 ,3587 ,3129 
E02000569,2009,Islington 016,Islington,E09000019,7105 ,3388 ,3717 
E02000570,2009,Islington 017,Islington,E09000019,6284 ,3068 ,3216 
E02000571,2009,Islington 018,Islington,E09000019,5726 ,2841 ,2885 
E02000572,2009,Islington 019,Islington,E09000019,5714 ,2684 ,3030 
E02000573,2009,Islington 020,Islington,E09000019,6803 ,3493 ,3310 
E02000574,2009,Islington 021,Islington,E09000019,6611 ,3329 ,3282 
E02000575,2009,Islington 022,Islington,E09000019,9281 ,4913 ,4368 
E02000576,2009,Islington 023,Islington,E09000019,6526 ,3395 ,3131 
E02000577,2009,Kensington and Chelsea 001,Kensington and Chelsea,E09000020,5040 ,2450 ,2590 
E02000578,2009,Kensington and Chelsea 002,Kensington and Chelsea,E09000020,3960 ,1834 ,2126 
E02000579,2009,Kensington and Chelsea 003,Kensington and Chelsea,E09000020,5917 ,2747 ,3170 
E02000580,2009,Kensington and Chelsea 004,Kensington and Chelsea,E09000020,6726 ,3320 ,3406 
E02000581,2009,Kensington and Chelsea 005,Kensington and Chelsea,E09000020,4877 ,2279 ,2598 
E02000582,2009,Kensington and Chelsea 006,Kensington and Chelsea,E09000020,6121 ,3130 ,2991 
E02000583,2009,Kensington and Chelsea 007,Kensington and Chelsea,E09000020,5502 ,2626 ,2876 
E02000584,2009,Kensington and Chelsea 008,Kensington and Chelsea,E09000020,6190 ,2995 ,3195 
E02000585,2009,Kensington and Chelsea 009,Kensington and Chelsea,E09000020,6409 ,3181 ,3228 
E02000586,2009,Kensington and Chelsea 010,Kensington and Chelsea,E09000020,6065 ,3048 ,3017 
E02000587,2009,Kensington and Chelsea 011,Kensington and Chelsea,E09000020,5511 ,2803 ,2708 
E02000588,2009,Kensington and Chelsea 012,Kensington and Chelsea,E09000020,6197 ,3162 ,3035 
E02000589,2009,Kensington and Chelsea 013,Kensington and Chelsea,E09000020,6934 ,3771 ,3163 
E02000590,2009,Kensington and Chelsea 014,Kensington and Chelsea,E09000020,5303 ,2482 ,2821 
E02000591,2009,Kensington and Chelsea 015,Kensington and Chelsea,E09000020,5418 ,2857 ,2561 
E02000592,2009,Kensington and Chelsea 016,Kensington and Chelsea,E09000020,5353 ,2733 ,2620 
E02000593,2009,Kensington and Chelsea 017,Kensington and Chelsea,E09000020,5886 ,3061 ,2825 
E02000594,2009,Kensington and Chelsea 018,Kensington and Chelsea,E09000020,5058 ,2448 ,2610 
E02000595,2009,Kensington and Chelsea 019,Kensington and Chelsea,E09000020,5342 ,2565 ,2777 
E02000596,2009,Kensington and Chelsea 020,Kensington and Chelsea,E09000020,6232 ,3131 ,3101 
E02000597,2009,Kensington and Chelsea 021,Kensington and Chelsea,E09000020,5104 ,2315 ,2789 
E02000598,2009,Kingston upon Thames 001,Kingston upon Thames,E09000021,4763 ,2246 ,2517 
E02000599,2009,Kingston upon Thames 002,Kingston upon Thames,E09000021,4899 ,2392 ,2507 
E02000600,2009,Kingston upon Thames 003,Kingston upon Thames,E09000021,6114 ,3009 ,3105 
E02000601,2009,Kingston upon Thames 004,Kingston upon Thames,E09000021,7088 ,3467 ,3621 
E02000602,2009,Kingston upon Thames 005,Kingston upon Thames,E09000021,6810 ,3440 ,3370 
E02000603,2009,Kingston upon Thames 006,Kingston upon Thames,E09000021,5259 ,2567 ,2692 
E02000604,2009,Kingston upon Thames 007,Kingston upon Thames,E09000021,5774 ,2865 ,2909 
E02000605,2009,Kingston upon Thames 008,Kingston upon Thames,E09000021,5293 ,2639 ,2654 
E02000606,2009,Kingston upon Thames 009,Kingston upon Thames,E09000021,7920 ,4124 ,3796 
E02000607,2009,Kingston upon Thames 010,Kingston upon Thames,E09000021,4942 ,2459 ,2483 
E02000608,2009,Kingston upon Thames 011,Kingston upon Thames,E09000021,5563 ,2901 ,2662 
E02000609,2009,Kingston upon Thames 012,Kingston upon Thames,E09000021,4599 ,2249 ,2350 
E02000610,2009,Kingston upon Thames 013,Kingston upon Thames,E09000021,5657 ,2935 ,2722 
E02000611,2009,Kingston upon Thames 014,Kingston upon Thames,E09000021,4680 ,2332 ,2348 
E02000612,2009,Kingston upon Thames 015,Kingston upon Thames,E09000021,5152 ,2520 ,2632 
E02000613,2009,Kingston upon Thames 016,Kingston upon Thames,E09000021,5160 ,2464 ,2696 
E02000614,2009,Kingston upon Thames 017,Kingston upon Thames,E09000021,5580 ,2743 ,2837 
E02000615,2009,Kingston upon Thames 018,Kingston upon Thames,E09000021,4791 ,2366 ,2425 
E02000616,2009,Kingston upon Thames 019,Kingston upon Thames,E09000021,4040 ,1951 ,2089 
E02000617,2009,Kingston upon Thames 020,Kingston upon Thames,E09000021,5452 ,2607 ,2845 
E02000619,2009,Lambeth 002,Lambeth,E09000022,5612 ,2888 ,2724 
E02000620,2009,Lambeth 003,Lambeth,E09000022,6629 ,3548 ,3081 
E02000621,2009,Lambeth 004,Lambeth,E09000022,7735 ,4286 ,3449 
E02000622,2009,Lambeth 005,Lambeth,E09000022,6116 ,3278 ,2838 
E02000623,2009,Lambeth 006,Lambeth,E09000022,5646 ,2959 ,2687 
E02000624,2009,Lambeth 007,Lambeth,E09000022,5885 ,3034 ,2851 
E02000625,2009,Lambeth 008,Lambeth,E09000022,5960 ,3055 ,2905 
E02000626,2009,Lambeth 009,Lambeth,E09000022,5910 ,2963 ,2947 
E02000627,2009,Lambeth 010,Lambeth,E09000022,7156 ,3705 ,3451 
E02000628,2009,Lambeth 011,Lambeth,E09000022,6932 ,3459 ,3473 
E02000629,2009,Lambeth 012,Lambeth,E09000022,7199 ,3730 ,3469 
E02000630,2009,Lambeth 013,Lambeth,E09000022,5539 ,2828 ,2711 
E02000631,2009,Lambeth 014,Lambeth,E09000022,6472 ,3233 ,3239 
E02000632,2009,Lambeth 015,Lambeth,E09000022,8081 ,4204 ,3877 
E02000633,2009,Lambeth 016,Lambeth,E09000022,6359 ,3214 ,3145 
E02000634,2009,Lambeth 017,Lambeth,E09000022,5224 ,2616 ,2608 
E02000635,2009,Lambeth 018,Lambeth,E09000022,6945 ,3545 ,3400 
E02000636,2009,Lambeth 019,Lambeth,E09000022,5667 ,2831 ,2836 
E02000637,2009,Lambeth 020,Lambeth,E09000022,6580 ,3388 ,3192 
E02000638,2009,Lambeth 021,Lambeth,E09000022,7043 ,3559 ,3484 
E02000639,2009,Lambeth 022,Lambeth,E09000022,5889 ,2850 ,3039 
E02000640,2009,Lambeth 023,Lambeth,E09000022,6617 ,3200 ,3417 
E02000641,2009,Lambeth 024,Lambeth,E09000022,5800 ,2700 ,3100 
E02000642,2009,Lambeth 025,Lambeth,E09000022,6714 ,3249 ,3465 
E02000643,2009,Lambeth 026,Lambeth,E09000022,5935 ,2857 ,3078 
E02000644,2009,Lambeth 027,Lambeth,E09000022,5860 ,2937 ,2923 
E02000645,2009,Lambeth 028,Lambeth,E09000022,6291 ,3081 ,3210 
E02000646,2009,Lambeth 029,Lambeth,E09000022,6538 ,3296 ,3242 
E02000647,2009,Lambeth 030,Lambeth,E09000022,5689 ,2839 ,2850 
E02000648,2009,Lambeth 031,Lambeth,E09000022,4750 ,2168 ,2582 
E02000649,2009,Lambeth 032,Lambeth,E09000022,7886 ,3887 ,3999 
E02000650,2009,Lambeth 033,Lambeth,E09000022,5389 ,2589 ,2800 
E02000651,2009,Lambeth 034,Lambeth,E09000022,5864 ,2939 ,2925 
E02000652,2009,Lambeth 035,Lambeth,E09000022,4607 ,2259 ,2348 
E02006801,2009,Lambeth 036,Lambeth,E09000022,6424 ,3359 ,3065 
E02000653,2009,Lewisham 001,Lewisham,E09000023,5813 ,2957 ,2856 
E02000654,2009,Lewisham 002,Lewisham,E09000023,5259 ,2558 ,2701 
E02000655,2009,Lewisham 003,Lewisham,E09000023,5989 ,2943 ,3046 
E02000657,2009,Lewisham 005,Lewisham,E09000023,6916 ,3462 ,3454 
E02000658,2009,Lewisham 006,Lewisham,E09000023,5904 ,3090 ,2814 
E02000659,2009,Lewisham 007,Lewisham,E09000023,5507 ,2696 ,2811 
E02000660,2009,Lewisham 008,Lewisham,E09000023,6128 ,3078 ,3050 
E02000661,2009,Lewisham 009,Lewisham,E09000023,4580 ,2358 ,2222 
E02000662,2009,Lewisham 010,Lewisham,E09000023,5783 ,2766 ,3017 
E02000663,2009,Lewisham 011,Lewisham,E09000023,5527 ,2964 ,2563 
E02000664,2009,Lewisham 012,Lewisham,E09000023,6889 ,3574 ,3315 
E02000665,2009,Lewisham 013,Lewisham,E09000023,5373 ,2711 ,2662 
E02000666,2009,Lewisham 014,Lewisham,E09000023,5221 ,2517 ,2704 
E02000667,2009,Lewisham 015,Lewisham,E09000023,4610 ,2240 ,2370 
E02000668,2009,Lewisham 016,Lewisham,E09000023,4523 ,2235 ,2288 
E02000669,2009,Lewisham 017,Lewisham,E09000023,5661 ,2865 ,2796 
E02000670,2009,Lewisham 018,Lewisham,E09000023,4384 ,2053 ,2331 
E02000671,2009,Lewisham 019,Lewisham,E09000023,6088 ,2990 ,3098 
E02000672,2009,Lewisham 020,Lewisham,E09000023,5677 ,2927 ,2750 
E02000673,2009,Lewisham 021,Lewisham,E09000023,5708 ,2883 ,2825 
E02000674,2009,Lewisham 022,Lewisham,E09000023,5308 ,2482 ,2826 
E02000675,2009,Lewisham 023,Lewisham,E09000023,5515 ,2636 ,2879 
E02000676,2009,Lewisham 024,Lewisham,E09000023,5449 ,2681 ,2768 
E02000677,2009,Lewisham 025,Lewisham,E09000023,4936 ,2445 ,2491 
E02000678,2009,Lewisham 026,Lewisham,E09000023,3785 ,1765 ,2020 
E02000679,2009,Lewisham 027,Lewisham,E09000023,5401 ,2677 ,2724 
E02000680,2009,Lewisham 028,Lewisham,E09000023,4620 ,2284 ,2336 
E02000681,2009,Lewisham 029,Lewisham,E09000023,5277 ,2468 ,2809 
E02000682,2009,Lewisham 030,Lewisham,E09000023,5068 ,2410 ,2658 
E02000683,2009,Lewisham 031,Lewisham,E09000023,4221 ,1974 ,2247 
E02000685,2009,Lewisham 033,Lewisham,E09000023,5172 ,2485 ,2687 
E02000686,2009,Lewisham 034,Lewisham,E09000023,4361 ,1957 ,2404 
E02000687,2009,Lewisham 035,Lewisham,E09000023,5591 ,2802 ,2789 
E02006783,2009,Lewisham 037,Lewisham,E09000023,4394 ,1957 ,2437 
E02006784,2009,Lewisham 038,Lewisham,E09000023,4611 ,2201 ,2410 
E02006798,2009,Lewisham 039,Lewisham,E09000023,5478 ,2693 ,2785 
E02000689,2009,Merton 001,Merton,E09000024,5401 ,2650 ,2751 
E02000690,2009,Merton 002,Merton,E09000024,3602 ,1838 ,1764 
E02000691,2009,Merton 003,Merton,E09000024,5469 ,2737 ,2732 
E02000692,2009,Merton 004,Merton,E09000024,5695 ,2985 ,2710 
E02000693,2009,Merton 005,Merton,E09000024,7262 ,3806 ,3456 
E02000694,2009,Merton 006,Merton,E09000024,6708 ,3331 ,3377 
E02000695,2009,Merton 007,Merton,E09000024,5822 ,3071 ,2751 
E02000696,2009,Merton 008,Merton,E09000024,6083 ,3060 ,3023 
E02000697,2009,Merton 009,Merton,E09000024,6571 ,3380 ,3191 
E02000698,2009,Merton 010,Merton,E09000024,5265 ,2619 ,2646 
E02000699,2009,Merton 011,Merton,E09000024,5867 ,2880 ,2987 
E02000700,2009,Merton 012,Merton,E09000024,5992 ,2929 ,3063 
E02000701,2009,Merton 013,Merton,E09000024,5623 ,2784 ,2839 
E02000702,2009,Merton 014,Merton,E09000024,5042 ,2393 ,2649 
E02000703,2009,Merton 015,Merton,E09000024,5269 ,2664 ,2605 
E02000704,2009,Merton 016,Merton,E09000024,5583 ,2817 ,2766 
E02000705,2009,Merton 017,Merton,E09000024,5319 ,2510 ,2809 
E02000706,2009,Merton 018,Merton,E09000024,5414 ,2554 ,2860 
E02000707,2009,Merton 019,Merton,E09000024,4792 ,2260 ,2532 
E02000708,2009,Merton 020,Merton,E09000024,5578 ,2747 ,2831 
E02000709,2009,Merton 021,Merton,E09000024,5017 ,2496 ,2521 
E02000710,2009,Merton 022,Merton,E09000024,5425 ,2631 ,2794 
E02000711,2009,Merton 023,Merton,E09000024,5448 ,2745 ,2703 
E02000712,2009,Merton 024,Merton,E09000024,5425 ,2651 ,2774 
E02000713,2009,Merton 025,Merton,E09000024,4846 ,2416 ,2430 
E02000714,2009,Newham 001,Newham,E09000025,5374 ,2772 ,2602 
E02000715,2009,Newham 002,Newham,E09000025,4417 ,2302 ,2115 
E02000716,2009,Newham 003,Newham,E09000025,4747 ,2544 ,2203 
E02000717,2009,Newham 004,Newham,E09000025,5149 ,2737 ,2412 
E02000718,2009,Newham 005,Newham,E09000025,4023 ,1988 ,2035 
E02000719,2009,Newham 006,Newham,E09000025,5504 ,2814 ,2690 
E02000720,2009,Newham 007,Newham,E09000025,4977 ,2704 ,2273 
E02000721,2009,Newham 008,Newham,E09000025,6354 ,3488 ,2866 
E02000722,2009,Newham 009,Newham,E09000025,5647 ,2933 ,2714 
E02000723,2009,Newham 010,Newham,E09000025,7024 ,3926 ,3098 
E02000724,2009,Newham 011,Newham,E09000025,6167 ,3442 ,2725 
E02000725,2009,Newham 012,Newham,E09000025,6135 ,3139 ,2996 
E02000726,2009,Newham 013,Newham,E09000025,6004 ,3219 ,2785 
E02000727,2009,Newham 014,Newham,E09000025,5525 ,3219 ,2306 
E02000728,2009,Newham 015,Newham,E09000025,5465 ,3019 ,2446 
E02000729,2009,Newham 016,Newham,E09000025,4604 ,2408 ,2196 
E02000730,2009,Newham 017,Newham,E09000025,5926 ,3321 ,2605 
E02000731,2009,Newham 018,Newham,E09000025,6473 ,3750 ,2723 
E02000732,2009,Newham 019,Newham,E09000025,4680 ,2528 ,2152 
E02000733,2009,Newham 020,Newham,E09000025,6241 ,3150 ,3091 
E02000734,2009,Newham 021,Newham,E09000025,4608 ,2319 ,2289 
E02000735,2009,Newham 022,Newham,E09000025,4824 ,2625 ,2199 
E02000736,2009,Newham 023,Newham,E09000025,5263 ,2693 ,2570 
E02000737,2009,Newham 024,Newham,E09000025,5659 ,2834 ,2825 
E02000738,2009,Newham 025,Newham,E09000025,5429 ,2840 ,2589 
E02000739,2009,Newham 026,Newham,E09000025,4449 ,2272 ,2177 
E02000740,2009,Newham 027,Newham,E09000025,4525 ,2237 ,2288 
E02000741,2009,Newham 028,Newham,E09000025,5201 ,2631 ,2570 
E02000742,2009,Newham 029,Newham,E09000025,4744 ,2362 ,2382 
E02000743,2009,Newham 030,Newham,E09000025,4839 ,2454 ,2385 
E02000744,2009,Newham 031,Newham,E09000025,4918 ,2437 ,2481 
E02000745,2009,Newham 032,Newham,E09000025,5500 ,2684 ,2816 
E02000746,2009,Newham 033,Newham,E09000025,4923 ,2290 ,2633 
E02000747,2009,Newham 034,Newham,E09000025,6995 ,3694 ,3301 
E02000748,2009,Newham 035,Newham,E09000025,4296 ,2106 ,2190 
E02000749,2009,Newham 036,Newham,E09000025,5171 ,2489 ,2682 
E02000750,2009,Newham 037,Newham,E09000025,7022 ,3654 ,3368 
E02000751,2009,Redbridge 001,Redbridge,E09000026,6676 ,3316 ,3360 
E02000752,2009,Redbridge 002,Redbridge,E09000026,4142 ,2007 ,2135 
E02000753,2009,Redbridge 003,Redbridge,E09000026,3908 ,1842 ,2066 
E02000754,2009,Redbridge 004,Redbridge,E09000026,4317 ,2121 ,2196 
E02000755,2009,Redbridge 005,Redbridge,E09000026,3550 ,1725 ,1825 
E02000756,2009,Redbridge 006,Redbridge,E09000026,8344 ,4085 ,4259 
E02000757,2009,Redbridge 007,Redbridge,E09000026,7743 ,3874 ,3869 
E02000758,2009,Redbridge 008,Redbridge,E09000026,3817 ,1883 ,1934 
E02000759,2009,Redbridge 009,Redbridge,E09000026,8185 ,4015 ,4170 
E02000760,2009,Redbridge 010,Redbridge,E09000026,4301 ,2053 ,2248 
E02000762,2009,Redbridge 012,Redbridge,E09000026,4089 ,2072 ,2017 
E02000763,2009,Redbridge 013,Redbridge,E09000026,4519 ,2192 ,2327 
E02000764,2009,Redbridge 014,Redbridge,E09000026,8042 ,3971 ,4071 
E02000765,2009,Redbridge 015,Redbridge,E09000026,4021 ,1990 ,2031 
E02000767,2009,Redbridge 017,Redbridge,E09000026,4887 ,2403 ,2484 
E02000768,2009,Redbridge 018,Redbridge,E09000026,3928 ,1934 ,1994 
E02000769,2009,Redbridge 019,Redbridge,E09000026,9173 ,4428 ,4745 
E02000770,2009,Redbridge 020,Redbridge,E09000026,4842 ,2467 ,2375 
E02000772,2009,Redbridge 022,Redbridge,E09000026,4862 ,2458 ,2404 
E02000773,2009,Redbridge 023,Redbridge,E09000026,5775 ,2891 ,2884 
E02000774,2009,Redbridge 024,Redbridge,E09000026,4729 ,2463 ,2266 
E02000776,2009,Redbridge 026,Redbridge,E09000026,4174 ,2106 ,2068 
E02000777,2009,Redbridge 027,Redbridge,E09000026,4195 ,2096 ,2099 
E02000779,2009,Redbridge 029,Redbridge,E09000026,4860 ,2530 ,2330 
E02000780,2009,Redbridge 030,Redbridge,E09000026,8590 ,4384 ,4206 
E02000781,2009,Redbridge 031,Redbridge,E09000026,8560 ,4320 ,4240 
E02000782,2009,Redbridge 032,Redbridge,E09000026,5321 ,2687 ,2634 
E02000783,2009,Redbridge 033,Redbridge,E09000026,4162 ,2058 ,2104 
E02006800,2009,Redbridge 034,Redbridge,E09000026,8620 ,4361 ,4259 
E02006924,2009,Redbridge 035,Redbridge,E09000026,8388 ,4381 ,4007 
E02006925,2009,Redbridge 036,Redbridge,E09000026,8574 ,4216 ,4358 
E02000784,2009,Richmond upon Thames 001,Richmond upon Thames,E09000027,7135 ,3505 ,3630 
E02000785,2009,Richmond upon Thames 002,Richmond upon Thames,E09000027,6779 ,3382 ,3397 
E02000786,2009,Richmond upon Thames 003,Richmond upon Thames,E09000027,7622 ,3748 ,3874 
E02000787,2009,Richmond upon Thames 004,Richmond upon Thames,E09000027,7355 ,3587 ,3768 
E02000788,2009,Richmond upon Thames 005,Richmond upon Thames,E09000027,5792 ,2829 ,2963 
E02000789,2009,Richmond upon Thames 006,Richmond upon Thames,E09000027,4428 ,2256 ,2172 
E02000790,2009,Richmond upon Thames 007,Richmond upon Thames,E09000027,4299 ,2196 ,2103 
E02000791,2009,Richmond upon Thames 008,Richmond upon Thames,E09000027,4461 ,2353 ,2108 
E02000792,2009,Richmond upon Thames 009,Richmond upon Thames,E09000027,4768 ,2380 ,2388 
E02000793,2009,Richmond upon Thames 010,Richmond upon Thames,E09000027,5345 ,2647 ,2698 
E02000794,2009,Richmond upon Thames 011,Richmond upon Thames,E09000027,4495 ,2263 ,2232 
E02000795,2009,Richmond upon Thames 012,Richmond upon Thames,E09000027,4122 ,2102 ,2020 
E02000796,2009,Richmond upon Thames 013,Richmond upon Thames,E09000027,6664 ,3319 ,3345 
E02000797,2009,Richmond upon Thames 014,Richmond upon Thames,E09000027,5148 ,2642 ,2506 
E02000798,2009,Richmond upon Thames 015,Richmond upon Thames,E09000027,7140 ,3479 ,3661 
E02000799,2009,Richmond upon Thames 016,Richmond upon Thames,E09000027,4558 ,2195 ,2363 
E02000800,2009,Richmond upon Thames 017,Richmond upon Thames,E09000027,3295 ,1591 ,1704 
E02000801,2009,Richmond upon Thames 018,Richmond upon Thames,E09000027,4521 ,2192 ,2329 
E02000802,2009,Richmond upon Thames 019,Richmond upon Thames,E09000027,4330 ,2128 ,2202 
E02000803,2009,Richmond upon Thames 020,Richmond upon Thames,E09000027,6135 ,2946 ,3189 
E02000804,2009,Richmond upon Thames 021,Richmond upon Thames,E09000027,4753 ,2280 ,2473 
E02000805,2009,Richmond upon Thames 022,Richmond upon Thames,E09000027,6775 ,3308 ,3467 
E02000806,2009,Richmond upon Thames 023,Richmond upon Thames,E09000027,6402 ,3112 ,3290 
E02000807,2009,Southwark 001,Southwark,E09000028,6547 ,3438 ,3109 
E02000808,2009,Southwark 002,Southwark,E09000028,7219 ,3801 ,3418 
E02000809,2009,Southwark 003,Southwark,E09000028,9719 ,5458 ,4261 
E02000810,2009,Southwark 004,Southwark,E09000028,6175 ,3087 ,3088 
E02000812,2009,Southwark 006,Southwark,E09000028,7683 ,3816 ,3867 
E02000813,2009,Southwark 007,Southwark,E09000028,5753 ,2852 ,2901 
E02000814,2009,Southwark 008,Southwark,E09000028,6957 ,3620 ,3337 
E02000815,2009,Southwark 009,Southwark,E09000028,5935 ,3088 ,2847 
E02000816,2009,Southwark 010,Southwark,E09000028,5949 ,2871 ,3078 
E02000817,2009,Southwark 011,Southwark,E09000028,4423 ,2124 ,2299 
E02000818,2009,Southwark 012,Southwark,E09000028,5628 ,2863 ,2765 
E02000819,2009,Southwark 013,Southwark,E09000028,5623 ,2813 ,2810 
E02000820,2009,Southwark 014,Southwark,E09000028,6182 ,3186 ,2996 
E02000821,2009,Southwark 015,Southwark,E09000028,5747 ,2783 ,2964 
E02000822,2009,Southwark 016,Southwark,E09000028,5716 ,2856 ,2860 
E02000823,2009,Southwark 017,Southwark,E09000028,5529 ,2737 ,2792 
E02000824,2009,Southwark 018,Southwark,E09000028,6253 ,2970 ,3283 
E02000825,2009,Southwark 019,Southwark,E09000028,6211 ,2918 ,3293 
E02000826,2009,Southwark 020,Southwark,E09000028,6118 ,2991 ,3127 
E02000827,2009,Southwark 021,Southwark,E09000028,7368 ,3715 ,3653 
E02000828,2009,Southwark 022,Southwark,E09000028,5863 ,2832 ,3031 
E02000829,2009,Southwark 023,Southwark,E09000028,7273 ,3805 ,3468 
E02000830,2009,Southwark 024,Southwark,E09000028,6532 ,3179 ,3353 
E02000831,2009,Southwark 025,Southwark,E09000028,6577 ,3250 ,3327 
E02000832,2009,Southwark 026,Southwark,E09000028,6728 ,3175 ,3553 
E02000833,2009,Southwark 027,Southwark,E09000028,5622 ,2594 ,3028 
E02000834,2009,Southwark 028,Southwark,E09000028,7156 ,3459 ,3697 
E02000835,2009,Southwark 029,Southwark,E09000028,4942 ,2416 ,2526 
E02000836,2009,Southwark 030,Southwark,E09000028,5980 ,2879 ,3101 
E02000837,2009,Southwark 031,Southwark,E09000028,5574 ,2669 ,2905 
E02000838,2009,Southwark 032,Southwark,E09000028,6451 ,3112 ,3339 
E02000839,2009,Southwark 033,Southwark,E09000028,5500 ,2693 ,2807 
E02006802,2009,Southwark 034,Southwark,E09000028,6108 ,3183 ,2925 
E02000840,2009,Sutton 001,Sutton,E09000029,5260 ,2468 ,2792 
E02000841,2009,Sutton 002,Sutton,E09000029,5586 ,2667 ,2919 
E02000842,2009,Sutton 003,Sutton,E09000029,5076 ,2528 ,2548 
E02000843,2009,Sutton 004,Sutton,E09000029,5371 ,2622 ,2749 
E02000844,2009,Sutton 005,Sutton,E09000029,5010 ,2415 ,2595 
E02000845,2009,Sutton 006,Sutton,E09000029,5765 ,2789 ,2976 
E02000846,2009,Sutton 007,Sutton,E09000029,4455 ,2204 ,2251 
E02000847,2009,Sutton 008,Sutton,E09000029,5617 ,2769 ,2848 
E02000848,2009,Sutton 009,Sutton,E09000029,5082 ,2519 ,2563 
E02000849,2009,Sutton 010,Sutton,E09000029,4930 ,2439 ,2491 
E02000850,2009,Sutton 011,Sutton,E09000029,6851 ,3397 ,3454 
E02000851,2009,Sutton 012,Sutton,E09000029,5687 ,2937 ,2750 
E02000852,2009,Sutton 013,Sutton,E09000029,5194 ,2573 ,2621 
E02000853,2009,Sutton 014,Sutton,E09000029,5054 ,2457 ,2597 
E02000854,2009,Sutton 015,Sutton,E09000029,4669 ,2278 ,2391 
E02000855,2009,Sutton 016,Sutton,E09000029,4967 ,2444 ,2523 
E02000856,2009,Sutton 017,Sutton,E09000029,5538 ,2751 ,2787 
E02000857,2009,Sutton 018,Sutton,E09000029,5553 ,2793 ,2760 
E02000858,2009,Sutton 019,Sutton,E09000029,4790 ,2221 ,2569 
E02000859,2009,Sutton 020,Sutton,E09000029,5317 ,2593 ,2724 
E02000860,2009,Sutton 021,Sutton,E09000029,5340 ,2722 ,2618 
E02000861,2009,Sutton 022,Sutton,E09000029,5017 ,2450 ,2567 
E02000863,2009,Sutton 024,Sutton,E09000029,4196 ,2051 ,2145 
E02006836,2009,Sutton 025,Sutton,E09000029,5182 ,2563 ,2619 
E02000864,2009,Tower Hamlets 001,Tower Hamlets,E09000030,5537 ,2670 ,2867 
E02000865,2009,Tower Hamlets 002,Tower Hamlets,E09000030,4878 ,2451 ,2427 
E02000866,2009,Tower Hamlets 003,Tower Hamlets,E09000030,7066 ,3511 ,3555 
E02000867,2009,Tower Hamlets 004,Tower Hamlets,E09000030,6717 ,3452 ,3265 
E02000868,2009,Tower Hamlets 005,Tower Hamlets,E09000030,4872 ,2557 ,2315 
E02000869,2009,Tower Hamlets 006,Tower Hamlets,E09000030,4067 ,2134 ,1933 
E02000870,2009,Tower Hamlets 007,Tower Hamlets,E09000030,4549 ,2271 ,2278 
E02000871,2009,Tower Hamlets 008,Tower Hamlets,E09000030,5348 ,2786 ,2562 
E02000872,2009,Tower Hamlets 009,Tower Hamlets,E09000030,5388 ,2882 ,2506 
E02000873,2009,Tower Hamlets 010,Tower Hamlets,E09000030,6645 ,3226 ,3419 
E02000874,2009,Tower Hamlets 011,Tower Hamlets,E09000030,5167 ,2622 ,2545 
E02000875,2009,Tower Hamlets 012,Tower Hamlets,E09000030,6280 ,3195 ,3085 
E02000876,2009,Tower Hamlets 013,Tower Hamlets,E09000030,5187 ,2766 ,2421 
E02000877,2009,Tower Hamlets 014,Tower Hamlets,E09000030,6478 ,3351 ,3127 
E02000878,2009,Tower Hamlets 015,Tower Hamlets,E09000030,7773 ,4169 ,3604 
E02000879,2009,Tower Hamlets 016,Tower Hamlets,E09000030,4953 ,2476 ,2477 
E02000880,2009,Tower Hamlets 017,Tower Hamlets,E09000030,4123 ,2181 ,1942 
E02000881,2009,Tower Hamlets 018,Tower Hamlets,E09000030,4319 ,2167 ,2152 
E02000882,2009,Tower Hamlets 019,Tower Hamlets,E09000030,5550 ,2793 ,2757 
E02000883,2009,Tower Hamlets 020,Tower Hamlets,E09000030,5108 ,2515 ,2593 
E02000884,2009,Tower Hamlets 021,Tower Hamlets,E09000030,6542 ,3673 ,2869 
E02000885,2009,Tower Hamlets 022,Tower Hamlets,E09000030,4658 ,2378 ,2280 
E02000886,2009,Tower Hamlets 023,Tower Hamlets,E09000030,5509 ,3049 ,2460 
E02000887,2009,Tower Hamlets 024,Tower Hamlets,E09000030,5517 ,2735 ,2782 
E02000888,2009,Tower Hamlets 025,Tower Hamlets,E09000030,5680 ,3070 ,2610 
E02000889,2009,Tower Hamlets 026,Tower Hamlets,E09000030,4974 ,2752 ,2222 
E02000890,2009,Tower Hamlets 027,Tower Hamlets,E09000030,4589 ,2510 ,2079 
E02000891,2009,Tower Hamlets 028,Tower Hamlets,E09000030,8970 ,4841 ,4129 
E02000893,2009,Tower Hamlets 030,Tower Hamlets,E09000030,5115 ,2633 ,2482 
E02000894,2009,Tower Hamlets 031,Tower Hamlets,E09000030,7754 ,4102 ,3652 
E02006853,2009,Tower Hamlets 032,Tower Hamlets,E09000030,4423 ,2388 ,2035 
E02006854,2009,Tower Hamlets 033,Tower Hamlets,E09000030,3630 ,2097 ,1533 
E02000895,2009,Waltham Forest 001,Waltham Forest,E09000031,4818 ,2340 ,2478 
E02000896,2009,Waltham Forest 002,Waltham Forest,E09000031,5640 ,2836 ,2804 
E02000897,2009,Waltham Forest 003,Waltham Forest,E09000031,5061 ,2430 ,2631 
E02000898,2009,Waltham Forest 004,Waltham Forest,E09000031,4948 ,2382 ,2566 
E02000899,2009,Waltham Forest 005,Waltham Forest,E09000031,5241 ,2538 ,2703 
E02000900,2009,Waltham Forest 006,Waltham Forest,E09000031,5371 ,2550 ,2821 
E02000901,2009,Waltham Forest 007,Waltham Forest,E09000031,6314 ,3049 ,3265 
E02000902,2009,Waltham Forest 008,Waltham Forest,E09000031,5387 ,2640 ,2747 
E02000903,2009,Waltham Forest 009,Waltham Forest,E09000031,5903 ,2870 ,3033 
E02000904,2009,Waltham Forest 010,Waltham Forest,E09000031,5362 ,2653 ,2709 
E02000905,2009,Waltham Forest 011,Waltham Forest,E09000031,6322 ,3164 ,3158 
E02000906,2009,Waltham Forest 012,Waltham Forest,E09000031,6221 ,3101 ,3120 
E02000907,2009,Waltham Forest 013,Waltham Forest,E09000031,6275 ,3024 ,3251 
E02000908,2009,Waltham Forest 014,Waltham Forest,E09000031,7190 ,3911 ,3279 
E02000909,2009,Waltham Forest 015,Waltham Forest,E09000031,5813 ,2854 ,2959 
E02000910,2009,Waltham Forest 016,Waltham Forest,E09000031,7396 ,3826 ,3570 
E02000911,2009,Waltham Forest 017,Waltham Forest,E09000031,7467 ,3754 ,3713 
E02000912,2009,Waltham Forest 018,Waltham Forest,E09000031,5996 ,2952 ,3044 
E02000913,2009,Waltham Forest 019,Waltham Forest,E09000031,5902 ,2996 ,2906 
E02000914,2009,Waltham Forest 020,Waltham Forest,E09000031,6952 ,3543 ,3409 
E02000915,2009,Waltham Forest 021,Waltham Forest,E09000031,6410 ,3366 ,3044 
E02000916,2009,Waltham Forest 022,Waltham Forest,E09000031,6125 ,3036 ,3089 
E02000917,2009,Waltham Forest 023,Waltham Forest,E09000031,5935 ,2960 ,2975 
E02000918,2009,Waltham Forest 024,Waltham Forest,E09000031,6507 ,3365 ,3142 
E02000919,2009,Waltham Forest 025,Waltham Forest,E09000031,6253 ,3256 ,2997 
E02000920,2009,Waltham Forest 026,Waltham Forest,E09000031,6308 ,3119 ,3189 
E02000921,2009,Waltham Forest 027,Waltham Forest,E09000031,7254 ,3605 ,3649 
E02000922,2009,Waltham Forest 028,Waltham Forest,E09000031,7053 ,3815 ,3238 
E02000923,2009,Wandsworth 001,Wandsworth,E09000032,5220 ,2628 ,2592 
E02000924,2009,Wandsworth 002,Wandsworth,E09000032,7883 ,3843 ,4040 
E02000925,2009,Wandsworth 003,Wandsworth,E09000032,5183 ,2467 ,2716 
E02000926,2009,Wandsworth 004,Wandsworth,E09000032,6312 ,3206 ,3106 
E02000927,2009,Wandsworth 005,Wandsworth,E09000032,5214 ,2549 ,2665 
E02000928,2009,Wandsworth 006,Wandsworth,E09000032,6160 ,2974 ,3186 
E02000929,2009,Wandsworth 007,Wandsworth,E09000032,4890 ,2227 ,2663 
E02000930,2009,Wandsworth 008,Wandsworth,E09000032,7902 ,3935 ,3967 
E02000931,2009,Wandsworth 009,Wandsworth,E09000032,6720 ,3423 ,3297 
E02000932,2009,Wandsworth 010,Wandsworth,E09000032,8124 ,4079 ,4045 
E02000933,2009,Wandsworth 011,Wandsworth,E09000032,6335 ,3085 ,3250 
E02000934,2009,Wandsworth 012,Wandsworth,E09000032,7516 ,3814 ,3702 
E02000935,2009,Wandsworth 013,Wandsworth,E09000032,4888 ,2074 ,2814 
E02000936,2009,Wandsworth 014,Wandsworth,E09000032,6405 ,3084 ,3321 
E02000937,2009,Wandsworth 015,Wandsworth,E09000032,5835 ,2968 ,2867 
E02000938,2009,Wandsworth 016,Wandsworth,E09000032,6472 ,3095 ,3377 
E02000939,2009,Wandsworth 017,Wandsworth,E09000032,5409 ,2695 ,2714 
E02000940,2009,Wandsworth 018,Wandsworth,E09000032,5724 ,2746 ,2978 
E02000941,2009,Wandsworth 019,Wandsworth,E09000032,7868 ,4134 ,3734 
E02000942,2009,Wandsworth 020,Wandsworth,E09000032,6770 ,3266 ,3504 
E02000943,2009,Wandsworth 021,Wandsworth,E09000032,6511 ,3302 ,3209 
E02000944,2009,Wandsworth 022,Wandsworth,E09000032,5016 ,2333 ,2683 
E02000945,2009,Wandsworth 023,Wandsworth,E09000032,5464 ,2514 ,2950 
E02000946,2009,Wandsworth 024,Wandsworth,E09000032,6217 ,3268 ,2949 
E02000947,2009,Wandsworth 025,Wandsworth,E09000032,6536 ,3060 ,3476 
E02000948,2009,Wandsworth 026,Wandsworth,E09000032,7918 ,3910 ,4008 
E02000949,2009,Wandsworth 027,Wandsworth,E09000032,7148 ,3531 ,3617 
E02000950,2009,Wandsworth 028,Wandsworth,E09000032,5777 ,2790 ,2987 
E02000951,2009,Wandsworth 029,Wandsworth,E09000032,5060 ,2489 ,2571 
E02000952,2009,Wandsworth 030,Wandsworth,E09000032,4648 ,2301 ,2347 
E02000953,2009,Wandsworth 031,Wandsworth,E09000032,5015 ,2304 ,2711 
E02000954,2009,Wandsworth 032,Wandsworth,E09000032,4415 ,2088 ,2327 
E02000955,2009,Wandsworth 033,Wandsworth,E09000032,4592 ,2170 ,2422 
E02000956,2009,Wandsworth 034,Wandsworth,E09000032,5525 ,2626 ,2899 
E02000957,2009,Wandsworth 035,Wandsworth,E09000032,7432 ,3640 ,3792 
E02000958,2009,Wandsworth 036,Wandsworth,E09000032,5880 ,2812 ,3068 
E02000959,2009,Wandsworth 037,Wandsworth,E09000032,5301 ,2610 ,2691 
E02000960,2009,Westminster 001,Westminster,E09000033,4694 ,2256 ,2438 
E02000961,2009,Westminster 002,Westminster,E09000033,6226 ,2940 ,3286 
E02000962,2009,Westminster 003,Westminster,E09000033,6020 ,3013 ,3007 
E02000963,2009,Westminster 004,Westminster,E09000033,6643 ,3062 ,3581 
E02000964,2009,Westminster 005,Westminster,E09000033,8823 ,4191 ,4632 
E02000965,2009,Westminster 006,Westminster,E09000033,7006 ,3450 ,3556 
E02000966,2009,Westminster 007,Westminster,E09000033,7415 ,3689 ,3726 
E02000967,2009,Westminster 008,Westminster,E09000033,5952 ,3226 ,2726 
E02000968,2009,Westminster 009,Westminster,E09000033,9535 ,4586 ,4949 
E02000969,2009,Westminster 010,Westminster,E09000033,6404 ,3086 ,3318 
E02000970,2009,Westminster 011,Westminster,E09000033,7289 ,3906 ,3383 
E02000971,2009,Westminster 012,Westminster,E09000033,7064 ,3766 ,3298 
E02000972,2009,Westminster 013,Westminster,E09000033,6525 ,3732 ,2793 
E02000973,2009,Westminster 014,Westminster,E09000033,7585 ,3855 ,3730 
E02000974,2009,Westminster 015,Westminster,E09000033,6684 ,3667 ,3017 
E02000975,2009,Westminster 016,Westminster,E09000033,7409 ,4031 ,3378 
E02000976,2009,Westminster 017,Westminster,E09000033,8011 ,4150 ,3861 
E02000977,2009,Westminster 018,Westminster,E09000033,6041 ,3505 ,2536 
E02000978,2009,Westminster 019,Westminster,E09000033,6982 ,3594 ,3388 
E02000979,2009,Westminster 020,Westminster,E09000033,6153 ,3229 ,2924 
E02000980,2009,Westminster 021,Westminster,E09000033,6108 ,3070 ,3038 
E02000981,2009,Westminster 022,Westminster,E09000033,7288 ,3724 ,3564 
E02000982,2009,Westminster 023,Westminster,E09000033,5540 ,2843 ,2697 
E02000983,2009,Westminster 024,Westminster,E09000033,6099 ,3038 ,3061 
E02000001,2010,City of London 001,City of London,E09000001,5770 ,3285 ,2485 
E02000002,2010,Barking and Dagenham 001,Barking and Dagenham,E09000002,3923 ,1824 ,2099 
E02000003,2010,Barking and Dagenham 002,Barking and Dagenham,E09000002,6617 ,3213 ,3404 
E02000004,2010,Barking and Dagenham 003,Barking and Dagenham,E09000002,4017 ,1971 ,2046 
E02000005,2010,Barking and Dagenham 004,Barking and Dagenham,E09000002,5444 ,2587 ,2857 
E02000007,2010,Barking and Dagenham 006,Barking and Dagenham,E09000002,5245 ,2440 ,2805 
E02000008,2010,Barking and Dagenham 007,Barking and Dagenham,E09000002,7218 ,3359 ,3859 
E02000009,2010,Barking and Dagenham 008,Barking and Dagenham,E09000002,5406 ,2659 ,2747 
E02000010,2010,Barking and Dagenham 009,Barking and Dagenham,E09000002,5430 ,2537 ,2893 
E02000011,2010,Barking and Dagenham 010,Barking and Dagenham,E09000002,4014 ,2005 ,2009 
E02000012,2010,Barking and Dagenham 011,Barking and Dagenham,E09000002,6269 ,3121 ,3148 
E02000013,2010,Barking and Dagenham 012,Barking and Dagenham,E09000002,5184 ,2449 ,2735 
E02000014,2010,Barking and Dagenham 013,Barking and Dagenham,E09000002,5946 ,2818 ,3128 
E02000015,2010,Barking and Dagenham 014,Barking and Dagenham,E09000002,4872 ,2336 ,2536 
E02000016,2010,Barking and Dagenham 015,Barking and Dagenham,E09000002,5004 ,2630 ,2374 
E02000017,2010,Barking and Dagenham 016,Barking and Dagenham,E09000002,5716 ,3091 ,2625 
E02000018,2010,Barking and Dagenham 017,Barking and Dagenham,E09000002,5552 ,2620 ,2932 
E02000019,2010,Barking and Dagenham 018,Barking and Dagenham,E09000002,5259 ,2521 ,2738 
E02000020,2010,Barking and Dagenham 019,Barking and Dagenham,E09000002,5693 ,2855 ,2838 
E02000021,2010,Barking and Dagenham 020,Barking and Dagenham,E09000002,5007 ,2379 ,2628 
E02000022,2010,Barking and Dagenham 021,Barking and Dagenham,E09000002,5332 ,2616 ,2716 
E02000023,2010,Barking and Dagenham 022,Barking and Dagenham,E09000002,4055 ,1965 ,2090 
E02006799,2010,Barking and Dagenham 023,Barking and Dagenham,E09000002,6061 ,2919 ,3142 
E02000024,2010,Barnet 001,Barnet,E09000003,6706 ,3292 ,3414 
E02000025,2010,Barnet 002,Barnet,E09000003,5593 ,2738 ,2855 
E02000026,2010,Barnet 003,Barnet,E09000003,4157 ,2013 ,2144 
E02000027,2010,Barnet 004,Barnet,E09000003,6408 ,3044 ,3364 
E02000028,2010,Barnet 005,Barnet,E09000003,4147 ,2096 ,2051 
E02000029,2010,Barnet 006,Barnet,E09000003,5875 ,2870 ,3005 
E02000030,2010,Barnet 007,Barnet,E09000003,5791 ,2766 ,3025 
E02000031,2010,Barnet 008,Barnet,E09000003,4659 ,2303 ,2356 
E02000032,2010,Barnet 009,Barnet,E09000003,5008 ,2405 ,2603 
E02000033,2010,Barnet 010,Barnet,E09000003,5630 ,2767 ,2863 
E02000034,2010,Barnet 011,Barnet,E09000003,5691 ,2765 ,2926 
E02000035,2010,Barnet 012,Barnet,E09000003,5651 ,2771 ,2880 
E02000036,2010,Barnet 013,Barnet,E09000003,6915 ,3332 ,3583 
E02000037,2010,Barnet 014,Barnet,E09000003,5945 ,2867 ,3078 
E02000038,2010,Barnet 015,Barnet,E09000003,7262 ,3705 ,3557 
E02000039,2010,Barnet 016,Barnet,E09000003,4264 ,2063 ,2201 
E02000040,2010,Barnet 017,Barnet,E09000003,4332 ,2013 ,2319 
E02000041,2010,Barnet 018,Barnet,E09000003,5673 ,2759 ,2914 
E02000042,2010,Barnet 019,Barnet,E09000003,7521 ,3776 ,3745 
E02000043,2010,Barnet 020,Barnet,E09000003,5062 ,2451 ,2611 
E02000044,2010,Barnet 021,Barnet,E09000003,5325 ,2471 ,2854 
E02000045,2010,Barnet 022,Barnet,E09000003,7141 ,3455 ,3686 
E02000046,2010,Barnet 023,Barnet,E09000003,4897 ,2393 ,2504 
E02000047,2010,Barnet 024,Barnet,E09000003,7288 ,3419 ,3869 
E02000048,2010,Barnet 025,Barnet,E09000003,6190 ,2966 ,3224 
E02000049,2010,Barnet 026,Barnet,E09000003,5322 ,2413 ,2909 
E02000050,2010,Barnet 027,Barnet,E09000003,6747 ,3203 ,3544 
E02000051,2010,Barnet 028,Barnet,E09000003,5429 ,2656 ,2773 
E02000052,2010,Barnet 029,Barnet,E09000003,6875 ,3291 ,3584 
E02000053,2010,Barnet 030,Barnet,E09000003,6237 ,3184 ,3053 
E02000054,2010,Barnet 031,Barnet,E09000003,5093 ,2491 ,2602 
E02000055,2010,Barnet 032,Barnet,E09000003,7528 ,3763 ,3765 
E02000056,2010,Barnet 033,Barnet,E09000003,5613 ,2617 ,2996 
E02000057,2010,Barnet 034,Barnet,E09000003,4706 ,2303 ,2403 
E02000058,2010,Barnet 035,Barnet,E09000003,6178 ,2860 ,3318 
E02000059,2010,Barnet 036,Barnet,E09000003,7308 ,3712 ,3596 
E02000060,2010,Barnet 037,Barnet,E09000003,6254 ,3065 ,3189 
E02000061,2010,Barnet 038,Barnet,E09000003,5287 ,2566 ,2721 
E02000062,2010,Barnet 039,Barnet,E09000003,4314 ,2054 ,2260 
E02000063,2010,Barnet 040,Barnet,E09000003,4520 ,2185 ,2335 
E02000064,2010,Barnet 041,Barnet,E09000003,4031 ,1898 ,2133 
E02000065,2010,Bexley 001,Bexley,E09000004,4849 ,2326 ,2523 
E02000066,2010,Bexley 002,Bexley,E09000004,6360 ,3037 ,3323 
E02000067,2010,Bexley 003,Bexley,E09000004,5725 ,2760 ,2965 
E02000068,2010,Bexley 004,Bexley,E09000004,4852 ,2382 ,2470 
E02000069,2010,Bexley 005,Bexley,E09000004,3913 ,1921 ,1992 
E02000070,2010,Bexley 006,Bexley,E09000004,5004 ,2431 ,2573 
E02000071,2010,Bexley 007,Bexley,E09000004,4905 ,2356 ,2549 
E02000072,2010,Bexley 008,Bexley,E09000004,7332 ,3443 ,3889 
E02000073,2010,Bexley 009,Bexley,E09000004,6730 ,3322 ,3408 
E02000074,2010,Bexley 010,Bexley,E09000004,4881 ,2291 ,2590 
E02000075,2010,Bexley 011,Bexley,E09000004,5049 ,2456 ,2593 
E02000077,2010,Bexley 013,Bexley,E09000004,5021 ,2421 ,2600 
E02000078,2010,Bexley 014,Bexley,E09000004,5055 ,2459 ,2596 
E02000079,2010,Bexley 015,Bexley,E09000004,5029 ,2489 ,2540 
E02000080,2010,Bexley 016,Bexley,E09000004,6048 ,3008 ,3040 
E02000081,2010,Bexley 017,Bexley,E09000004,4772 ,2392 ,2380 
E02000082,2010,Bexley 018,Bexley,E09000004,5861 ,2915 ,2946 
E02000083,2010,Bexley 019,Bexley,E09000004,6328 ,3118 ,3210 
E02000084,2010,Bexley 020,Bexley,E09000004,6939 ,3391 ,3548 
E02000085,2010,Bexley 021,Bexley,E09000004,5061 ,2438 ,2623 
E02000086,2010,Bexley 022,Bexley,E09000004,4872 ,2374 ,2498 
E02000087,2010,Bexley 023,Bexley,E09000004,4602 ,2326 ,2276 
E02000088,2010,Bexley 024,Bexley,E09000004,4952 ,2436 ,2516 
E02000089,2010,Bexley 025,Bexley,E09000004,4880 ,2359 ,2521 
E02000090,2010,Bexley 026,Bexley,E09000004,5545 ,2669 ,2876 
E02000091,2010,Bexley 027,Bexley,E09000004,6040 ,2930 ,3110 
E02000092,2010,Bexley 028,Bexley,E09000004,3977 ,1841 ,2136 
E02006785,2010,Bexley 029,Bexley,E09000004,4077 ,1970 ,2107 
E02000093,2010,Brent 001,Brent,E09000005,7146 ,3510 ,3636 
E02000094,2010,Brent 002,Brent,E09000005,5597 ,2783 ,2814 
E02000095,2010,Brent 003,Brent,E09000005,6571 ,3318 ,3253 
E02000096,2010,Brent 004,Brent,E09000005,4835 ,2401 ,2434 
E02000097,2010,Brent 005,Brent,E09000005,5945 ,3040 ,2905 
E02000098,2010,Brent 006,Brent,E09000005,5248 ,2650 ,2598 
E02000099,2010,Brent 007,Brent,E09000005,5673 ,2824 ,2849 
E02000100,2010,Brent 008,Brent,E09000005,5807 ,2749 ,3058 
E02000101,2010,Brent 009,Brent,E09000005,6042 ,3006 ,3036 
E02000102,2010,Brent 010,Brent,E09000005,5057 ,2519 ,2538 
E02000103,2010,Brent 011,Brent,E09000005,5710 ,2903 ,2807 
E02000104,2010,Brent 012,Brent,E09000005,4419 ,2320 ,2099 
E02000105,2010,Brent 013,Brent,E09000005,6102 ,3193 ,2909 
E02000106,2010,Brent 014,Brent,E09000005,7116 ,3663 ,3453 
E02000107,2010,Brent 015,Brent,E09000005,8410 ,4503 ,3907 
E02000108,2010,Brent 016,Brent,E09000005,4438 ,2338 ,2100 
E02000109,2010,Brent 017,Brent,E09000005,6468 ,3431 ,3037 
E02000110,2010,Brent 018,Brent,E09000005,6282 ,3253 ,3029 
E02000111,2010,Brent 019,Brent,E09000005,6563 ,3421 ,3142 
E02000112,2010,Brent 020,Brent,E09000005,6341 ,3398 ,2943 
E02000113,2010,Brent 021,Brent,E09000005,6146 ,2918 ,3228 
E02000114,2010,Brent 022,Brent,E09000005,6998 ,3614 ,3384 
E02000115,2010,Brent 023,Brent,E09000005,6456 ,3332 ,3124 
E02000116,2010,Brent 024,Brent,E09000005,5646 ,2849 ,2797 
E02000117,2010,Brent 025,Brent,E09000005,7836 ,3826 ,4010 
E02000118,2010,Brent 026,Brent,E09000005,6520 ,3394 ,3126 
E02000119,2010,Brent 027,Brent,E09000005,4284 ,2017 ,2267 
E02000120,2010,Brent 028,Brent,E09000005,6843 ,3352 ,3491 
E02000121,2010,Brent 029,Brent,E09000005,6332 ,3299 ,3033 
E02000122,2010,Brent 030,Brent,E09000005,5521 ,2661 ,2860 
E02000123,2010,Brent 031,Brent,E09000005,10201 ,5223 ,4978 
E02000124,2010,Brent 032,Brent,E09000005,7498 ,3747 ,3751 
E02000125,2010,Brent 033,Brent,E09000005,7663 ,3792 ,3871 
E02000126,2010,Brent 034,Brent,E09000005,5054 ,2470 ,2584 
E02000127,2010,Bromley 001,Bromley,E09000006,5450 ,2490 ,2960 
E02000128,2010,Bromley 002,Bromley,E09000006,4745 ,2247 ,2498 
E02000130,2010,Bromley 004,Bromley,E09000006,5504 ,2619 ,2885 
E02000131,2010,Bromley 005,Bromley,E09000006,6752 ,3303 ,3449 
E02000132,2010,Bromley 006,Bromley,E09000006,6113 ,3036 ,3077 
E02000133,2010,Bromley 007,Bromley,E09000006,5932 ,2904 ,3028 
E02000134,2010,Bromley 008,Bromley,E09000006,7419 ,3662 ,3757 
E02000135,2010,Bromley 009,Bromley,E09000006,6789 ,3248 ,3541 
E02000136,2010,Bromley 010,Bromley,E09000006,3384 ,1646 ,1738 
E02000137,2010,Bromley 011,Bromley,E09000006,5112 ,2499 ,2613 
E02000138,2010,Bromley 012,Bromley,E09000006,5160 ,2605 ,2555 
E02000139,2010,Bromley 013,Bromley,E09000006,5032 ,2402 ,2630 
E02000140,2010,Bromley 014,Bromley,E09000006,4909 ,2255 ,2654 
E02000141,2010,Bromley 015,Bromley,E09000006,4914 ,2403 ,2511 
E02000142,2010,Bromley 016,Bromley,E09000006,5359 ,2623 ,2736 
E02000144,2010,Bromley 018,Bromley,E09000006,5861 ,2946 ,2915 
E02000145,2010,Bromley 019,Bromley,E09000006,5059 ,2332 ,2727 
E02000146,2010,Bromley 020,Bromley,E09000006,5381 ,2645 ,2736 
E02000147,2010,Bromley 021,Bromley,E09000006,4879 ,2429 ,2450 
E02000148,2010,Bromley 022,Bromley,E09000006,4057 ,1952 ,2105 
E02000149,2010,Bromley 023,Bromley,E09000006,4984 ,2350 ,2634 
E02000150,2010,Bromley 024,Bromley,E09000006,5325 ,2572 ,2753 
E02000151,2010,Bromley 025,Bromley,E09000006,4610 ,2224 ,2386 
E02000152,2010,Bromley 026,Bromley,E09000006,4113 ,1948 ,2165 
E02000153,2010,Bromley 027,Bromley,E09000006,4958 ,2411 ,2547 
E02000154,2010,Bromley 028,Bromley,E09000006,5086 ,2539 ,2547 
E02000155,2010,Bromley 029,Bromley,E09000006,4255 ,2088 ,2167 
E02000156,2010,Bromley 030,Bromley,E09000006,7449 ,3653 ,3796 
E02000157,2010,Bromley 031,Bromley,E09000006,4725 ,2292 ,2433 
E02000158,2010,Bromley 032,Bromley,E09000006,4405 ,2101 ,2304 
E02000159,2010,Bromley 033,Bromley,E09000006,4170 ,2002 ,2168 
E02000160,2010,Bromley 034,Bromley,E09000006,4992 ,2462 ,2530 
E02000161,2010,Bromley 035,Bromley,E09000006,5281 ,2585 ,2696 
E02000162,2010,Bromley 036,Bromley,E09000006,3964 ,1850 ,2114 
E02000163,2010,Bromley 037,Bromley,E09000006,4781 ,2359 ,2422 
E02000165,2010,Bromley 039,Bromley,E09000006,4844 ,2352 ,2492 
E02006782,2010,Bromley 040,Bromley,E09000006,4907 ,2320 ,2587 
E02006787,2010,Bromley 041,Bromley,E09000006,4936 ,2348 ,2588 
E02006789,2010,Bromley 042,Bromley,E09000006,3970 ,1912 ,2058 
E02000166,2010,Camden 001,Camden,E09000007,5279 ,2443 ,2836 
E02000167,2010,Camden 002,Camden,E09000007,5326 ,2574 ,2752 
E02000168,2010,Camden 003,Camden,E09000007,5732 ,2746 ,2986 
E02000169,2010,Camden 004,Camden,E09000007,4898 ,2326 ,2572 
E02000170,2010,Camden 005,Camden,E09000007,6136 ,3047 ,3089 
E02000171,2010,Camden 006,Camden,E09000007,5552 ,2702 ,2850 
E02000172,2010,Camden 007,Camden,E09000007,7007 ,3466 ,3541 
E02000173,2010,Camden 008,Camden,E09000007,5279 ,2569 ,2710 
E02000174,2010,Camden 009,Camden,E09000007,6396 ,3011 ,3385 
E02000175,2010,Camden 010,Camden,E09000007,6810 ,3265 ,3545 
E02000176,2010,Camden 011,Camden,E09000007,4489 ,2161 ,2328 
E02000177,2010,Camden 012,Camden,E09000007,6077 ,2832 ,3245 
E02000178,2010,Camden 013,Camden,E09000007,6709 ,3356 ,3353 
E02000179,2010,Camden 014,Camden,E09000007,4104 ,1937 ,2167 
E02000180,2010,Camden 015,Camden,E09000007,6080 ,3023 ,3057 
E02000181,2010,Camden 016,Camden,E09000007,5824 ,2770 ,3054 
E02000182,2010,Camden 017,Camden,E09000007,4480 ,2017 ,2463 
E02000183,2010,Camden 018,Camden,E09000007,5524 ,2688 ,2836 
E02000184,2010,Camden 019,Camden,E09000007,6444 ,3210 ,3234 
E02000185,2010,Camden 020,Camden,E09000007,5604 ,2677 ,2927 
E02000186,2010,Camden 021,Camden,E09000007,5058 ,2656 ,2402 
E02000187,2010,Camden 022,Camden,E09000007,5327 ,2520 ,2807 
E02000188,2010,Camden 023,Camden,E09000007,5730 ,2956 ,2774 
E02000189,2010,Camden 024,Camden,E09000007,4357 ,2189 ,2168 
E02000190,2010,Camden 025,Camden,E09000007,6067 ,3024 ,3043 
E02000191,2010,Camden 026,Camden,E09000007,6355 ,3410 ,2945 
E02000192,2010,Camden 027,Camden,E09000007,5026 ,2715 ,2311 
E02000193,2010,Camden 028,Camden,E09000007,6334 ,3429 ,2905 
E02000194,2010,Croydon 001,Croydon,E09000008,5982 ,2964 ,3018 
E02000195,2010,Croydon 002,Croydon,E09000008,6008 ,2938 ,3070 
E02000196,2010,Croydon 003,Croydon,E09000008,4885 ,2394 ,2491 
E02000197,2010,Croydon 004,Croydon,E09000008,5883 ,2824 ,3059 
E02000198,2010,Croydon 005,Croydon,E09000008,5357 ,2539 ,2818 
E02000199,2010,Croydon 006,Croydon,E09000008,5556 ,2612 ,2944 
E02000200,2010,Croydon 007,Croydon,E09000008,5812 ,2826 ,2986 
E02000201,2010,Croydon 008,Croydon,E09000008,5539 ,2665 ,2874 
E02000202,2010,Croydon 009,Croydon,E09000008,5776 ,2888 ,2888 
E02000203,2010,Croydon 010,Croydon,E09000008,5065 ,2463 ,2602 
E02000204,2010,Croydon 011,Croydon,E09000008,6244 ,3026 ,3218 
E02000206,2010,Croydon 013,Croydon,E09000008,6309 ,3051 ,3258 
E02000207,2010,Croydon 014,Croydon,E09000008,5955 ,2804 ,3151 
E02000208,2010,Croydon 015,Croydon,E09000008,6357 ,3111 ,3246 
E02000209,2010,Croydon 016,Croydon,E09000008,5489 ,2607 ,2882 
E02000210,2010,Croydon 017,Croydon,E09000008,5769 ,2763 ,3006 
E02000211,2010,Croydon 018,Croydon,E09000008,5138 ,2513 ,2625 
E02000212,2010,Croydon 019,Croydon,E09000008,5432 ,2655 ,2777 
E02000213,2010,Croydon 020,Croydon,E09000008,6612 ,3480 ,3132 
E02000214,2010,Croydon 021,Croydon,E09000008,4150 ,2090 ,2060 
E02000215,2010,Croydon 022,Croydon,E09000008,7616 ,4055 ,3561 
E02000216,2010,Croydon 023,Croydon,E09000008,4398 ,2307 ,2091 
E02000217,2010,Croydon 024,Croydon,E09000008,6505 ,3268 ,3237 
E02000218,2010,Croydon 025,Croydon,E09000008,4109 ,1864 ,2245 
E02000219,2010,Croydon 026,Croydon,E09000008,4811 ,2321 ,2490 
E02000220,2010,Croydon 027,Croydon,E09000008,7192 ,3849 ,3343 
E02000221,2010,Croydon 028,Croydon,E09000008,6321 ,2978 ,3343 
E02000222,2010,Croydon 029,Croydon,E09000008,5616 ,2828 ,2788 
E02000223,2010,Croydon 030,Croydon,E09000008,4788 ,2035 ,2753 
E02000224,2010,Croydon 031,Croydon,E09000008,5430 ,2743 ,2687 
E02000225,2010,Croydon 032,Croydon,E09000008,4680 ,2160 ,2520 
E02000226,2010,Croydon 033,Croydon,E09000008,4967 ,2471 ,2496 
E02000227,2010,Croydon 034,Croydon,E09000008,7617 ,3619 ,3998 
E02000228,2010,Croydon 035,Croydon,E09000008,4707 ,2304 ,2403 
E02000229,2010,Croydon 036,Croydon,E09000008,3689 ,1666 ,2023 
E02000230,2010,Croydon 037,Croydon,E09000008,6593 ,3317 ,3276 
E02000231,2010,Croydon 038,Croydon,E09000008,4980 ,2488 ,2492 
E02000232,2010,Croydon 039,Croydon,E09000008,3831 ,1841 ,1990 
E02000233,2010,Croydon 040,Croydon,E09000008,3907 ,1878 ,2029 
E02000234,2010,Croydon 041,Croydon,E09000008,5301 ,2579 ,2722 
E02000235,2010,Croydon 042,Croydon,E09000008,4532 ,2181 ,2351 
E02000236,2010,Croydon 043,Croydon,E09000008,4952 ,2415 ,2537 
E02000237,2010,Croydon 044,Croydon,E09000008,4530 ,2157 ,2373 
E02006788,2010,Croydon 045,Croydon,E09000008,4947 ,2147 ,2800 
E02000238,2010,Ealing 001,Ealing,E09000009,6396 ,3298 ,3098 
E02000239,2010,Ealing 002,Ealing,E09000009,6131 ,3170 ,2961 
E02000240,2010,Ealing 003,Ealing,E09000009,6516 ,3085 ,3431 
E02000241,2010,Ealing 004,Ealing,E09000009,4466 ,2280 ,2186 
E02000242,2010,Ealing 005,Ealing,E09000009,4650 ,2429 ,2221 
E02000243,2010,Ealing 006,Ealing,E09000009,5847 ,2953 ,2894 
E02000244,2010,Ealing 007,Ealing,E09000009,4981 ,2577 ,2404 
E02000245,2010,Ealing 008,Ealing,E09000009,5308 ,2507 ,2801 
E02000246,2010,Ealing 009,Ealing,E09000009,5529 ,2682 ,2847 
E02000247,2010,Ealing 010,Ealing,E09000009,6550 ,3135 ,3415 
E02000248,2010,Ealing 011,Ealing,E09000009,5046 ,2540 ,2506 
E02000249,2010,Ealing 012,Ealing,E09000009,5172 ,2633 ,2539 
E02000250,2010,Ealing 013,Ealing,E09000009,4242 ,2053 ,2189 
E02000251,2010,Ealing 014,Ealing,E09000009,5448 ,2795 ,2653 
E02000252,2010,Ealing 015,Ealing,E09000009,7065 ,3773 ,3292 
E02000253,2010,Ealing 016,Ealing,E09000009,6294 ,3003 ,3291 
E02000254,2010,Ealing 017,Ealing,E09000009,6076 ,3140 ,2936 
E02000255,2010,Ealing 018,Ealing,E09000009,6447 ,3082 ,3365 
E02000256,2010,Ealing 019,Ealing,E09000009,6404 ,3276 ,3128 
E02000257,2010,Ealing 020,Ealing,E09000009,9799 ,4944 ,4855 
E02000258,2010,Ealing 021,Ealing,E09000009,4968 ,2606 ,2362 
E02000259,2010,Ealing 022,Ealing,E09000009,4385 ,2145 ,2240 
E02000260,2010,Ealing 023,Ealing,E09000009,5770 ,3014 ,2756 
E02000261,2010,Ealing 024,Ealing,E09000009,7498 ,3718 ,3780 
E02000262,2010,Ealing 025,Ealing,E09000009,6437 ,3265 ,3172 
E02000263,2010,Ealing 026,Ealing,E09000009,8001 ,4402 ,3599 
E02000264,2010,Ealing 027,Ealing,E09000009,6118 ,3116 ,3002 
E02000265,2010,Ealing 028,Ealing,E09000009,7974 ,4003 ,3971 
E02000266,2010,Ealing 029,Ealing,E09000009,8105 ,4052 ,4053 
E02000267,2010,Ealing 030,Ealing,E09000009,4973 ,2459 ,2514 
E02000268,2010,Ealing 031,Ealing,E09000009,6770 ,3401 ,3369 
E02000269,2010,Ealing 032,Ealing,E09000009,5803 ,2865 ,2938 
E02000270,2010,Ealing 033,Ealing,E09000009,5494 ,2710 ,2784 
E02000271,2010,Ealing 034,Ealing,E09000009,4775 ,2385 ,2390 
E02000272,2010,Ealing 035,Ealing,E09000009,4629 ,2314 ,2315 
E02000274,2010,Ealing 037,Ealing,E09000009,8043 ,4254 ,3789 
E02000275,2010,Ealing 038,Ealing,E09000009,4600 ,2352 ,2248 
E02000276,2010,Ealing 039,Ealing,E09000009,4914 ,2555 ,2359 
E02006791,2010,Ealing 040,Ealing,E09000009,5147 ,2528 ,2619 
E02000277,2010,Enfield 001,Enfield,E09000010,4620 ,2189 ,2431 
E02000278,2010,Enfield 002,Enfield,E09000010,5410 ,2523 ,2887 
E02000279,2010,Enfield 003,Enfield,E09000010,7238 ,3378 ,3860 
E02000280,2010,Enfield 004,Enfield,E09000010,5551 ,2606 ,2945 
E02000281,2010,Enfield 005,Enfield,E09000010,5694 ,2693 ,3001 
E02000282,2010,Enfield 006,Enfield,E09000010,5681 ,2629 ,3052 
E02000283,2010,Enfield 007,Enfield,E09000010,5434 ,2588 ,2846 
E02000284,2010,Enfield 008,Enfield,E09000010,5527 ,2692 ,2835 
E02000285,2010,Enfield 009,Enfield,E09000010,4352 ,2116 ,2236 
E02000286,2010,Enfield 010,Enfield,E09000010,5480 ,2798 ,2682 
E02000287,2010,Enfield 011,Enfield,E09000010,4334 ,2102 ,2232 
E02000288,2010,Enfield 012,Enfield,E09000010,6657 ,3198 ,3459 
E02000289,2010,Enfield 013,Enfield,E09000010,3984 ,1941 ,2043 
E02000290,2010,Enfield 014,Enfield,E09000010,4633 ,2184 ,2449 
E02000291,2010,Enfield 015,Enfield,E09000010,5883 ,2907 ,2976 
E02000292,2010,Enfield 016,Enfield,E09000010,6248 ,2980 ,3268 
E02000293,2010,Enfield 017,Enfield,E09000010,3979 ,2015 ,1964 
E02000294,2010,Enfield 018,Enfield,E09000010,5688 ,2708 ,2980 
E02000295,2010,Enfield 019,Enfield,E09000010,5277 ,2537 ,2740 
E02000296,2010,Enfield 020,Enfield,E09000010,6274 ,2999 ,3275 
E02000297,2010,Enfield 021,Enfield,E09000010,6266 ,3128 ,3138 
E02000298,2010,Enfield 022,Enfield,E09000010,5180 ,2597 ,2583 
E02000299,2010,Enfield 023,Enfield,E09000010,5770 ,2737 ,3033 
E02000300,2010,Enfield 024,Enfield,E09000010,5258 ,2470 ,2788 
E02000301,2010,Enfield 025,Enfield,E09000010,6372 ,2950 ,3422 
E02000302,2010,Enfield 026,Enfield,E09000010,5407 ,2619 ,2788 
E02000303,2010,Enfield 027,Enfield,E09000010,5134 ,2382 ,2752 
E02000304,2010,Enfield 028,Enfield,E09000010,5307 ,2584 ,2723 
E02000305,2010,Enfield 029,Enfield,E09000010,6050 ,3065 ,2985 
E02000306,2010,Enfield 030,Enfield,E09000010,5659 ,2570 ,3089 
E02000307,2010,Enfield 031,Enfield,E09000010,6302 ,3002 ,3300 
E02000308,2010,Enfield 032,Enfield,E09000010,5375 ,2755 ,2620 
E02000309,2010,Enfield 033,Enfield,E09000010,6609 ,3224 ,3385 
E02000311,2010,Enfield 035,Enfield,E09000010,6852 ,3324 ,3528 
E02000312,2010,Enfield 036,Enfield,E09000010,7533 ,3872 ,3661 
E02006793,2010,Enfield 037,Enfield,E09000010,5750 ,2631 ,3119 
E02000313,2010,Greenwich 001,Greenwich,E09000011,4174 ,2068 ,2106 
E02000314,2010,Greenwich 002,Greenwich,E09000011,8194 ,4142 ,4052 
E02000315,2010,Greenwich 003,Greenwich,E09000011,5561 ,2628 ,2933 
E02000316,2010,Greenwich 004,Greenwich,E09000011,7432 ,3851 ,3581 
E02000317,2010,Greenwich 005,Greenwich,E09000011,5501 ,2706 ,2795 
E02000318,2010,Greenwich 006,Greenwich,E09000011,6733 ,3439 ,3294 
E02000319,2010,Greenwich 007,Greenwich,E09000011,7528 ,3977 ,3551 
E02000320,2010,Greenwich 008,Greenwich,E09000011,4327 ,2079 ,2248 
E02000321,2010,Greenwich 009,Greenwich,E09000011,4803 ,2393 ,2410 
E02000323,2010,Greenwich 011,Greenwich,E09000011,6969 ,3516 ,3453 
E02000324,2010,Greenwich 012,Greenwich,E09000011,4643 ,2306 ,2337 
E02000326,2010,Greenwich 014,Greenwich,E09000011,4887 ,2408 ,2479 
E02000327,2010,Greenwich 015,Greenwich,E09000011,4411 ,2376 ,2035 
E02000328,2010,Greenwich 016,Greenwich,E09000011,4443 ,2211 ,2232 
E02000329,2010,Greenwich 017,Greenwich,E09000011,4183 ,2104 ,2079 
E02000331,2010,Greenwich 019,Greenwich,E09000011,5290 ,2563 ,2727 
E02000332,2010,Greenwich 020,Greenwich,E09000011,4904 ,2434 ,2470 
E02000333,2010,Greenwich 021,Greenwich,E09000011,4414 ,2250 ,2164 
E02000334,2010,Greenwich 022,Greenwich,E09000011,4336 ,2155 ,2181 
E02000335,2010,Greenwich 023,Greenwich,E09000011,4316 ,2137 ,2179 
E02000337,2010,Greenwich 025,Greenwich,E09000011,5298 ,2570 ,2728 
E02000339,2010,Greenwich 027,Greenwich,E09000011,3918 ,1961 ,1957 
E02000340,2010,Greenwich 028,Greenwich,E09000011,3944 ,1996 ,1948 
E02000341,2010,Greenwich 029,Greenwich,E09000011,4916 ,2277 ,2639 
E02000342,2010,Greenwich 030,Greenwich,E09000011,4479 ,2059 ,2420 
E02000343,2010,Greenwich 031,Greenwich,E09000011,4253 ,2125 ,2128 
E02000344,2010,Greenwich 032,Greenwich,E09000011,4184 ,2084 ,2100 
E02006786,2010,Greenwich 033,Greenwich,E09000011,4573 ,2294 ,2279 
E02006927,2010,Greenwich 034,Greenwich,E09000011,5794 ,2887 ,2907 
E02006928,2010,Greenwich 035,Greenwich,E09000011,5457 ,2716 ,2741 
E02006929,2010,Greenwich 036,Greenwich,E09000011,5231 ,2620 ,2611 
E02006930,2010,Greenwich 037,Greenwich,E09000011,5063 ,2593 ,2470 
E02006931,2010,Greenwich 038,Greenwich,E09000011,6567 ,3378 ,3189 
E02000345,2010,Hackney 001,Hackney,E09000012,5285 ,2699 ,2586 
E02000346,2010,Hackney 002,Hackney,E09000012,4424 ,2217 ,2207 
E02000347,2010,Hackney 003,Hackney,E09000012,5002 ,2519 ,2483 
E02000348,2010,Hackney 004,Hackney,E09000012,4899 ,2380 ,2519 
E02000350,2010,Hackney 006,Hackney,E09000012,6949 ,3460 ,3489 
E02000351,2010,Hackney 007,Hackney,E09000012,6723 ,3366 ,3357 
E02000352,2010,Hackney 008,Hackney,E09000012,4638 ,2221 ,2417 
E02000353,2010,Hackney 009,Hackney,E09000012,5958 ,2895 ,3063 
E02000354,2010,Hackney 010,Hackney,E09000012,6792 ,3404 ,3388 
E02000355,2010,Hackney 011,Hackney,E09000012,6250 ,3124 ,3126 
E02000356,2010,Hackney 012,Hackney,E09000012,5520 ,2721 ,2799 
E02000357,2010,Hackney 013,Hackney,E09000012,3949 ,1839 ,2110 
E02000358,2010,Hackney 014,Hackney,E09000012,8395 ,4163 ,4232 
E02000359,2010,Hackney 015,Hackney,E09000012,4677 ,2195 ,2482 
E02000360,2010,Hackney 016,Hackney,E09000012,7785 ,3756 ,4029 
E02000361,2010,Hackney 017,Hackney,E09000012,5614 ,2785 ,2829 
E02000362,2010,Hackney 018,Hackney,E09000012,4375 ,2151 ,2224 
E02000363,2010,Hackney 019,Hackney,E09000012,7070 ,3422 ,3648 
E02000364,2010,Hackney 020,Hackney,E09000012,6570 ,3255 ,3315 
E02000365,2010,Hackney 021,Hackney,E09000012,9791 ,4976 ,4815 
E02000366,2010,Hackney 022,Hackney,E09000012,6002 ,2926 ,3076 
E02000367,2010,Hackney 023,Hackney,E09000012,7310 ,3543 ,3767 
E02000368,2010,Hackney 024,Hackney,E09000012,6810 ,3352 ,3458 
E02000369,2010,Hackney 025,Hackney,E09000012,8379 ,4251 ,4128 
E02000370,2010,Hackney 026,Hackney,E09000012,6009 ,3088 ,2921 
E02000371,2010,Hackney 027,Hackney,E09000012,9804 ,5234 ,4570 
E02006918,2010,Hackney 028,Hackney,E09000012,4785 ,2344 ,2441 
E02006921,2010,Hackney 029,Hackney,E09000012,4896 ,2360 ,2536 
E02000372,2010,Hammersmith and Fulham 001,Hammersmith and Fulham,E09000013,6475 ,3097 ,3378 
E02000373,2010,Hammersmith and Fulham 002,Hammersmith and Fulham,E09000013,4358 ,2008 ,2350 
E02000374,2010,Hammersmith and Fulham 003,Hammersmith and Fulham,E09000013,4902 ,2365 ,2537 
E02000375,2010,Hammersmith and Fulham 004,Hammersmith and Fulham,E09000013,5255 ,2618 ,2637 
E02000376,2010,Hammersmith and Fulham 005,Hammersmith and Fulham,E09000013,5509 ,2813 ,2696 
E02000377,2010,Hammersmith and Fulham 006,Hammersmith and Fulham,E09000013,6067 ,3062 ,3005 
E02000378,2010,Hammersmith and Fulham 007,Hammersmith and Fulham,E09000013,5113 ,2516 ,2597 
E02000379,2010,Hammersmith and Fulham 008,Hammersmith and Fulham,E09000013,5341 ,2711 ,2630 
E02000380,2010,Hammersmith and Fulham 009,Hammersmith and Fulham,E09000013,4397 ,2278 ,2119 
E02000381,2010,Hammersmith and Fulham 010,Hammersmith and Fulham,E09000013,5814 ,2796 ,3018 
E02000382,2010,Hammersmith and Fulham 011,Hammersmith and Fulham,E09000013,4489 ,2270 ,2219 
E02000383,2010,Hammersmith and Fulham 012,Hammersmith and Fulham,E09000013,7506 ,3774 ,3732 
E02000384,2010,Hammersmith and Fulham 013,Hammersmith and Fulham,E09000013,5600 ,2784 ,2816 
E02000385,2010,Hammersmith and Fulham 014,Hammersmith and Fulham,E09000013,5472 ,2828 ,2644 
E02000386,2010,Hammersmith and Fulham 015,Hammersmith and Fulham,E09000013,6197 ,3088 ,3109 
E02000387,2010,Hammersmith and Fulham 016,Hammersmith and Fulham,E09000013,4834 ,2396 ,2438 
E02000388,2010,Hammersmith and Fulham 017,Hammersmith and Fulham,E09000013,6338 ,3083 ,3255 
E02000389,2010,Hammersmith and Fulham 018,Hammersmith and Fulham,E09000013,6126 ,2956 ,3170 
E02000390,2010,Hammersmith and Fulham 019,Hammersmith and Fulham,E09000013,4864 ,2384 ,2480 
E02000391,2010,Hammersmith and Fulham 020,Hammersmith and Fulham,E09000013,5503 ,2689 ,2814 
E02000392,2010,Hammersmith and Fulham 021,Hammersmith and Fulham,E09000013,7028 ,3299 ,3729 
E02000393,2010,Hammersmith and Fulham 022,Hammersmith and Fulham,E09000013,4545 ,2152 ,2393 
E02000394,2010,Hammersmith and Fulham 023,Hammersmith and Fulham,E09000013,5588 ,2667 ,2921 
E02000395,2010,Hammersmith and Fulham 024,Hammersmith and Fulham,E09000013,4260 ,2081 ,2179 
E02000396,2010,Hammersmith and Fulham 025,Hammersmith and Fulham,E09000013,4571 ,2161 ,2410 
E02000397,2010,Haringey 001,Haringey,E09000014,5619 ,2815 ,2804 
E02000398,2010,Haringey 002,Haringey,E09000014,4800 ,2447 ,2353 
E02000400,2010,Haringey 004,Haringey,E09000014,5231 ,2544 ,2687 
E02000401,2010,Haringey 005,Haringey,E09000014,4373 ,2060 ,2313 
E02000402,2010,Haringey 006,Haringey,E09000014,4463 ,2044 ,2419 
E02000403,2010,Haringey 007,Haringey,E09000014,5607 ,2864 ,2743 
E02000404,2010,Haringey 008,Haringey,E09000014,5094 ,2520 ,2574 
E02000405,2010,Haringey 009,Haringey,E09000014,4469 ,2178 ,2291 
E02000406,2010,Haringey 010,Haringey,E09000014,5049 ,2445 ,2604 
E02000407,2010,Haringey 011,Haringey,E09000014,4935 ,2396 ,2539 
E02000408,2010,Haringey 012,Haringey,E09000014,5006 ,2436 ,2570 
E02000409,2010,Haringey 013,Haringey,E09000014,4547 ,2245 ,2302 
E02000410,2010,Haringey 014,Haringey,E09000014,4709 ,2245 ,2464 
E02000411,2010,Haringey 015,Haringey,E09000014,5358 ,2731 ,2627 
E02000412,2010,Haringey 016,Haringey,E09000014,5098 ,2573 ,2525 
E02000413,2010,Haringey 017,Haringey,E09000014,4774 ,2228 ,2546 
E02000414,2010,Haringey 018,Haringey,E09000014,4904 ,2490 ,2414 
E02000415,2010,Haringey 019,Haringey,E09000014,5058 ,2671 ,2387 
E02000416,2010,Haringey 020,Haringey,E09000014,5462 ,2721 ,2741 
E02000417,2010,Haringey 021,Haringey,E09000014,4731 ,2276 ,2455 
E02000418,2010,Haringey 022,Haringey,E09000014,3828 ,1830 ,1998 
E02000419,2010,Haringey 023,Haringey,E09000014,6144 ,3173 ,2971 
E02000420,2010,Haringey 024,Haringey,E09000014,5177 ,2581 ,2596 
E02000421,2010,Haringey 025,Haringey,E09000014,4876 ,2372 ,2504 
E02000422,2010,Haringey 026,Haringey,E09000014,5625 ,2951 ,2674 
E02000423,2010,Haringey 027,Haringey,E09000014,5257 ,2797 ,2460 
E02000424,2010,Haringey 028,Haringey,E09000014,5340 ,2655 ,2685 
E02000425,2010,Haringey 029,Haringey,E09000014,4011 ,1980 ,2031 
E02000426,2010,Haringey 030,Haringey,E09000014,4532 ,2154 ,2378 
E02000427,2010,Haringey 031,Haringey,E09000014,5343 ,2773 ,2570 
E02000428,2010,Haringey 032,Haringey,E09000014,5009 ,2488 ,2521 
E02000429,2010,Haringey 033,Haringey,E09000014,5079 ,2549 ,2530 
E02000430,2010,Haringey 034,Haringey,E09000014,5791 ,2903 ,2888 
E02000431,2010,Haringey 035,Haringey,E09000014,5100 ,2542 ,2558 
E02000432,2010,Haringey 036,Haringey,E09000014,4979 ,2435 ,2544 
E02006794,2010,Haringey 037,Haringey,E09000014,4965 ,2398 ,2567 
E02000433,2010,Harrow 001,Harrow,E09000015,4420 ,2108 ,2312 
E02000434,2010,Harrow 002,Harrow,E09000015,5224 ,2539 ,2685 
E02000435,2010,Harrow 003,Harrow,E09000015,4713 ,2259 ,2454 
E02000436,2010,Harrow 004,Harrow,E09000015,3608 ,1727 ,1881 
E02000437,2010,Harrow 005,Harrow,E09000015,5420 ,2604 ,2816 
E02000438,2010,Harrow 006,Harrow,E09000015,4933 ,2350 ,2583 
E02000439,2010,Harrow 007,Harrow,E09000015,5373 ,2656 ,2717 
E02000440,2010,Harrow 008,Harrow,E09000015,6312 ,3076 ,3236 
E02000441,2010,Harrow 009,Harrow,E09000015,4524 ,2161 ,2363 
E02000442,2010,Harrow 010,Harrow,E09000015,5912 ,3011 ,2901 
E02000443,2010,Harrow 011,Harrow,E09000015,6337 ,3174 ,3163 
E02000444,2010,Harrow 012,Harrow,E09000015,5623 ,2772 ,2851 
E02000445,2010,Harrow 013,Harrow,E09000015,6855 ,3455 ,3400 
E02000447,2010,Harrow 015,Harrow,E09000015,4774 ,2323 ,2451 
E02000448,2010,Harrow 016,Harrow,E09000015,4290 ,2114 ,2176 
E02000449,2010,Harrow 017,Harrow,E09000015,5700 ,2930 ,2770 
E02000451,2010,Harrow 019,Harrow,E09000015,4354 ,2166 ,2188 
E02000452,2010,Harrow 020,Harrow,E09000015,5906 ,3092 ,2814 
E02000453,2010,Harrow 021,Harrow,E09000015,5214 ,2571 ,2643 
E02000454,2010,Harrow 022,Harrow,E09000015,4561 ,2213 ,2348 
E02000455,2010,Harrow 023,Harrow,E09000015,5818 ,2953 ,2865 
E02000456,2010,Harrow 024,Harrow,E09000015,4768 ,2371 ,2397 
E02000457,2010,Harrow 025,Harrow,E09000015,4106 ,2055 ,2051 
E02000459,2010,Harrow 027,Harrow,E09000015,5362 ,2688 ,2674 
E02000460,2010,Harrow 028,Harrow,E09000015,4410 ,2172 ,2238 
E02000461,2010,Harrow 029,Harrow,E09000015,4961 ,2770 ,2191 
E02000462,2010,Harrow 030,Harrow,E09000015,4360 ,2219 ,2141 
E02000463,2010,Harrow 031,Harrow,E09000015,5630 ,2755 ,2875 
E02006795,2010,Harrow 032,Harrow,E09000015,5476 ,2764 ,2712 
E02006882,2010,Harrow 033,Harrow,E09000015,9731 ,4811 ,4920 
E02000464,2010,Havering 001,Havering,E09000016,3959 ,1906 ,2053 
E02000465,2010,Havering 002,Havering,E09000016,5207 ,2543 ,2664 
E02000466,2010,Havering 003,Havering,E09000016,5218 ,2478 ,2740 
E02000467,2010,Havering 004,Havering,E09000016,6244 ,2995 ,3249 
E02000468,2010,Havering 005,Havering,E09000016,4848 ,2309 ,2539 
E02000469,2010,Havering 006,Havering,E09000016,4047 ,1956 ,2091 
E02000470,2010,Havering 007,Havering,E09000016,5110 ,2562 ,2548 
E02000471,2010,Havering 008,Havering,E09000016,4749 ,2348 ,2401 
E02000472,2010,Havering 009,Havering,E09000016,5792 ,2852 ,2940 
E02000473,2010,Havering 010,Havering,E09000016,6159 ,3043 ,3116 
E02000474,2010,Havering 011,Havering,E09000016,5285 ,2578 ,2707 
E02000475,2010,Havering 012,Havering,E09000016,6010 ,2947 ,3063 
E02000476,2010,Havering 013,Havering,E09000016,5601 ,2777 ,2824 
E02000477,2010,Havering 014,Havering,E09000016,6168 ,3031 ,3137 
E02000478,2010,Havering 015,Havering,E09000016,3741 ,1877 ,1864 
E02000479,2010,Havering 016,Havering,E09000016,5667 ,2793 ,2874 
E02000480,2010,Havering 017,Havering,E09000016,6405 ,3158 ,3247 
E02000481,2010,Havering 018,Havering,E09000016,4568 ,2203 ,2365 
E02000482,2010,Havering 019,Havering,E09000016,3862 ,1932 ,1930 
E02000483,2010,Havering 020,Havering,E09000016,4826 ,2381 ,2445 
E02000484,2010,Havering 021,Havering,E09000016,5579 ,2800 ,2779 
E02000485,2010,Havering 022,Havering,E09000016,5075 ,2514 ,2561 
E02000486,2010,Havering 023,Havering,E09000016,4882 ,2407 ,2475 
E02000487,2010,Havering 024,Havering,E09000016,4929 ,2465 ,2464 
E02000488,2010,Havering 025,Havering,E09000016,4924 ,2468 ,2456 
E02000489,2010,Havering 026,Havering,E09000016,5005 ,2430 ,2575 
E02000490,2010,Havering 027,Havering,E09000016,4759 ,2312 ,2447 
E02000491,2010,Havering 028,Havering,E09000016,5521 ,2766 ,2755 
E02000492,2010,Havering 029,Havering,E09000016,3939 ,1988 ,1951 
E02000493,2010,Havering 030,Havering,E09000016,4104 ,1929 ,2175 
E02000494,2010,Hillingdon 001,Hillingdon,E09000017,4755 ,2268 ,2487 
E02000495,2010,Hillingdon 002,Hillingdon,E09000017,6106 ,2934 ,3172 
E02000496,2010,Hillingdon 003,Hillingdon,E09000017,4771 ,2323 ,2448 
E02000497,2010,Hillingdon 004,Hillingdon,E09000017,5343 ,2609 ,2734 
E02000498,2010,Hillingdon 005,Hillingdon,E09000017,3904 ,1883 ,2021 
E02000499,2010,Hillingdon 006,Hillingdon,E09000017,4804 ,2350 ,2454 
E02000500,2010,Hillingdon 007,Hillingdon,E09000017,4901 ,2473 ,2428 
E02000501,2010,Hillingdon 008,Hillingdon,E09000017,5303 ,2554 ,2749 
E02000502,2010,Hillingdon 009,Hillingdon,E09000017,4903 ,2417 ,2486 
E02000503,2010,Hillingdon 010,Hillingdon,E09000017,5985 ,3023 ,2962 
E02000504,2010,Hillingdon 011,Hillingdon,E09000017,4560 ,2258 ,2302 
E02000506,2010,Hillingdon 013,Hillingdon,E09000017,4865 ,2435 ,2430 
E02000507,2010,Hillingdon 014,Hillingdon,E09000017,5260 ,2640 ,2620 
E02000508,2010,Hillingdon 015,Hillingdon,E09000017,6860 ,3731 ,3129 
E02000509,2010,Hillingdon 016,Hillingdon,E09000017,8102 ,4071 ,4031 
E02000510,2010,Hillingdon 017,Hillingdon,E09000017,5694 ,2857 ,2837 
E02000511,2010,Hillingdon 018,Hillingdon,E09000017,6101 ,3008 ,3093 
E02000512,2010,Hillingdon 019,Hillingdon,E09000017,5320 ,2629 ,2691 
E02000513,2010,Hillingdon 020,Hillingdon,E09000017,5761 ,2694 ,3067 
E02000514,2010,Hillingdon 021,Hillingdon,E09000017,6494 ,3289 ,3205 
E02000515,2010,Hillingdon 022,Hillingdon,E09000017,7290 ,3725 ,3565 
E02000516,2010,Hillingdon 023,Hillingdon,E09000017,5485 ,2720 ,2765 
E02000517,2010,Hillingdon 024,Hillingdon,E09000017,5074 ,2419 ,2655 
E02000518,2010,Hillingdon 025,Hillingdon,E09000017,5620 ,2804 ,2816 
E02000519,2010,Hillingdon 026,Hillingdon,E09000017,5617 ,2850 ,2767 
E02000520,2010,Hillingdon 027,Hillingdon,E09000017,7345 ,3755 ,3590 
E02000521,2010,Hillingdon 028,Hillingdon,E09000017,6249 ,3089 ,3160 
E02000522,2010,Hillingdon 029,Hillingdon,E09000017,5478 ,2642 ,2836 
E02000523,2010,Hillingdon 030,Hillingdon,E09000017,6134 ,3111 ,3023 
E02000524,2010,Hillingdon 031,Hillingdon,E09000017,4587 ,2557 ,2030 
E02000525,2010,Hillingdon 032,Hillingdon,E09000017,5831 ,2912 ,2919 
E02006796,2010,Hillingdon 033,Hillingdon,E09000017,5761 ,2866 ,2895 
E02000526,2010,Hounslow 001,Hounslow,E09000018,5985 ,2940 ,3045 
E02000528,2010,Hounslow 003,Hounslow,E09000018,7343 ,3588 ,3755 
E02000529,2010,Hounslow 004,Hounslow,E09000018,5769 ,2919 ,2850 
E02000530,2010,Hounslow 005,Hounslow,E09000018,4349 ,2141 ,2208 
E02000531,2010,Hounslow 006,Hounslow,E09000018,7762 ,3817 ,3945 
E02000532,2010,Hounslow 007,Hounslow,E09000018,6348 ,3155 ,3193 
E02000533,2010,Hounslow 008,Hounslow,E09000018,5922 ,2977 ,2945 
E02000534,2010,Hounslow 009,Hounslow,E09000018,5504 ,2854 ,2650 
E02000535,2010,Hounslow 010,Hounslow,E09000018,6372 ,3313 ,3059 
E02000536,2010,Hounslow 011,Hounslow,E09000018,6384 ,3300 ,3084 
E02000537,2010,Hounslow 012,Hounslow,E09000018,6222 ,3324 ,2898 
E02000538,2010,Hounslow 013,Hounslow,E09000018,5894 ,3067 ,2827 
E02000539,2010,Hounslow 014,Hounslow,E09000018,7263 ,3528 ,3735 
E02000540,2010,Hounslow 015,Hounslow,E09000018,6299 ,3378 ,2921 
E02000541,2010,Hounslow 016,Hounslow,E09000018,6002 ,3112 ,2890 
E02000542,2010,Hounslow 017,Hounslow,E09000018,6334 ,3333 ,3001 
E02000543,2010,Hounslow 018,Hounslow,E09000018,8284 ,4328 ,3956 
E02000544,2010,Hounslow 019,Hounslow,E09000018,5701 ,2880 ,2821 
E02000545,2010,Hounslow 020,Hounslow,E09000018,5595 ,2695 ,2900 
E02000546,2010,Hounslow 021,Hounslow,E09000018,6782 ,3521 ,3261 
E02000547,2010,Hounslow 022,Hounslow,E09000018,6184 ,3103 ,3081 
E02000548,2010,Hounslow 023,Hounslow,E09000018,5916 ,2924 ,2992 
E02000549,2010,Hounslow 024,Hounslow,E09000018,7227 ,3690 ,3537 
E02000550,2010,Hounslow 025,Hounslow,E09000018,6863 ,3341 ,3522 
E02000551,2010,Hounslow 026,Hounslow,E09000018,5556 ,2679 ,2877 
E02000552,2010,Hounslow 027,Hounslow,E09000018,5621 ,2918 ,2703 
E02000553,2010,Hounslow 028,Hounslow,E09000018,4387 ,2153 ,2234 
E02006792,2010,Hounslow 029,Hounslow,E09000018,6133 ,3158 ,2975 
E02000554,2010,Islington 001,Islington,E09000019,6602 ,3071 ,3531 
E02000555,2010,Islington 002,Islington,E09000019,6533 ,3040 ,3493 
E02000556,2010,Islington 003,Islington,E09000019,7583 ,3721 ,3862 
E02000557,2010,Islington 004,Islington,E09000019,5753 ,2764 ,2989 
E02000558,2010,Islington 005,Islington,E09000019,5787 ,2863 ,2924 
E02000559,2010,Islington 006,Islington,E09000019,6442 ,3284 ,3158 
E02000560,2010,Islington 007,Islington,E09000019,5456 ,2761 ,2695 
E02000561,2010,Islington 008,Islington,E09000019,5621 ,2713 ,2908 
E02000562,2010,Islington 009,Islington,E09000019,5630 ,2681 ,2949 
E02000563,2010,Islington 010,Islington,E09000019,6286 ,2908 ,3378 
E02000564,2010,Islington 011,Islington,E09000019,7717 ,3845 ,3872 
E02000565,2010,Islington 012,Islington,E09000019,5840 ,2736 ,3104 
E02000566,2010,Islington 013,Islington,E09000019,6016 ,2916 ,3100 
E02000567,2010,Islington 014,Islington,E09000019,7873 ,3765 ,4108 
E02000568,2010,Islington 015,Islington,E09000019,6911 ,3723 ,3188 
E02000569,2010,Islington 016,Islington,E09000019,7299 ,3467 ,3832 
E02000570,2010,Islington 017,Islington,E09000019,6540 ,3216 ,3324 
E02000571,2010,Islington 018,Islington,E09000019,5759 ,2866 ,2893 
E02000572,2010,Islington 019,Islington,E09000019,5651 ,2673 ,2978 
E02000573,2010,Islington 020,Islington,E09000019,6731 ,3440 ,3291 
E02000574,2010,Islington 021,Islington,E09000019,6648 ,3315 ,3333 
E02000575,2010,Islington 022,Islington,E09000019,9278 ,4886 ,4392 
E02000576,2010,Islington 023,Islington,E09000019,6935 ,3596 ,3339 
E02000577,2010,Kensington and Chelsea 001,Kensington and Chelsea,E09000020,4984 ,2402 ,2582 
E02000578,2010,Kensington and Chelsea 002,Kensington and Chelsea,E09000020,3937 ,1852 ,2085 
E02000579,2010,Kensington and Chelsea 003,Kensington and Chelsea,E09000020,5996 ,2785 ,3211 
E02000580,2010,Kensington and Chelsea 004,Kensington and Chelsea,E09000020,6704 ,3296 ,3408 
E02000581,2010,Kensington and Chelsea 005,Kensington and Chelsea,E09000020,4789 ,2246 ,2543 
E02000582,2010,Kensington and Chelsea 006,Kensington and Chelsea,E09000020,5936 ,3005 ,2931 
E02000583,2010,Kensington and Chelsea 007,Kensington and Chelsea,E09000020,5373 ,2535 ,2838 
E02000584,2010,Kensington and Chelsea 008,Kensington and Chelsea,E09000020,5846 ,2815 ,3031 
E02000585,2010,Kensington and Chelsea 009,Kensington and Chelsea,E09000020,6244 ,3060 ,3184 
E02000586,2010,Kensington and Chelsea 010,Kensington and Chelsea,E09000020,6001 ,3084 ,2917 
E02000587,2010,Kensington and Chelsea 011,Kensington and Chelsea,E09000020,5439 ,2745 ,2694 
E02000588,2010,Kensington and Chelsea 012,Kensington and Chelsea,E09000020,6237 ,3208 ,3029 
E02000589,2010,Kensington and Chelsea 013,Kensington and Chelsea,E09000020,7014 ,3835 ,3179 
E02000590,2010,Kensington and Chelsea 014,Kensington and Chelsea,E09000020,5244 ,2445 ,2799 
E02000591,2010,Kensington and Chelsea 015,Kensington and Chelsea,E09000020,5393 ,2811 ,2582 
E02000592,2010,Kensington and Chelsea 016,Kensington and Chelsea,E09000020,5323 ,2731 ,2592 
E02000593,2010,Kensington and Chelsea 017,Kensington and Chelsea,E09000020,5941 ,3091 ,2850 
E02000594,2010,Kensington and Chelsea 018,Kensington and Chelsea,E09000020,5024 ,2443 ,2581 
E02000595,2010,Kensington and Chelsea 019,Kensington and Chelsea,E09000020,5250 ,2523 ,2727 
E02000596,2010,Kensington and Chelsea 020,Kensington and Chelsea,E09000020,6062 ,3012 ,3050 
E02000597,2010,Kensington and Chelsea 021,Kensington and Chelsea,E09000020,4964 ,2269 ,2695 
E02000598,2010,Kingston upon Thames 001,Kingston upon Thames,E09000021,4839 ,2271 ,2568 
E02000599,2010,Kingston upon Thames 002,Kingston upon Thames,E09000021,4895 ,2413 ,2482 
E02000600,2010,Kingston upon Thames 003,Kingston upon Thames,E09000021,5991 ,2948 ,3043 
E02000601,2010,Kingston upon Thames 004,Kingston upon Thames,E09000021,7119 ,3511 ,3608 
E02000602,2010,Kingston upon Thames 005,Kingston upon Thames,E09000021,6929 ,3463 ,3466 
E02000603,2010,Kingston upon Thames 006,Kingston upon Thames,E09000021,5177 ,2486 ,2691 
E02000604,2010,Kingston upon Thames 007,Kingston upon Thames,E09000021,5676 ,2794 ,2882 
E02000605,2010,Kingston upon Thames 008,Kingston upon Thames,E09000021,5285 ,2617 ,2668 
E02000606,2010,Kingston upon Thames 009,Kingston upon Thames,E09000021,7913 ,4169 ,3744 
E02000607,2010,Kingston upon Thames 010,Kingston upon Thames,E09000021,4957 ,2421 ,2536 
E02000608,2010,Kingston upon Thames 011,Kingston upon Thames,E09000021,5596 ,2899 ,2697 
E02000609,2010,Kingston upon Thames 012,Kingston upon Thames,E09000021,4615 ,2241 ,2374 
E02000610,2010,Kingston upon Thames 013,Kingston upon Thames,E09000021,5666 ,2949 ,2717 
E02000611,2010,Kingston upon Thames 014,Kingston upon Thames,E09000021,4724 ,2355 ,2369 
E02000612,2010,Kingston upon Thames 015,Kingston upon Thames,E09000021,5204 ,2505 ,2699 
E02000613,2010,Kingston upon Thames 016,Kingston upon Thames,E09000021,5213 ,2512 ,2701 
E02000614,2010,Kingston upon Thames 017,Kingston upon Thames,E09000021,5660 ,2770 ,2890 
E02000615,2010,Kingston upon Thames 018,Kingston upon Thames,E09000021,4913 ,2442 ,2471 
E02000616,2010,Kingston upon Thames 019,Kingston upon Thames,E09000021,4054 ,1953 ,2101 
E02000617,2010,Kingston upon Thames 020,Kingston upon Thames,E09000021,5504 ,2626 ,2878 
E02000619,2010,Lambeth 002,Lambeth,E09000022,5735 ,2971 ,2764 
E02000620,2010,Lambeth 003,Lambeth,E09000022,6988 ,3770 ,3218 
E02000621,2010,Lambeth 004,Lambeth,E09000022,7977 ,4433 ,3544 
E02000622,2010,Lambeth 005,Lambeth,E09000022,6145 ,3315 ,2830 
E02000623,2010,Lambeth 006,Lambeth,E09000022,5639 ,2935 ,2704 
E02000624,2010,Lambeth 007,Lambeth,E09000022,5917 ,3049 ,2868 
E02000625,2010,Lambeth 008,Lambeth,E09000022,6005 ,3076 ,2929 
E02000626,2010,Lambeth 009,Lambeth,E09000022,5828 ,2902 ,2926 
E02000627,2010,Lambeth 010,Lambeth,E09000022,7188 ,3699 ,3489 
E02000628,2010,Lambeth 011,Lambeth,E09000022,6937 ,3507 ,3430 
E02000629,2010,Lambeth 012,Lambeth,E09000022,7202 ,3706 ,3496 
E02000630,2010,Lambeth 013,Lambeth,E09000022,5625 ,2845 ,2780 
E02000631,2010,Lambeth 014,Lambeth,E09000022,6433 ,3175 ,3258 
E02000632,2010,Lambeth 015,Lambeth,E09000022,8171 ,4140 ,4031 
E02000633,2010,Lambeth 016,Lambeth,E09000022,6462 ,3265 ,3197 
E02000634,2010,Lambeth 017,Lambeth,E09000022,5211 ,2587 ,2624 
E02000635,2010,Lambeth 018,Lambeth,E09000022,7107 ,3606 ,3501 
E02000636,2010,Lambeth 019,Lambeth,E09000022,5758 ,2889 ,2869 
E02000637,2010,Lambeth 020,Lambeth,E09000022,6734 ,3455 ,3279 
E02000638,2010,Lambeth 021,Lambeth,E09000022,7199 ,3650 ,3549 
E02000639,2010,Lambeth 022,Lambeth,E09000022,5768 ,2762 ,3006 
E02000640,2010,Lambeth 023,Lambeth,E09000022,6586 ,3122 ,3464 
E02000641,2010,Lambeth 024,Lambeth,E09000022,5899 ,2734 ,3165 
E02000642,2010,Lambeth 025,Lambeth,E09000022,6676 ,3225 ,3451 
E02000643,2010,Lambeth 026,Lambeth,E09000022,5953 ,2857 ,3096 
E02000644,2010,Lambeth 027,Lambeth,E09000022,5861 ,2925 ,2936 
E02000645,2010,Lambeth 028,Lambeth,E09000022,6487 ,3181 ,3306 
E02000646,2010,Lambeth 029,Lambeth,E09000022,6746 ,3410 ,3336 
E02000647,2010,Lambeth 030,Lambeth,E09000022,5881 ,2935 ,2946 
E02000648,2010,Lambeth 031,Lambeth,E09000022,4878 ,2171 ,2707 
E02000649,2010,Lambeth 032,Lambeth,E09000022,8089 ,4001 ,4088 
E02000650,2010,Lambeth 033,Lambeth,E09000022,5331 ,2538 ,2793 
E02000651,2010,Lambeth 034,Lambeth,E09000022,5938 ,2955 ,2983 
E02000652,2010,Lambeth 035,Lambeth,E09000022,4775 ,2374 ,2401 
E02006801,2010,Lambeth 036,Lambeth,E09000022,6464 ,3429 ,3035 
E02000653,2010,Lewisham 001,Lewisham,E09000023,6024 ,3093 ,2931 
E02000654,2010,Lewisham 002,Lewisham,E09000023,5421 ,2631 ,2790 
E02000655,2010,Lewisham 003,Lewisham,E09000023,5983 ,2957 ,3026 
E02000657,2010,Lewisham 005,Lewisham,E09000023,6977 ,3515 ,3462 
E02000658,2010,Lewisham 006,Lewisham,E09000023,5950 ,3125 ,2825 
E02000659,2010,Lewisham 007,Lewisham,E09000023,5460 ,2690 ,2770 
E02000660,2010,Lewisham 008,Lewisham,E09000023,6242 ,3107 ,3135 
E02000661,2010,Lewisham 009,Lewisham,E09000023,4522 ,2327 ,2195 
E02000662,2010,Lewisham 010,Lewisham,E09000023,5735 ,2750 ,2985 
E02000663,2010,Lewisham 011,Lewisham,E09000023,5577 ,2999 ,2578 
E02000664,2010,Lewisham 012,Lewisham,E09000023,7039 ,3676 ,3363 
E02000665,2010,Lewisham 013,Lewisham,E09000023,5476 ,2728 ,2748 
E02000666,2010,Lewisham 014,Lewisham,E09000023,5223 ,2500 ,2723 
E02000667,2010,Lewisham 015,Lewisham,E09000023,4598 ,2225 ,2373 
E02000668,2010,Lewisham 016,Lewisham,E09000023,4609 ,2262 ,2347 
E02000669,2010,Lewisham 017,Lewisham,E09000023,5596 ,2855 ,2741 
E02000670,2010,Lewisham 018,Lewisham,E09000023,4365 ,2044 ,2321 
E02000671,2010,Lewisham 019,Lewisham,E09000023,6099 ,2989 ,3110 
E02000672,2010,Lewisham 020,Lewisham,E09000023,5748 ,2952 ,2796 
E02000673,2010,Lewisham 021,Lewisham,E09000023,5612 ,2831 ,2781 
E02000674,2010,Lewisham 022,Lewisham,E09000023,5338 ,2472 ,2866 
E02000675,2010,Lewisham 023,Lewisham,E09000023,5571 ,2648 ,2923 
E02000676,2010,Lewisham 024,Lewisham,E09000023,5487 ,2676 ,2811 
E02000677,2010,Lewisham 025,Lewisham,E09000023,4915 ,2434 ,2481 
E02000678,2010,Lewisham 026,Lewisham,E09000023,3770 ,1741 ,2029 
E02000679,2010,Lewisham 027,Lewisham,E09000023,5398 ,2674 ,2724 
E02000680,2010,Lewisham 028,Lewisham,E09000023,4585 ,2284 ,2301 
E02000681,2010,Lewisham 029,Lewisham,E09000023,5276 ,2463 ,2813 
E02000682,2010,Lewisham 030,Lewisham,E09000023,5141 ,2424 ,2717 
E02000683,2010,Lewisham 031,Lewisham,E09000023,4156 ,1922 ,2234 
E02000685,2010,Lewisham 033,Lewisham,E09000023,5157 ,2493 ,2664 
E02000686,2010,Lewisham 034,Lewisham,E09000023,4364 ,2005 ,2359 
E02000687,2010,Lewisham 035,Lewisham,E09000023,5555 ,2809 ,2746 
E02006783,2010,Lewisham 037,Lewisham,E09000023,4368 ,1962 ,2406 
E02006784,2010,Lewisham 038,Lewisham,E09000023,4683 ,2226 ,2457 
E02006798,2010,Lewisham 039,Lewisham,E09000023,5549 ,2746 ,2803 
E02000689,2010,Merton 001,Merton,E09000024,5661 ,2754 ,2907 
E02000690,2010,Merton 002,Merton,E09000024,3504 ,1766 ,1738 
E02000691,2010,Merton 003,Merton,E09000024,5487 ,2769 ,2718 
E02000692,2010,Merton 004,Merton,E09000024,5704 ,2938 ,2766 
E02000693,2010,Merton 005,Merton,E09000024,7427 ,3920 ,3507 
E02000694,2010,Merton 006,Merton,E09000024,6634 ,3273 ,3361 
E02000695,2010,Merton 007,Merton,E09000024,5840 ,3089 ,2751 
E02000696,2010,Merton 008,Merton,E09000024,5976 ,2949 ,3027 
E02000697,2010,Merton 009,Merton,E09000024,6437 ,3301 ,3136 
E02000698,2010,Merton 010,Merton,E09000024,5207 ,2574 ,2633 
E02000699,2010,Merton 011,Merton,E09000024,5759 ,2804 ,2955 
E02000700,2010,Merton 012,Merton,E09000024,6052 ,2948 ,3104 
E02000701,2010,Merton 013,Merton,E09000024,5735 ,2848 ,2887 
E02000702,2010,Merton 014,Merton,E09000024,5052 ,2391 ,2661 
E02000703,2010,Merton 015,Merton,E09000024,5148 ,2628 ,2520 
E02000704,2010,Merton 016,Merton,E09000024,5571 ,2767 ,2804 
E02000705,2010,Merton 017,Merton,E09000024,5462 ,2621 ,2841 
E02000706,2010,Merton 018,Merton,E09000024,5590 ,2642 ,2948 
E02000707,2010,Merton 019,Merton,E09000024,4805 ,2254 ,2551 
E02000708,2010,Merton 020,Merton,E09000024,5465 ,2685 ,2780 
E02000709,2010,Merton 021,Merton,E09000024,5059 ,2511 ,2548 
E02000710,2010,Merton 022,Merton,E09000024,5387 ,2645 ,2742 
E02000711,2010,Merton 023,Merton,E09000024,5464 ,2762 ,2702 
E02000712,2010,Merton 024,Merton,E09000024,5497 ,2693 ,2804 
E02000713,2010,Merton 025,Merton,E09000024,4838 ,2399 ,2439 
E02000714,2010,Newham 001,Newham,E09000025,5612 ,2921 ,2691 
E02000715,2010,Newham 002,Newham,E09000025,4623 ,2481 ,2142 
E02000716,2010,Newham 003,Newham,E09000025,4956 ,2707 ,2249 
E02000717,2010,Newham 004,Newham,E09000025,5425 ,2957 ,2468 
E02000718,2010,Newham 005,Newham,E09000025,4088 ,2038 ,2050 
E02000719,2010,Newham 006,Newham,E09000025,5826 ,2997 ,2829 
E02000720,2010,Newham 007,Newham,E09000025,5295 ,2943 ,2352 
E02000721,2010,Newham 008,Newham,E09000025,6830 ,3817 ,3013 
E02000722,2010,Newham 009,Newham,E09000025,6119 ,3170 ,2949 
E02000723,2010,Newham 010,Newham,E09000025,7467 ,4236 ,3231 
E02000724,2010,Newham 011,Newham,E09000025,6551 ,3740 ,2811 
E02000725,2010,Newham 012,Newham,E09000025,6764 ,3470 ,3294 
E02000726,2010,Newham 013,Newham,E09000025,6567 ,3532 ,3035 
E02000727,2010,Newham 014,Newham,E09000025,5981 ,3540 ,2441 
E02000728,2010,Newham 015,Newham,E09000025,5776 ,3243 ,2533 
E02000729,2010,Newham 016,Newham,E09000025,4945 ,2606 ,2339 
E02000730,2010,Newham 017,Newham,E09000025,6368 ,3627 ,2741 
E02000731,2010,Newham 018,Newham,E09000025,6945 ,4101 ,2844 
E02000732,2010,Newham 019,Newham,E09000025,4934 ,2700 ,2234 
E02000733,2010,Newham 020,Newham,E09000025,6613 ,3382 ,3231 
E02000734,2010,Newham 021,Newham,E09000025,5049 ,2575 ,2474 
E02000735,2010,Newham 022,Newham,E09000025,5051 ,2795 ,2256 
E02000736,2010,Newham 023,Newham,E09000025,5557 ,2864 ,2693 
E02000737,2010,Newham 024,Newham,E09000025,5909 ,2989 ,2920 
E02000738,2010,Newham 025,Newham,E09000025,5606 ,2950 ,2656 
E02000739,2010,Newham 026,Newham,E09000025,4709 ,2436 ,2273 
E02000740,2010,Newham 027,Newham,E09000025,4707 ,2351 ,2356 
E02000741,2010,Newham 028,Newham,E09000025,5428 ,2757 ,2671 
E02000742,2010,Newham 029,Newham,E09000025,4961 ,2478 ,2483 
E02000743,2010,Newham 030,Newham,E09000025,5111 ,2574 ,2537 
E02000744,2010,Newham 031,Newham,E09000025,5200 ,2590 ,2610 
E02000745,2010,Newham 032,Newham,E09000025,5646 ,2723 ,2923 
E02000746,2010,Newham 033,Newham,E09000025,5220 ,2431 ,2789 
E02000747,2010,Newham 034,Newham,E09000025,7626 ,4030 ,3596 
E02000748,2010,Newham 035,Newham,E09000025,4419 ,2129 ,2290 
E02000749,2010,Newham 036,Newham,E09000025,5349 ,2562 ,2787 
E02000750,2010,Newham 037,Newham,E09000025,7473 ,3888 ,3585 
E02000751,2010,Redbridge 001,Redbridge,E09000026,6607 ,3258 ,3349 
E02000752,2010,Redbridge 002,Redbridge,E09000026,4251 ,2035 ,2216 
E02000753,2010,Redbridge 003,Redbridge,E09000026,3901 ,1840 ,2061 
E02000754,2010,Redbridge 004,Redbridge,E09000026,4276 ,2086 ,2190 
E02000755,2010,Redbridge 005,Redbridge,E09000026,3483 ,1687 ,1796 
E02000756,2010,Redbridge 006,Redbridge,E09000026,8294 ,4038 ,4256 
E02000757,2010,Redbridge 007,Redbridge,E09000026,7911 ,3963 ,3948 
E02000758,2010,Redbridge 008,Redbridge,E09000026,3851 ,1871 ,1980 
E02000759,2010,Redbridge 009,Redbridge,E09000026,8221 ,4016 ,4205 
E02000760,2010,Redbridge 010,Redbridge,E09000026,4356 ,2099 ,2257 
E02000762,2010,Redbridge 012,Redbridge,E09000026,4128 ,2081 ,2047 
E02000763,2010,Redbridge 013,Redbridge,E09000026,4562 ,2201 ,2361 
E02000764,2010,Redbridge 014,Redbridge,E09000026,8028 ,3934 ,4094 
E02000765,2010,Redbridge 015,Redbridge,E09000026,4035 ,2019 ,2016 
E02000767,2010,Redbridge 017,Redbridge,E09000026,4861 ,2381 ,2480 
E02000768,2010,Redbridge 018,Redbridge,E09000026,3888 ,1909 ,1979 
E02000769,2010,Redbridge 019,Redbridge,E09000026,9246 ,4464 ,4782 
E02000770,2010,Redbridge 020,Redbridge,E09000026,4904 ,2500 ,2404 
E02000772,2010,Redbridge 022,Redbridge,E09000026,5072 ,2613 ,2459 
E02000773,2010,Redbridge 023,Redbridge,E09000026,5910 ,2925 ,2985 
E02000774,2010,Redbridge 024,Redbridge,E09000026,4832 ,2527 ,2305 
E02000776,2010,Redbridge 026,Redbridge,E09000026,4194 ,2122 ,2072 
E02000777,2010,Redbridge 027,Redbridge,E09000026,4060 ,1987 ,2073 
E02000779,2010,Redbridge 029,Redbridge,E09000026,5120 ,2685 ,2435 
E02000780,2010,Redbridge 030,Redbridge,E09000026,9162 ,4714 ,4448 
E02000781,2010,Redbridge 031,Redbridge,E09000026,8764 ,4418 ,4346 
E02000782,2010,Redbridge 032,Redbridge,E09000026,5819 ,2954 ,2865 
E02000783,2010,Redbridge 033,Redbridge,E09000026,4399 ,2214 ,2185 
E02006800,2010,Redbridge 034,Redbridge,E09000026,8827 ,4479 ,4348 
E02006924,2010,Redbridge 035,Redbridge,E09000026,8541 ,4492 ,4049 
E02006925,2010,Redbridge 036,Redbridge,E09000026,8558 ,4198 ,4360 
E02000784,2010,Richmond upon Thames 001,Richmond upon Thames,E09000027,6989 ,3449 ,3540 
E02000785,2010,Richmond upon Thames 002,Richmond upon Thames,E09000027,6678 ,3344 ,3334 
E02000786,2010,Richmond upon Thames 003,Richmond upon Thames,E09000027,7703 ,3752 ,3951 
E02000787,2010,Richmond upon Thames 004,Richmond upon Thames,E09000027,7407 ,3669 ,3738 
E02000788,2010,Richmond upon Thames 005,Richmond upon Thames,E09000027,5839 ,2865 ,2974 
E02000789,2010,Richmond upon Thames 006,Richmond upon Thames,E09000027,4421 ,2236 ,2185 
E02000790,2010,Richmond upon Thames 007,Richmond upon Thames,E09000027,4142 ,2017 ,2125 
E02000791,2010,Richmond upon Thames 008,Richmond upon Thames,E09000027,4483 ,2363 ,2120 
E02000792,2010,Richmond upon Thames 009,Richmond upon Thames,E09000027,4773 ,2374 ,2399 
E02000793,2010,Richmond upon Thames 010,Richmond upon Thames,E09000027,5264 ,2561 ,2703 
E02000794,2010,Richmond upon Thames 011,Richmond upon Thames,E09000027,4530 ,2265 ,2265 
E02000795,2010,Richmond upon Thames 012,Richmond upon Thames,E09000027,4202 ,2150 ,2052 
E02000796,2010,Richmond upon Thames 013,Richmond upon Thames,E09000027,6510 ,3187 ,3323 
E02000797,2010,Richmond upon Thames 014,Richmond upon Thames,E09000027,5208 ,2637 ,2571 
E02000798,2010,Richmond upon Thames 015,Richmond upon Thames,E09000027,7087 ,3414 ,3673 
E02000799,2010,Richmond upon Thames 016,Richmond upon Thames,E09000027,4651 ,2269 ,2382 
E02000800,2010,Richmond upon Thames 017,Richmond upon Thames,E09000027,3356 ,1648 ,1708 
E02000801,2010,Richmond upon Thames 018,Richmond upon Thames,E09000027,4570 ,2205 ,2365 
E02000802,2010,Richmond upon Thames 019,Richmond upon Thames,E09000027,4425 ,2187 ,2238 
E02000803,2010,Richmond upon Thames 020,Richmond upon Thames,E09000027,6157 ,2916 ,3241 
E02000804,2010,Richmond upon Thames 021,Richmond upon Thames,E09000027,4813 ,2330 ,2483 
E02000805,2010,Richmond upon Thames 022,Richmond upon Thames,E09000027,6878 ,3398 ,3480 
E02000806,2010,Richmond upon Thames 023,Richmond upon Thames,E09000027,6556 ,3172 ,3384 
E02000807,2010,Southwark 001,Southwark,E09000028,6599 ,3441 ,3158 
E02000808,2010,Southwark 002,Southwark,E09000028,7433 ,3948 ,3485 
E02000809,2010,Southwark 003,Southwark,E09000028,10125 ,5685 ,4440 
E02000810,2010,Southwark 004,Southwark,E09000028,6581 ,3280 ,3301 
E02000812,2010,Southwark 006,Southwark,E09000028,7730 ,3821 ,3909 
E02000813,2010,Southwark 007,Southwark,E09000028,5906 ,2934 ,2972 
E02000814,2010,Southwark 008,Southwark,E09000028,7036 ,3650 ,3386 
E02000815,2010,Southwark 009,Southwark,E09000028,5506 ,2831 ,2675 
E02000816,2010,Southwark 010,Southwark,E09000028,6298 ,3010 ,3288 
E02000817,2010,Southwark 011,Southwark,E09000028,4490 ,2196 ,2294 
E02000818,2010,Southwark 012,Southwark,E09000028,5511 ,2824 ,2687 
E02000819,2010,Southwark 013,Southwark,E09000028,5796 ,2870 ,2926 
E02000820,2010,Southwark 014,Southwark,E09000028,6236 ,3264 ,2972 
E02000821,2010,Southwark 015,Southwark,E09000028,5763 ,2790 ,2973 
E02000822,2010,Southwark 016,Southwark,E09000028,5751 ,2865 ,2886 
E02000823,2010,Southwark 017,Southwark,E09000028,5524 ,2745 ,2779 
E02000824,2010,Southwark 018,Southwark,E09000028,6344 ,3028 ,3316 
E02000825,2010,Southwark 019,Southwark,E09000028,6412 ,3037 ,3375 
E02000826,2010,Southwark 020,Southwark,E09000028,6286 ,3061 ,3225 
E02000827,2010,Southwark 021,Southwark,E09000028,7417 ,3769 ,3648 
E02000828,2010,Southwark 022,Southwark,E09000028,5991 ,2928 ,3063 
E02000829,2010,Southwark 023,Southwark,E09000028,7466 ,3907 ,3559 
E02000830,2010,Southwark 024,Southwark,E09000028,6667 ,3266 ,3401 
E02000831,2010,Southwark 025,Southwark,E09000028,6745 ,3302 ,3443 
E02000832,2010,Southwark 026,Southwark,E09000028,6873 ,3203 ,3670 
E02000833,2010,Southwark 027,Southwark,E09000028,5566 ,2589 ,2977 
E02000834,2010,Southwark 028,Southwark,E09000028,7092 ,3382 ,3710 
E02000835,2010,Southwark 029,Southwark,E09000028,4896 ,2356 ,2540 
E02000836,2010,Southwark 030,Southwark,E09000028,5935 ,2884 ,3051 
E02000837,2010,Southwark 031,Southwark,E09000028,5707 ,2734 ,2973 
E02000838,2010,Southwark 032,Southwark,E09000028,6471 ,3085 ,3386 
E02000839,2010,Southwark 033,Southwark,E09000028,5435 ,2666 ,2769 
E02006802,2010,Southwark 034,Southwark,E09000028,6128 ,3223 ,2905 
E02000840,2010,Sutton 001,Sutton,E09000029,5351 ,2520 ,2831 
E02000841,2010,Sutton 002,Sutton,E09000029,5670 ,2695 ,2975 
E02000842,2010,Sutton 003,Sutton,E09000029,5064 ,2520 ,2544 
E02000843,2010,Sutton 004,Sutton,E09000029,5278 ,2579 ,2699 
E02000844,2010,Sutton 005,Sutton,E09000029,5109 ,2470 ,2639 
E02000845,2010,Sutton 006,Sutton,E09000029,5839 ,2824 ,3015 
E02000846,2010,Sutton 007,Sutton,E09000029,4576 ,2275 ,2301 
E02000847,2010,Sutton 008,Sutton,E09000029,5571 ,2753 ,2818 
E02000848,2010,Sutton 009,Sutton,E09000029,5099 ,2506 ,2593 
E02000849,2010,Sutton 010,Sutton,E09000029,4979 ,2456 ,2523 
E02000850,2010,Sutton 011,Sutton,E09000029,6862 ,3426 ,3436 
E02000851,2010,Sutton 012,Sutton,E09000029,5794 ,2977 ,2817 
E02000852,2010,Sutton 013,Sutton,E09000029,5152 ,2547 ,2605 
E02000853,2010,Sutton 014,Sutton,E09000029,5117 ,2473 ,2644 
E02000854,2010,Sutton 015,Sutton,E09000029,4690 ,2305 ,2385 
E02000855,2010,Sutton 016,Sutton,E09000029,5021 ,2478 ,2543 
E02000856,2010,Sutton 017,Sutton,E09000029,5571 ,2778 ,2793 
E02000857,2010,Sutton 018,Sutton,E09000029,5571 ,2849 ,2722 
E02000858,2010,Sutton 019,Sutton,E09000029,4931 ,2259 ,2672 
E02000859,2010,Sutton 020,Sutton,E09000029,5248 ,2530 ,2718 
E02000860,2010,Sutton 021,Sutton,E09000029,5267 ,2703 ,2564 
E02000861,2010,Sutton 022,Sutton,E09000029,4962 ,2417 ,2545 
E02000863,2010,Sutton 024,Sutton,E09000029,4101 ,1999 ,2102 
E02006836,2010,Sutton 025,Sutton,E09000029,5247 ,2580 ,2667 
E02000864,2010,Tower Hamlets 001,Tower Hamlets,E09000030,5697 ,2757 ,2940 
E02000865,2010,Tower Hamlets 002,Tower Hamlets,E09000030,4957 ,2434 ,2523 
E02000866,2010,Tower Hamlets 003,Tower Hamlets,E09000030,7179 ,3526 ,3653 
E02000867,2010,Tower Hamlets 004,Tower Hamlets,E09000030,7318 ,3708 ,3610 
E02000868,2010,Tower Hamlets 005,Tower Hamlets,E09000030,5071 ,2584 ,2487 
E02000869,2010,Tower Hamlets 006,Tower Hamlets,E09000030,4124 ,2141 ,1983 
E02000870,2010,Tower Hamlets 007,Tower Hamlets,E09000030,4581 ,2285 ,2296 
E02000871,2010,Tower Hamlets 008,Tower Hamlets,E09000030,5614 ,2960 ,2654 
E02000872,2010,Tower Hamlets 009,Tower Hamlets,E09000030,5574 ,2954 ,2620 
E02000873,2010,Tower Hamlets 010,Tower Hamlets,E09000030,6738 ,3315 ,3423 
E02000874,2010,Tower Hamlets 011,Tower Hamlets,E09000030,5229 ,2679 ,2550 
E02000875,2010,Tower Hamlets 012,Tower Hamlets,E09000030,6491 ,3308 ,3183 
E02000876,2010,Tower Hamlets 013,Tower Hamlets,E09000030,5242 ,2856 ,2386 
E02000877,2010,Tower Hamlets 014,Tower Hamlets,E09000030,6719 ,3467 ,3252 
E02000878,2010,Tower Hamlets 015,Tower Hamlets,E09000030,8200 ,4386 ,3814 
E02000879,2010,Tower Hamlets 016,Tower Hamlets,E09000030,5100 ,2612 ,2488 
E02000880,2010,Tower Hamlets 017,Tower Hamlets,E09000030,4139 ,2207 ,1932 
E02000881,2010,Tower Hamlets 018,Tower Hamlets,E09000030,4337 ,2199 ,2138 
E02000882,2010,Tower Hamlets 019,Tower Hamlets,E09000030,5705 ,2907 ,2798 
E02000883,2010,Tower Hamlets 020,Tower Hamlets,E09000030,5171 ,2598 ,2573 
E02000884,2010,Tower Hamlets 021,Tower Hamlets,E09000030,7278 ,4091 ,3187 
E02000885,2010,Tower Hamlets 022,Tower Hamlets,E09000030,4800 ,2500 ,2300 
E02000886,2010,Tower Hamlets 023,Tower Hamlets,E09000030,5683 ,3128 ,2555 
E02000887,2010,Tower Hamlets 024,Tower Hamlets,E09000030,5689 ,2838 ,2851 
E02000888,2010,Tower Hamlets 025,Tower Hamlets,E09000030,5936 ,3222 ,2714 
E02000889,2010,Tower Hamlets 026,Tower Hamlets,E09000030,5033 ,2796 ,2237 
E02000890,2010,Tower Hamlets 027,Tower Hamlets,E09000030,4740 ,2632 ,2108 
E02000891,2010,Tower Hamlets 028,Tower Hamlets,E09000030,9520 ,5103 ,4417 
E02000893,2010,Tower Hamlets 030,Tower Hamlets,E09000030,5034 ,2555 ,2479 
E02000894,2010,Tower Hamlets 031,Tower Hamlets,E09000030,7897 ,4157 ,3740 
E02006853,2010,Tower Hamlets 032,Tower Hamlets,E09000030,4906 ,2629 ,2277 
E02006854,2010,Tower Hamlets 033,Tower Hamlets,E09000030,4350 ,2470 ,1880 
E02000895,2010,Waltham Forest 001,Waltham Forest,E09000031,4775 ,2321 ,2454 
E02000896,2010,Waltham Forest 002,Waltham Forest,E09000031,5660 ,2830 ,2830 
E02000897,2010,Waltham Forest 003,Waltham Forest,E09000031,5077 ,2419 ,2658 
E02000898,2010,Waltham Forest 004,Waltham Forest,E09000031,5003 ,2432 ,2571 
E02000899,2010,Waltham Forest 005,Waltham Forest,E09000031,5216 ,2519 ,2697 
E02000900,2010,Waltham Forest 006,Waltham Forest,E09000031,5395 ,2569 ,2826 
E02000901,2010,Waltham Forest 007,Waltham Forest,E09000031,6237 ,2980 ,3257 
E02000902,2010,Waltham Forest 008,Waltham Forest,E09000031,5411 ,2656 ,2755 
E02000903,2010,Waltham Forest 009,Waltham Forest,E09000031,5905 ,2894 ,3011 
E02000904,2010,Waltham Forest 010,Waltham Forest,E09000031,5459 ,2693 ,2766 
E02000905,2010,Waltham Forest 011,Waltham Forest,E09000031,6469 ,3258 ,3211 
E02000906,2010,Waltham Forest 012,Waltham Forest,E09000031,6318 ,3155 ,3163 
E02000907,2010,Waltham Forest 013,Waltham Forest,E09000031,6388 ,3098 ,3290 
E02000908,2010,Waltham Forest 014,Waltham Forest,E09000031,7412 ,4050 ,3362 
E02000909,2010,Waltham Forest 015,Waltham Forest,E09000031,5921 ,2909 ,3012 
E02000910,2010,Waltham Forest 016,Waltham Forest,E09000031,7625 ,3915 ,3710 
E02000911,2010,Waltham Forest 017,Waltham Forest,E09000031,7627 ,3840 ,3787 
E02000912,2010,Waltham Forest 018,Waltham Forest,E09000031,6037 ,2974 ,3063 
E02000913,2010,Waltham Forest 019,Waltham Forest,E09000031,6047 ,3102 ,2945 
E02000914,2010,Waltham Forest 020,Waltham Forest,E09000031,7278 ,3729 ,3549 
E02000915,2010,Waltham Forest 021,Waltham Forest,E09000031,6613 ,3534 ,3079 
E02000916,2010,Waltham Forest 022,Waltham Forest,E09000031,6283 ,3136 ,3147 
E02000917,2010,Waltham Forest 023,Waltham Forest,E09000031,6235 ,3151 ,3084 
E02000918,2010,Waltham Forest 024,Waltham Forest,E09000031,6752 ,3528 ,3224 
E02000919,2010,Waltham Forest 025,Waltham Forest,E09000031,6712 ,3489 ,3223 
E02000920,2010,Waltham Forest 026,Waltham Forest,E09000031,6796 ,3379 ,3417 
E02000921,2010,Waltham Forest 027,Waltham Forest,E09000031,7693 ,3866 ,3827 
E02000922,2010,Waltham Forest 028,Waltham Forest,E09000031,7432 ,4057 ,3375 
E02000923,2010,Wandsworth 001,Wandsworth,E09000032,5355 ,2683 ,2672 
E02000924,2010,Wandsworth 002,Wandsworth,E09000032,8195 ,4010 ,4185 
E02000925,2010,Wandsworth 003,Wandsworth,E09000032,5329 ,2499 ,2830 
E02000926,2010,Wandsworth 004,Wandsworth,E09000032,6630 ,3349 ,3281 
E02000927,2010,Wandsworth 005,Wandsworth,E09000032,5317 ,2532 ,2785 
E02000928,2010,Wandsworth 006,Wandsworth,E09000032,6057 ,2874 ,3183 
E02000929,2010,Wandsworth 007,Wandsworth,E09000032,5023 ,2279 ,2744 
E02000930,2010,Wandsworth 008,Wandsworth,E09000032,8077 ,4005 ,4072 
E02000931,2010,Wandsworth 009,Wandsworth,E09000032,6837 ,3499 ,3338 
E02000932,2010,Wandsworth 010,Wandsworth,E09000032,8245 ,4069 ,4176 
E02000933,2010,Wandsworth 011,Wandsworth,E09000032,6389 ,3080 ,3309 
E02000934,2010,Wandsworth 012,Wandsworth,E09000032,7729 ,3908 ,3821 
E02000935,2010,Wandsworth 013,Wandsworth,E09000032,4745 ,2052 ,2693 
E02000936,2010,Wandsworth 014,Wandsworth,E09000032,6324 ,3033 ,3291 
E02000937,2010,Wandsworth 015,Wandsworth,E09000032,5841 ,2942 ,2899 
E02000938,2010,Wandsworth 016,Wandsworth,E09000032,6642 ,3167 ,3475 
E02000939,2010,Wandsworth 017,Wandsworth,E09000032,5396 ,2689 ,2707 
E02000940,2010,Wandsworth 018,Wandsworth,E09000032,5812 ,2810 ,3002 
E02000941,2010,Wandsworth 019,Wandsworth,E09000032,7825 ,4108 ,3717 
E02000942,2010,Wandsworth 020,Wandsworth,E09000032,6669 ,3196 ,3473 
E02000943,2010,Wandsworth 021,Wandsworth,E09000032,6569 ,3309 ,3260 
E02000944,2010,Wandsworth 022,Wandsworth,E09000032,5008 ,2353 ,2655 
E02000945,2010,Wandsworth 023,Wandsworth,E09000032,5638 ,2626 ,3012 
E02000946,2010,Wandsworth 024,Wandsworth,E09000032,6252 ,3314 ,2938 
E02000947,2010,Wandsworth 025,Wandsworth,E09000032,6416 ,3032 ,3384 
E02000948,2010,Wandsworth 026,Wandsworth,E09000032,7948 ,3931 ,4017 
E02000949,2010,Wandsworth 027,Wandsworth,E09000032,7219 ,3534 ,3685 
E02000950,2010,Wandsworth 028,Wandsworth,E09000032,5686 ,2763 ,2923 
E02000951,2010,Wandsworth 029,Wandsworth,E09000032,5106 ,2509 ,2597 
E02000952,2010,Wandsworth 030,Wandsworth,E09000032,4633 ,2283 ,2350 
E02000953,2010,Wandsworth 031,Wandsworth,E09000032,5209 ,2358 ,2851 
E02000954,2010,Wandsworth 032,Wandsworth,E09000032,4461 ,2105 ,2356 
E02000955,2010,Wandsworth 033,Wandsworth,E09000032,4599 ,2167 ,2432 
E02000956,2010,Wandsworth 034,Wandsworth,E09000032,5601 ,2648 ,2953 
E02000957,2010,Wandsworth 035,Wandsworth,E09000032,7506 ,3621 ,3885 
E02000958,2010,Wandsworth 036,Wandsworth,E09000032,5740 ,2755 ,2985 
E02000959,2010,Wandsworth 037,Wandsworth,E09000032,5292 ,2627 ,2665 
E02000960,2010,Westminster 001,Westminster,E09000033,4540 ,2193 ,2347 
E02000961,2010,Westminster 002,Westminster,E09000033,6263 ,2946 ,3317 
E02000962,2010,Westminster 003,Westminster,E09000033,6026 ,2983 ,3043 
E02000963,2010,Westminster 004,Westminster,E09000033,6593 ,3067 ,3526 
E02000964,2010,Westminster 005,Westminster,E09000033,8911 ,4247 ,4664 
E02000965,2010,Westminster 006,Westminster,E09000033,6866 ,3371 ,3495 
E02000966,2010,Westminster 007,Westminster,E09000033,7406 ,3654 ,3752 
E02000967,2010,Westminster 008,Westminster,E09000033,5904 ,3175 ,2729 
E02000968,2010,Westminster 009,Westminster,E09000033,9410 ,4525 ,4885 
E02000969,2010,Westminster 010,Westminster,E09000033,6279 ,3015 ,3264 
E02000970,2010,Westminster 011,Westminster,E09000033,7199 ,3865 ,3334 
E02000971,2010,Westminster 012,Westminster,E09000033,6777 ,3662 ,3115 
E02000972,2010,Westminster 013,Westminster,E09000033,6597 ,3810 ,2787 
E02000973,2010,Westminster 014,Westminster,E09000033,7663 ,3873 ,3790 
E02000974,2010,Westminster 015,Westminster,E09000033,6518 ,3632 ,2886 
E02000975,2010,Westminster 016,Westminster,E09000033,7325 ,3921 ,3404 
E02000976,2010,Westminster 017,Westminster,E09000033,8071 ,4186 ,3885 
E02000977,2010,Westminster 018,Westminster,E09000033,6058 ,3597 ,2461 
E02000978,2010,Westminster 019,Westminster,E09000033,7110 ,3751 ,3359 
E02000979,2010,Westminster 020,Westminster,E09000033,6070 ,3236 ,2834 
E02000980,2010,Westminster 021,Westminster,E09000033,6038 ,3081 ,2957 
E02000981,2010,Westminster 022,Westminster,E09000033,7192 ,3708 ,3484 
E02000982,2010,Westminster 023,Westminster,E09000033,5653 ,2841 ,2812 
E02000983,2010,Westminster 024,Westminster,E09000033,5970 ,2976 ,2994 
E02000001,2011,City of London 001,City of London,E09000001,5810 ,3339 ,2471 
E02000002,2011,Barking and Dagenham 001,Barking and Dagenham,E09000002,3992 ,1824 ,2168 
E02000003,2011,Barking and Dagenham 002,Barking and Dagenham,E09000002,6618 ,3222 ,3396 
E02000004,2011,Barking and Dagenham 003,Barking and Dagenham,E09000002,4044 ,1991 ,2053 
E02000005,2011,Barking and Dagenham 004,Barking and Dagenham,E09000002,5506 ,2631 ,2875 
E02000007,2011,Barking and Dagenham 006,Barking and Dagenham,E09000002,5453 ,2538 ,2915 
E02000008,2011,Barking and Dagenham 007,Barking and Dagenham,E09000002,7355 ,3438 ,3917 
E02000009,2011,Barking and Dagenham 008,Barking and Dagenham,E09000002,5617 ,2757 ,2860 
E02000010,2011,Barking and Dagenham 009,Barking and Dagenham,E09000002,5490 ,2577 ,2913 
E02000011,2011,Barking and Dagenham 010,Barking and Dagenham,E09000002,4008 ,2000 ,2008 
E02000012,2011,Barking and Dagenham 011,Barking and Dagenham,E09000002,6545 ,3264 ,3281 
E02000013,2011,Barking and Dagenham 012,Barking and Dagenham,E09000002,5249 ,2493 ,2756 
E02000014,2011,Barking and Dagenham 013,Barking and Dagenham,E09000002,6004 ,2811 ,3193 
E02000015,2011,Barking and Dagenham 014,Barking and Dagenham,E09000002,4922 ,2359 ,2563 
E02000016,2011,Barking and Dagenham 015,Barking and Dagenham,E09000002,5487 ,2935 ,2552 
E02000017,2011,Barking and Dagenham 016,Barking and Dagenham,E09000002,6038 ,3340 ,2698 
E02000018,2011,Barking and Dagenham 017,Barking and Dagenham,E09000002,5688 ,2707 ,2981 
E02000019,2011,Barking and Dagenham 018,Barking and Dagenham,E09000002,5365 ,2563 ,2802 
E02000020,2011,Barking and Dagenham 019,Barking and Dagenham,E09000002,5973 ,3017 ,2956 
E02000021,2011,Barking and Dagenham 020,Barking and Dagenham,E09000002,5086 ,2412 ,2674 
E02000022,2011,Barking and Dagenham 021,Barking and Dagenham,E09000002,5558 ,2752 ,2806 
E02000023,2011,Barking and Dagenham 022,Barking and Dagenham,E09000002,4102 ,1996 ,2106 
E02006799,2011,Barking and Dagenham 023,Barking and Dagenham,E09000002,6197 ,2954 ,3243 
E02000024,2011,Barnet 001,Barnet,E09000003,6626 ,3257 ,3369 
E02000025,2011,Barnet 002,Barnet,E09000003,5447 ,2621 ,2826 
E02000026,2011,Barnet 003,Barnet,E09000003,4129 ,1990 ,2139 
E02000027,2011,Barnet 004,Barnet,E09000003,6190 ,2909 ,3281 
E02000028,2011,Barnet 005,Barnet,E09000003,4106 ,2035 ,2071 
E02000029,2011,Barnet 006,Barnet,E09000003,5726 ,2780 ,2946 
E02000030,2011,Barnet 007,Barnet,E09000003,5707 ,2715 ,2992 
E02000031,2011,Barnet 008,Barnet,E09000003,4624 ,2272 ,2352 
E02000032,2011,Barnet 009,Barnet,E09000003,5092 ,2454 ,2638 
E02000033,2011,Barnet 010,Barnet,E09000003,5701 ,2788 ,2913 
E02000034,2011,Barnet 011,Barnet,E09000003,5648 ,2666 ,2982 
E02000035,2011,Barnet 012,Barnet,E09000003,5368 ,2603 ,2765 
E02000036,2011,Barnet 013,Barnet,E09000003,6953 ,3357 ,3596 
E02000037,2011,Barnet 014,Barnet,E09000003,6043 ,2856 ,3187 
E02000038,2011,Barnet 015,Barnet,E09000003,7312 ,3715 ,3597 
E02000039,2011,Barnet 016,Barnet,E09000003,4371 ,2131 ,2240 
E02000040,2011,Barnet 017,Barnet,E09000003,4562 ,2132 ,2430 
E02000041,2011,Barnet 018,Barnet,E09000003,5754 ,2836 ,2918 
E02000042,2011,Barnet 019,Barnet,E09000003,7434 ,3726 ,3708 
E02000043,2011,Barnet 020,Barnet,E09000003,5006 ,2440 ,2566 
E02000044,2011,Barnet 021,Barnet,E09000003,5418 ,2514 ,2904 
E02000045,2011,Barnet 022,Barnet,E09000003,7240 ,3513 ,3727 
E02000046,2011,Barnet 023,Barnet,E09000003,5132 ,2539 ,2593 
E02000047,2011,Barnet 024,Barnet,E09000003,7602 ,3643 ,3959 
E02000048,2011,Barnet 025,Barnet,E09000003,6431 ,3116 ,3315 
E02000049,2011,Barnet 026,Barnet,E09000003,5520 ,2529 ,2991 
E02000050,2011,Barnet 027,Barnet,E09000003,6900 ,3341 ,3559 
E02000051,2011,Barnet 028,Barnet,E09000003,5693 ,2832 ,2861 
E02000052,2011,Barnet 029,Barnet,E09000003,6980 ,3382 ,3598 
E02000053,2011,Barnet 030,Barnet,E09000003,6536 ,3361 ,3175 
E02000054,2011,Barnet 031,Barnet,E09000003,5205 ,2557 ,2648 
E02000055,2011,Barnet 032,Barnet,E09000003,7790 ,3943 ,3847 
E02000056,2011,Barnet 033,Barnet,E09000003,5768 ,2694 ,3074 
E02000057,2011,Barnet 034,Barnet,E09000003,4819 ,2385 ,2434 
E02000058,2011,Barnet 035,Barnet,E09000003,6481 ,3052 ,3429 
E02000059,2011,Barnet 036,Barnet,E09000003,7409 ,3783 ,3626 
E02000060,2011,Barnet 037,Barnet,E09000003,6492 ,3209 ,3283 
E02000061,2011,Barnet 038,Barnet,E09000003,5614 ,2794 ,2820 
E02000062,2011,Barnet 039,Barnet,E09000003,4448 ,2146 ,2302 
E02000063,2011,Barnet 040,Barnet,E09000003,4777 ,2362 ,2415 
E02000064,2011,Barnet 041,Barnet,E09000003,4312 ,2081 ,2231 
E02000065,2011,Bexley 001,Bexley,E09000004,5168 ,2499 ,2669 
E02000066,2011,Bexley 002,Bexley,E09000004,6421 ,3057 ,3364 
E02000067,2011,Bexley 003,Bexley,E09000004,5867 ,2836 ,3031 
E02000068,2011,Bexley 004,Bexley,E09000004,4945 ,2383 ,2562 
E02000069,2011,Bexley 005,Bexley,E09000004,3957 ,1933 ,2024 
E02000070,2011,Bexley 006,Bexley,E09000004,5055 ,2452 ,2603 
E02000071,2011,Bexley 007,Bexley,E09000004,4834 ,2325 ,2509 
E02000072,2011,Bexley 008,Bexley,E09000004,7486 ,3506 ,3980 
E02000073,2011,Bexley 009,Bexley,E09000004,6759 ,3303 ,3456 
E02000074,2011,Bexley 010,Bexley,E09000004,4901 ,2281 ,2620 
E02000075,2011,Bexley 011,Bexley,E09000004,5066 ,2479 ,2587 
E02000077,2011,Bexley 013,Bexley,E09000004,5061 ,2440 ,2621 
E02000078,2011,Bexley 014,Bexley,E09000004,5068 ,2459 ,2609 
E02000079,2011,Bexley 015,Bexley,E09000004,4984 ,2443 ,2541 
E02000080,2011,Bexley 016,Bexley,E09000004,6178 ,3052 ,3126 
E02000081,2011,Bexley 017,Bexley,E09000004,4727 ,2364 ,2363 
E02000082,2011,Bexley 018,Bexley,E09000004,5881 ,2937 ,2944 
E02000083,2011,Bexley 019,Bexley,E09000004,6338 ,3136 ,3202 
E02000084,2011,Bexley 020,Bexley,E09000004,6963 ,3449 ,3514 
E02000085,2011,Bexley 021,Bexley,E09000004,5165 ,2481 ,2684 
E02000086,2011,Bexley 022,Bexley,E09000004,4876 ,2404 ,2472 
E02000087,2011,Bexley 023,Bexley,E09000004,4644 ,2353 ,2291 
E02000088,2011,Bexley 024,Bexley,E09000004,4971 ,2440 ,2531 
E02000089,2011,Bexley 025,Bexley,E09000004,4857 ,2353 ,2504 
E02000090,2011,Bexley 026,Bexley,E09000004,5627 ,2707 ,2920 
E02000091,2011,Bexley 027,Bexley,E09000004,6095 ,2942 ,3153 
E02000092,2011,Bexley 028,Bexley,E09000004,4024 ,1873 ,2151 
E02006785,2011,Bexley 029,Bexley,E09000004,4074 ,1990 ,2084 
E02000093,2011,Brent 001,Brent,E09000005,7441 ,3739 ,3702 
E02000094,2011,Brent 002,Brent,E09000005,5977 ,3044 ,2933 
E02000095,2011,Brent 003,Brent,E09000005,6800 ,3473 ,3327 
E02000096,2011,Brent 004,Brent,E09000005,5109 ,2588 ,2521 
E02000097,2011,Brent 005,Brent,E09000005,6066 ,3142 ,2924 
E02000098,2011,Brent 006,Brent,E09000005,5433 ,2779 ,2654 
E02000099,2011,Brent 007,Brent,E09000005,5957 ,2984 ,2973 
E02000100,2011,Brent 008,Brent,E09000005,6055 ,2921 ,3134 
E02000101,2011,Brent 009,Brent,E09000005,6266 ,3154 ,3112 
E02000102,2011,Brent 010,Brent,E09000005,5063 ,2499 ,2564 
E02000103,2011,Brent 011,Brent,E09000005,5733 ,2867 ,2866 
E02000104,2011,Brent 012,Brent,E09000005,4596 ,2389 ,2207 
E02000105,2011,Brent 013,Brent,E09000005,6454 ,3433 ,3021 
E02000106,2011,Brent 014,Brent,E09000005,7060 ,3573 ,3487 
E02000107,2011,Brent 015,Brent,E09000005,8092 ,4209 ,3883 
E02000108,2011,Brent 016,Brent,E09000005,4517 ,2380 ,2137 
E02000109,2011,Brent 017,Brent,E09000005,7009 ,3755 ,3254 
E02000110,2011,Brent 018,Brent,E09000005,6086 ,3081 ,3005 
E02000111,2011,Brent 019,Brent,E09000005,6993 ,3720 ,3273 
E02000112,2011,Brent 020,Brent,E09000005,6880 ,3736 ,3144 
E02000113,2011,Brent 021,Brent,E09000005,6171 ,2896 ,3275 
E02000114,2011,Brent 022,Brent,E09000005,6842 ,3475 ,3367 
E02000115,2011,Brent 023,Brent,E09000005,6441 ,3350 ,3091 
E02000116,2011,Brent 024,Brent,E09000005,5780 ,2911 ,2869 
E02000117,2011,Brent 025,Brent,E09000005,7896 ,3833 ,4063 
E02000118,2011,Brent 026,Brent,E09000005,6750 ,3564 ,3186 
E02000119,2011,Brent 027,Brent,E09000005,4655 ,2240 ,2415 
E02000120,2011,Brent 028,Brent,E09000005,7173 ,3550 ,3623 
E02000121,2011,Brent 029,Brent,E09000005,6519 ,3395 ,3124 
E02000122,2011,Brent 030,Brent,E09000005,5580 ,2708 ,2872 
E02000123,2011,Brent 031,Brent,E09000005,10294 ,5217 ,5077 
E02000124,2011,Brent 032,Brent,E09000005,7706 ,3896 ,3810 
E02000125,2011,Brent 033,Brent,E09000005,7830 ,3857 ,3973 
E02000126,2011,Brent 034,Brent,E09000005,5323 ,2659 ,2664 
E02000127,2011,Bromley 001,Bromley,E09000006,5447 ,2491 ,2956 
E02000128,2011,Bromley 002,Bromley,E09000006,4768 ,2257 ,2511 
E02000130,2011,Bromley 004,Bromley,E09000006,5579 ,2675 ,2904 
E02000131,2011,Bromley 005,Bromley,E09000006,6909 ,3425 ,3484 
E02000132,2011,Bromley 006,Bromley,E09000006,6229 ,3106 ,3123 
E02000133,2011,Bromley 007,Bromley,E09000006,5883 ,2896 ,2987 
E02000134,2011,Bromley 008,Bromley,E09000006,7538 ,3706 ,3832 
E02000135,2011,Bromley 009,Bromley,E09000006,6840 ,3269 ,3571 
E02000136,2011,Bromley 010,Bromley,E09000006,3388 ,1633 ,1755 
E02000137,2011,Bromley 011,Bromley,E09000006,5141 ,2507 ,2634 
E02000138,2011,Bromley 012,Bromley,E09000006,5214 ,2609 ,2605 
E02000139,2011,Bromley 013,Bromley,E09000006,5188 ,2485 ,2703 
E02000140,2011,Bromley 014,Bromley,E09000006,5013 ,2313 ,2700 
E02000141,2011,Bromley 015,Bromley,E09000006,4880 ,2363 ,2517 
E02000142,2011,Bromley 016,Bromley,E09000006,5365 ,2635 ,2730 
E02000144,2011,Bromley 018,Bromley,E09000006,5926 ,2979 ,2947 
E02000145,2011,Bromley 019,Bromley,E09000006,5089 ,2310 ,2779 
E02000146,2011,Bromley 020,Bromley,E09000006,5413 ,2656 ,2757 
E02000147,2011,Bromley 021,Bromley,E09000006,4935 ,2430 ,2505 
E02000148,2011,Bromley 022,Bromley,E09000006,4035 ,1960 ,2075 
E02000149,2011,Bromley 023,Bromley,E09000006,4965 ,2332 ,2633 
E02000150,2011,Bromley 024,Bromley,E09000006,5374 ,2592 ,2782 
E02000151,2011,Bromley 025,Bromley,E09000006,4618 ,2221 ,2397 
E02000152,2011,Bromley 026,Bromley,E09000006,4168 ,1986 ,2182 
E02000153,2011,Bromley 027,Bromley,E09000006,4904 ,2377 ,2527 
E02000154,2011,Bromley 028,Bromley,E09000006,5194 ,2583 ,2611 
E02000155,2011,Bromley 029,Bromley,E09000006,4223 ,2055 ,2168 
E02000156,2011,Bromley 030,Bromley,E09000006,7421 ,3636 ,3785 
E02000157,2011,Bromley 031,Bromley,E09000006,4749 ,2354 ,2395 
E02000158,2011,Bromley 032,Bromley,E09000006,4353 ,2088 ,2265 
E02000159,2011,Bromley 033,Bromley,E09000006,4194 ,2026 ,2168 
E02000160,2011,Bromley 034,Bromley,E09000006,5019 ,2472 ,2547 
E02000161,2011,Bromley 035,Bromley,E09000006,5304 ,2597 ,2707 
E02000162,2011,Bromley 036,Bromley,E09000006,3947 ,1837 ,2110 
E02000163,2011,Bromley 037,Bromley,E09000006,4778 ,2347 ,2431 
E02000165,2011,Bromley 039,Bromley,E09000006,4792 ,2348 ,2444 
E02006782,2011,Bromley 040,Bromley,E09000006,4843 ,2282 ,2561 
E02006787,2011,Bromley 041,Bromley,E09000006,4995 ,2377 ,2618 
E02006789,2011,Bromley 042,Bromley,E09000006,3967 ,1897 ,2070 
E02000166,2011,Camden 001,Camden,E09000007,5362 ,2475 ,2887 
E02000167,2011,Camden 002,Camden,E09000007,5250 ,2614 ,2636 
E02000168,2011,Camden 003,Camden,E09000007,5895 ,2816 ,3079 
E02000169,2011,Camden 004,Camden,E09000007,5073 ,2462 ,2611 
E02000170,2011,Camden 005,Camden,E09000007,6312 ,3186 ,3126 
E02000171,2011,Camden 006,Camden,E09000007,5535 ,2691 ,2844 
E02000172,2011,Camden 007,Camden,E09000007,7127 ,3442 ,3685 
E02000173,2011,Camden 008,Camden,E09000007,5483 ,2723 ,2760 
E02000174,2011,Camden 009,Camden,E09000007,6475 ,3081 ,3394 
E02000175,2011,Camden 010,Camden,E09000007,7032 ,3389 ,3643 
E02000176,2011,Camden 011,Camden,E09000007,4720 ,2304 ,2416 
E02000177,2011,Camden 012,Camden,E09000007,6233 ,2948 ,3285 
E02000178,2011,Camden 013,Camden,E09000007,6885 ,3495 ,3390 
E02000179,2011,Camden 014,Camden,E09000007,4295 ,2026 ,2269 
E02000180,2011,Camden 015,Camden,E09000007,6233 ,3115 ,3118 
E02000181,2011,Camden 016,Camden,E09000007,5973 ,2868 ,3105 
E02000182,2011,Camden 017,Camden,E09000007,4570 ,2087 ,2483 
E02000183,2011,Camden 018,Camden,E09000007,5622 ,2777 ,2845 
E02000184,2011,Camden 019,Camden,E09000007,6716 ,3311 ,3405 
E02000185,2011,Camden 020,Camden,E09000007,5731 ,2722 ,3009 
E02000186,2011,Camden 021,Camden,E09000007,5255 ,2750 ,2505 
E02000187,2011,Camden 022,Camden,E09000007,5597 ,2667 ,2930 
E02000188,2011,Camden 023,Camden,E09000007,6142 ,3212 ,2930 
E02000189,2011,Camden 024,Camden,E09000007,4387 ,2180 ,2207 
E02000190,2011,Camden 025,Camden,E09000007,6032 ,3012 ,3020 
E02000191,2011,Camden 026,Camden,E09000007,6513 ,3533 ,2980 
E02000192,2011,Camden 027,Camden,E09000007,5330 ,2890 ,2440 
E02000193,2011,Camden 028,Camden,E09000007,6325 ,3406 ,2919 
E02000194,2011,Croydon 001,Croydon,E09000008,6154 ,3053 ,3101 
E02000195,2011,Croydon 002,Croydon,E09000008,6181 ,3025 ,3156 
E02000196,2011,Croydon 003,Croydon,E09000008,5071 ,2491 ,2580 
E02000197,2011,Croydon 004,Croydon,E09000008,5974 ,2851 ,3123 
E02000198,2011,Croydon 005,Croydon,E09000008,5389 ,2545 ,2844 
E02000199,2011,Croydon 006,Croydon,E09000008,5676 ,2643 ,3033 
E02000200,2011,Croydon 007,Croydon,E09000008,5837 ,2827 ,3010 
E02000201,2011,Croydon 008,Croydon,E09000008,5671 ,2697 ,2974 
E02000202,2011,Croydon 009,Croydon,E09000008,5767 ,2872 ,2895 
E02000203,2011,Croydon 010,Croydon,E09000008,5157 ,2494 ,2663 
E02000204,2011,Croydon 011,Croydon,E09000008,6217 ,2959 ,3258 
E02000206,2011,Croydon 013,Croydon,E09000008,6326 ,3055 ,3271 
E02000207,2011,Croydon 014,Croydon,E09000008,6077 ,2889 ,3188 
E02000208,2011,Croydon 015,Croydon,E09000008,6651 ,3210 ,3441 
E02000209,2011,Croydon 016,Croydon,E09000008,5583 ,2694 ,2889 
E02000210,2011,Croydon 017,Croydon,E09000008,5862 ,2822 ,3040 
E02000211,2011,Croydon 018,Croydon,E09000008,5228 ,2547 ,2681 
E02000212,2011,Croydon 019,Croydon,E09000008,5703 ,2804 ,2899 
E02000213,2011,Croydon 020,Croydon,E09000008,6763 ,3482 ,3281 
E02000214,2011,Croydon 021,Croydon,E09000008,4226 ,2123 ,2103 
E02000215,2011,Croydon 022,Croydon,E09000008,7739 ,4105 ,3634 
E02000216,2011,Croydon 023,Croydon,E09000008,4382 ,2253 ,2129 
E02000217,2011,Croydon 024,Croydon,E09000008,6973 ,3508 ,3465 
E02000218,2011,Croydon 025,Croydon,E09000008,4194 ,1898 ,2296 
E02000219,2011,Croydon 026,Croydon,E09000008,4912 ,2375 ,2537 
E02000220,2011,Croydon 027,Croydon,E09000008,7490 ,3971 ,3519 
E02000221,2011,Croydon 028,Croydon,E09000008,6476 ,3051 ,3425 
E02000222,2011,Croydon 029,Croydon,E09000008,5640 ,2841 ,2799 
E02000223,2011,Croydon 030,Croydon,E09000008,4914 ,2092 ,2822 
E02000224,2011,Croydon 031,Croydon,E09000008,5399 ,2686 ,2713 
E02000225,2011,Croydon 032,Croydon,E09000008,4807 ,2228 ,2579 
E02000226,2011,Croydon 033,Croydon,E09000008,4973 ,2468 ,2505 
E02000227,2011,Croydon 034,Croydon,E09000008,7626 ,3624 ,4002 
E02000228,2011,Croydon 035,Croydon,E09000008,4747 ,2314 ,2433 
E02000229,2011,Croydon 036,Croydon,E09000008,3876 ,1778 ,2098 
E02000230,2011,Croydon 037,Croydon,E09000008,6725 ,3362 ,3363 
E02000231,2011,Croydon 038,Croydon,E09000008,5030 ,2505 ,2525 
E02000232,2011,Croydon 039,Croydon,E09000008,3893 ,1868 ,2025 
E02000233,2011,Croydon 040,Croydon,E09000008,3929 ,1876 ,2053 
E02000234,2011,Croydon 041,Croydon,E09000008,5328 ,2608 ,2720 
E02000235,2011,Croydon 042,Croydon,E09000008,4539 ,2195 ,2344 
E02000236,2011,Croydon 043,Croydon,E09000008,5007 ,2430 ,2577 
E02000237,2011,Croydon 044,Croydon,E09000008,4558 ,2184 ,2374 
E02006788,2011,Croydon 045,Croydon,E09000008,5031 ,2221 ,2810 
E02000238,2011,Ealing 001,Ealing,E09000009,6554 ,3393 ,3161 
E02000239,2011,Ealing 002,Ealing,E09000009,6255 ,3246 ,3009 
E02000240,2011,Ealing 003,Ealing,E09000009,6695 ,3177 ,3518 
E02000241,2011,Ealing 004,Ealing,E09000009,4615 ,2359 ,2256 
E02000242,2011,Ealing 005,Ealing,E09000009,4711 ,2490 ,2221 
E02000243,2011,Ealing 006,Ealing,E09000009,5834 ,2964 ,2870 
E02000244,2011,Ealing 007,Ealing,E09000009,5004 ,2591 ,2413 
E02000245,2011,Ealing 008,Ealing,E09000009,5392 ,2556 ,2836 
E02000246,2011,Ealing 009,Ealing,E09000009,5625 ,2737 ,2888 
E02000247,2011,Ealing 010,Ealing,E09000009,6693 ,3210 ,3483 
E02000248,2011,Ealing 011,Ealing,E09000009,5210 ,2618 ,2592 
E02000249,2011,Ealing 012,Ealing,E09000009,5207 ,2633 ,2574 
E02000250,2011,Ealing 013,Ealing,E09000009,4245 ,2053 ,2192 
E02000251,2011,Ealing 014,Ealing,E09000009,5532 ,2833 ,2699 
E02000252,2011,Ealing 015,Ealing,E09000009,7230 ,3894 ,3336 
E02000253,2011,Ealing 016,Ealing,E09000009,6237 ,2950 ,3287 
E02000254,2011,Ealing 017,Ealing,E09000009,6236 ,3219 ,3017 
E02000255,2011,Ealing 018,Ealing,E09000009,6404 ,3071 ,3333 
E02000256,2011,Ealing 019,Ealing,E09000009,6442 ,3286 ,3156 
E02000257,2011,Ealing 020,Ealing,E09000009,10009 ,5027 ,4982 
E02000258,2011,Ealing 021,Ealing,E09000009,4761 ,2459 ,2302 
E02000259,2011,Ealing 022,Ealing,E09000009,4359 ,2114 ,2245 
E02000260,2011,Ealing 023,Ealing,E09000009,6013 ,3181 ,2832 
E02000261,2011,Ealing 024,Ealing,E09000009,7682 ,3790 ,3892 
E02000262,2011,Ealing 025,Ealing,E09000009,6500 ,3314 ,3186 
E02000263,2011,Ealing 026,Ealing,E09000009,8049 ,4397 ,3652 
E02000264,2011,Ealing 027,Ealing,E09000009,5893 ,2991 ,2902 
E02000265,2011,Ealing 028,Ealing,E09000009,8059 ,4047 ,4012 
E02000266,2011,Ealing 029,Ealing,E09000009,8412 ,4229 ,4183 
E02000267,2011,Ealing 030,Ealing,E09000009,4962 ,2437 ,2525 
E02000268,2011,Ealing 031,Ealing,E09000009,6815 ,3410 ,3405 
E02000269,2011,Ealing 032,Ealing,E09000009,5795 ,2862 ,2933 
E02000270,2011,Ealing 033,Ealing,E09000009,5424 ,2607 ,2817 
E02000271,2011,Ealing 034,Ealing,E09000009,4826 ,2385 ,2441 
E02000272,2011,Ealing 035,Ealing,E09000009,4585 ,2263 ,2322 
E02000274,2011,Ealing 037,Ealing,E09000009,8929 ,4898 ,4031 
E02000275,2011,Ealing 038,Ealing,E09000009,4911 ,2567 ,2344 
E02000276,2011,Ealing 039,Ealing,E09000009,4862 ,2499 ,2363 
E02006791,2011,Ealing 040,Ealing,E09000009,5048 ,2474 ,2574 
E02000277,2011,Enfield 001,Enfield,E09000010,4649 ,2197 ,2452 
E02000278,2011,Enfield 002,Enfield,E09000010,5502 ,2533 ,2969 
E02000279,2011,Enfield 003,Enfield,E09000010,7496 ,3469 ,4027 
E02000280,2011,Enfield 004,Enfield,E09000010,5552 ,2621 ,2931 
E02000281,2011,Enfield 005,Enfield,E09000010,5806 ,2741 ,3065 
E02000282,2011,Enfield 006,Enfield,E09000010,5827 ,2679 ,3148 
E02000283,2011,Enfield 007,Enfield,E09000010,5474 ,2578 ,2896 
E02000284,2011,Enfield 008,Enfield,E09000010,5519 ,2669 ,2850 
E02000285,2011,Enfield 009,Enfield,E09000010,4279 ,2072 ,2207 
E02000286,2011,Enfield 010,Enfield,E09000010,5522 ,2812 ,2710 
E02000287,2011,Enfield 011,Enfield,E09000010,4381 ,2130 ,2251 
E02000288,2011,Enfield 012,Enfield,E09000010,6933 ,3300 ,3633 
E02000289,2011,Enfield 013,Enfield,E09000010,4123 ,1982 ,2141 
E02000290,2011,Enfield 014,Enfield,E09000010,4676 ,2190 ,2486 
E02000291,2011,Enfield 015,Enfield,E09000010,5983 ,2980 ,3003 
E02000292,2011,Enfield 016,Enfield,E09000010,6340 ,3043 ,3297 
E02000293,2011,Enfield 017,Enfield,E09000010,3955 ,1995 ,1960 
E02000294,2011,Enfield 018,Enfield,E09000010,5782 ,2748 ,3034 
E02000295,2011,Enfield 019,Enfield,E09000010,5508 ,2635 ,2873 
E02000296,2011,Enfield 020,Enfield,E09000010,6607 ,3160 ,3447 
E02000297,2011,Enfield 021,Enfield,E09000010,6193 ,3062 ,3131 
E02000298,2011,Enfield 022,Enfield,E09000010,5266 ,2640 ,2626 
E02000299,2011,Enfield 023,Enfield,E09000010,5961 ,2841 ,3120 
E02000300,2011,Enfield 024,Enfield,E09000010,5401 ,2578 ,2823 
E02000301,2011,Enfield 025,Enfield,E09000010,6572 ,3047 ,3525 
E02000302,2011,Enfield 026,Enfield,E09000010,5520 ,2678 ,2842 
E02000303,2011,Enfield 027,Enfield,E09000010,5422 ,2544 ,2878 
E02000304,2011,Enfield 028,Enfield,E09000010,5374 ,2620 ,2754 
E02000305,2011,Enfield 029,Enfield,E09000010,6237 ,3161 ,3076 
E02000306,2011,Enfield 030,Enfield,E09000010,5875 ,2680 ,3195 
E02000307,2011,Enfield 031,Enfield,E09000010,6508 ,3096 ,3412 
E02000308,2011,Enfield 032,Enfield,E09000010,5421 ,2771 ,2650 
E02000309,2011,Enfield 033,Enfield,E09000010,6886 ,3358 ,3528 
E02000311,2011,Enfield 035,Enfield,E09000010,6819 ,3276 ,3543 
E02000312,2011,Enfield 036,Enfield,E09000010,7789 ,4014 ,3775 
E02006793,2011,Enfield 037,Enfield,E09000010,5877 ,2685 ,3192 
E02000313,2011,Greenwich 001,Greenwich,E09000011,4424 ,2199 ,2225 
E02000314,2011,Greenwich 002,Greenwich,E09000011,8873 ,4633 ,4240 
E02000315,2011,Greenwich 003,Greenwich,E09000011,5693 ,2692 ,3001 
E02000316,2011,Greenwich 004,Greenwich,E09000011,8067 ,4211 ,3856 
E02000317,2011,Greenwich 005,Greenwich,E09000011,5504 ,2716 ,2788 
E02000318,2011,Greenwich 006,Greenwich,E09000011,6913 ,3590 ,3323 
E02000319,2011,Greenwich 007,Greenwich,E09000011,7935 ,4228 ,3707 
E02000320,2011,Greenwich 008,Greenwich,E09000011,4416 ,2132 ,2284 
E02000321,2011,Greenwich 009,Greenwich,E09000011,4942 ,2465 ,2477 
E02000323,2011,Greenwich 011,Greenwich,E09000011,7307 ,3724 ,3583 
E02000324,2011,Greenwich 012,Greenwich,E09000011,4810 ,2380 ,2430 
E02000326,2011,Greenwich 014,Greenwich,E09000011,5001 ,2428 ,2573 
E02000327,2011,Greenwich 015,Greenwich,E09000011,4725 ,2542 ,2183 
E02000328,2011,Greenwich 016,Greenwich,E09000011,4587 ,2282 ,2305 
E02000329,2011,Greenwich 017,Greenwich,E09000011,4182 ,2120 ,2062 
E02000331,2011,Greenwich 019,Greenwich,E09000011,5421 ,2632 ,2789 
E02000332,2011,Greenwich 020,Greenwich,E09000011,4926 ,2469 ,2457 
E02000333,2011,Greenwich 021,Greenwich,E09000011,4387 ,2226 ,2161 
E02000334,2011,Greenwich 022,Greenwich,E09000011,4394 ,2183 ,2211 
E02000335,2011,Greenwich 023,Greenwich,E09000011,4337 ,2151 ,2186 
E02000337,2011,Greenwich 025,Greenwich,E09000011,5369 ,2627 ,2742 
E02000339,2011,Greenwich 027,Greenwich,E09000011,3906 ,1933 ,1973 
E02000340,2011,Greenwich 028,Greenwich,E09000011,4017 ,2039 ,1978 
E02000341,2011,Greenwich 029,Greenwich,E09000011,4981 ,2302 ,2679 
E02000342,2011,Greenwich 030,Greenwich,E09000011,4634 ,2128 ,2506 
E02000343,2011,Greenwich 031,Greenwich,E09000011,4365 ,2187 ,2178 
E02000344,2011,Greenwich 032,Greenwich,E09000011,4201 ,2103 ,2098 
E02006786,2011,Greenwich 033,Greenwich,E09000011,4612 ,2301 ,2311 
E02006927,2011,Greenwich 034,Greenwich,E09000011,5341 ,2633 ,2708 
E02006928,2011,Greenwich 035,Greenwich,E09000011,5895 ,2899 ,2996 
E02006929,2011,Greenwich 036,Greenwich,E09000011,5541 ,2765 ,2776 
E02006930,2011,Greenwich 037,Greenwich,E09000011,5089 ,2613 ,2476 
E02006931,2011,Greenwich 038,Greenwich,E09000011,6653 ,3346 ,3307 
E02000345,2011,Hackney 001,Hackney,E09000012,5191 ,2589 ,2602 
E02000346,2011,Hackney 002,Hackney,E09000012,4366 ,2184 ,2182 
E02000347,2011,Hackney 003,Hackney,E09000012,4961 ,2475 ,2486 
E02000348,2011,Hackney 004,Hackney,E09000012,4930 ,2406 ,2524 
E02000350,2011,Hackney 006,Hackney,E09000012,7092 ,3513 ,3579 
E02000351,2011,Hackney 007,Hackney,E09000012,7016 ,3549 ,3467 
E02000352,2011,Hackney 008,Hackney,E09000012,4721 ,2229 ,2492 
E02000353,2011,Hackney 009,Hackney,E09000012,6006 ,2921 ,3085 
E02000354,2011,Hackney 010,Hackney,E09000012,6949 ,3499 ,3450 
E02000355,2011,Hackney 011,Hackney,E09000012,6364 ,3182 ,3182 
E02000356,2011,Hackney 012,Hackney,E09000012,5660 ,2781 ,2879 
E02000357,2011,Hackney 013,Hackney,E09000012,3974 ,1836 ,2138 
E02000358,2011,Hackney 014,Hackney,E09000012,8533 ,4234 ,4299 
E02000359,2011,Hackney 015,Hackney,E09000012,4719 ,2238 ,2481 
E02000360,2011,Hackney 016,Hackney,E09000012,8172 ,3944 ,4228 
E02000361,2011,Hackney 017,Hackney,E09000012,5992 ,2975 ,3017 
E02000362,2011,Hackney 018,Hackney,E09000012,4504 ,2240 ,2264 
E02000363,2011,Hackney 019,Hackney,E09000012,7269 ,3510 ,3759 
E02000364,2011,Hackney 020,Hackney,E09000012,6851 ,3413 ,3438 
E02000365,2011,Hackney 021,Hackney,E09000012,10201 ,5189 ,5012 
E02000366,2011,Hackney 022,Hackney,E09000012,6077 ,2971 ,3106 
E02000367,2011,Hackney 023,Hackney,E09000012,7631 ,3663 ,3968 
E02000368,2011,Hackney 024,Hackney,E09000012,6979 ,3440 ,3539 
E02000369,2011,Hackney 025,Hackney,E09000012,8740 ,4505 ,4235 
E02000370,2011,Hackney 026,Hackney,E09000012,6359 ,3280 ,3079 
E02000371,2011,Hackney 027,Hackney,E09000012,10386 ,5572 ,4814 
E02006918,2011,Hackney 028,Hackney,E09000012,5188 ,2526 ,2662 
E02006921,2011,Hackney 029,Hackney,E09000012,4887 ,2352 ,2535 
E02000372,2011,Hammersmith and Fulham 001,Hammersmith and Fulham,E09000013,6544 ,3122 ,3422 
E02000373,2011,Hammersmith and Fulham 002,Hammersmith and Fulham,E09000013,4435 ,2033 ,2402 
E02000374,2011,Hammersmith and Fulham 003,Hammersmith and Fulham,E09000013,4814 ,2302 ,2512 
E02000375,2011,Hammersmith and Fulham 004,Hammersmith and Fulham,E09000013,5319 ,2624 ,2695 
E02000376,2011,Hammersmith and Fulham 005,Hammersmith and Fulham,E09000013,5517 ,2828 ,2689 
E02000377,2011,Hammersmith and Fulham 006,Hammersmith and Fulham,E09000013,6183 ,3133 ,3050 
E02000378,2011,Hammersmith and Fulham 007,Hammersmith and Fulham,E09000013,5196 ,2555 ,2641 
E02000379,2011,Hammersmith and Fulham 008,Hammersmith and Fulham,E09000013,5421 ,2744 ,2677 
E02000380,2011,Hammersmith and Fulham 009,Hammersmith and Fulham,E09000013,4355 ,2261 ,2094 
E02000381,2011,Hammersmith and Fulham 010,Hammersmith and Fulham,E09000013,5837 ,2797 ,3040 
E02000382,2011,Hammersmith and Fulham 011,Hammersmith and Fulham,E09000013,4538 ,2304 ,2234 
E02000383,2011,Hammersmith and Fulham 012,Hammersmith and Fulham,E09000013,7547 ,3758 ,3789 
E02000384,2011,Hammersmith and Fulham 013,Hammersmith and Fulham,E09000013,5460 ,2731 ,2729 
E02000385,2011,Hammersmith and Fulham 014,Hammersmith and Fulham,E09000013,5289 ,2715 ,2574 
E02000386,2011,Hammersmith and Fulham 015,Hammersmith and Fulham,E09000013,6147 ,3093 ,3054 
E02000387,2011,Hammersmith and Fulham 016,Hammersmith and Fulham,E09000013,4939 ,2444 ,2495 
E02000388,2011,Hammersmith and Fulham 017,Hammersmith and Fulham,E09000013,6419 ,3138 ,3281 
E02000389,2011,Hammersmith and Fulham 018,Hammersmith and Fulham,E09000013,6143 ,2988 ,3155 
E02000390,2011,Hammersmith and Fulham 019,Hammersmith and Fulham,E09000013,4998 ,2436 ,2562 
E02000391,2011,Hammersmith and Fulham 020,Hammersmith and Fulham,E09000013,5638 ,2760 ,2878 
E02000392,2011,Hammersmith and Fulham 021,Hammersmith and Fulham,E09000013,7204 ,3376 ,3828 
E02000393,2011,Hammersmith and Fulham 022,Hammersmith and Fulham,E09000013,4639 ,2213 ,2426 
E02000394,2011,Hammersmith and Fulham 023,Hammersmith and Fulham,E09000013,5854 ,2771 ,3083 
E02000395,2011,Hammersmith and Fulham 024,Hammersmith and Fulham,E09000013,4295 ,2094 ,2201 
E02000396,2011,Hammersmith and Fulham 025,Hammersmith and Fulham,E09000013,4695 ,2251 ,2444 
E02000397,2011,Haringey 001,Haringey,E09000014,5816 ,2933 ,2883 
E02000398,2011,Haringey 002,Haringey,E09000014,4720 ,2390 ,2330 
E02000400,2011,Haringey 004,Haringey,E09000014,5349 ,2610 ,2739 
E02000401,2011,Haringey 005,Haringey,E09000014,4352 ,2015 ,2337 
E02000402,2011,Haringey 006,Haringey,E09000014,4392 ,1989 ,2403 
E02000403,2011,Haringey 007,Haringey,E09000014,5471 ,2794 ,2677 
E02000404,2011,Haringey 008,Haringey,E09000014,5152 ,2534 ,2618 
E02000405,2011,Haringey 009,Haringey,E09000014,4564 ,2233 ,2331 
E02000406,2011,Haringey 010,Haringey,E09000014,5071 ,2443 ,2628 
E02000407,2011,Haringey 011,Haringey,E09000014,5014 ,2480 ,2534 
E02000408,2011,Haringey 012,Haringey,E09000014,5157 ,2520 ,2637 
E02000409,2011,Haringey 013,Haringey,E09000014,4499 ,2208 ,2291 
E02000410,2011,Haringey 014,Haringey,E09000014,4838 ,2357 ,2481 
E02000411,2011,Haringey 015,Haringey,E09000014,5320 ,2687 ,2633 
E02000412,2011,Haringey 016,Haringey,E09000014,5163 ,2579 ,2584 
E02000413,2011,Haringey 017,Haringey,E09000014,4894 ,2307 ,2587 
E02000414,2011,Haringey 018,Haringey,E09000014,5120 ,2629 ,2491 
E02000415,2011,Haringey 019,Haringey,E09000014,5090 ,2663 ,2427 
E02000416,2011,Haringey 020,Haringey,E09000014,5514 ,2731 ,2783 
E02000417,2011,Haringey 021,Haringey,E09000014,4802 ,2299 ,2503 
E02000418,2011,Haringey 022,Haringey,E09000014,3833 ,1826 ,2007 
E02000419,2011,Haringey 023,Haringey,E09000014,6332 ,3302 ,3030 
E02000420,2011,Haringey 024,Haringey,E09000014,5372 ,2686 ,2686 
E02000421,2011,Haringey 025,Haringey,E09000014,5157 ,2527 ,2630 
E02000422,2011,Haringey 026,Haringey,E09000014,5558 ,2916 ,2642 
E02000423,2011,Haringey 027,Haringey,E09000014,5299 ,2850 ,2449 
E02000424,2011,Haringey 028,Haringey,E09000014,5447 ,2709 ,2738 
E02000425,2011,Haringey 029,Haringey,E09000014,4249 ,2086 ,2163 
E02000426,2011,Haringey 030,Haringey,E09000014,4647 ,2268 ,2379 
E02000427,2011,Haringey 031,Haringey,E09000014,5465 ,2864 ,2601 
E02000428,2011,Haringey 032,Haringey,E09000014,5014 ,2516 ,2498 
E02000429,2011,Haringey 033,Haringey,E09000014,5034 ,2565 ,2469 
E02000430,2011,Haringey 034,Haringey,E09000014,5854 ,2967 ,2887 
E02000431,2011,Haringey 035,Haringey,E09000014,5186 ,2662 ,2524 
E02000432,2011,Haringey 036,Haringey,E09000014,5106 ,2558 ,2548 
E02006794,2011,Haringey 037,Haringey,E09000014,4776 ,2286 ,2490 
E02000433,2011,Harrow 001,Harrow,E09000015,4528 ,2182 ,2346 
E02000434,2011,Harrow 002,Harrow,E09000015,5575 ,2744 ,2831 
E02000435,2011,Harrow 003,Harrow,E09000015,4739 ,2284 ,2455 
E02000436,2011,Harrow 004,Harrow,E09000015,3603 ,1734 ,1869 
E02000437,2011,Harrow 005,Harrow,E09000015,5411 ,2603 ,2808 
E02000438,2011,Harrow 006,Harrow,E09000015,5039 ,2393 ,2646 
E02000439,2011,Harrow 007,Harrow,E09000015,5696 ,2845 ,2851 
E02000440,2011,Harrow 008,Harrow,E09000015,6413 ,3144 ,3269 
E02000441,2011,Harrow 009,Harrow,E09000015,4325 ,2059 ,2266 
E02000442,2011,Harrow 010,Harrow,E09000015,6082 ,3079 ,3003 
E02000443,2011,Harrow 011,Harrow,E09000015,6352 ,3155 ,3197 
E02000444,2011,Harrow 012,Harrow,E09000015,5747 ,2855 ,2892 
E02000445,2011,Harrow 013,Harrow,E09000015,7068 ,3581 ,3487 
E02000447,2011,Harrow 015,Harrow,E09000015,4753 ,2326 ,2427 
E02000448,2011,Harrow 016,Harrow,E09000015,4102 ,1980 ,2122 
E02000449,2011,Harrow 017,Harrow,E09000015,5740 ,2948 ,2792 
E02000451,2011,Harrow 019,Harrow,E09000015,4363 ,2185 ,2178 
E02000452,2011,Harrow 020,Harrow,E09000015,6111 ,3211 ,2900 
E02000453,2011,Harrow 021,Harrow,E09000015,5330 ,2635 ,2695 
E02000454,2011,Harrow 022,Harrow,E09000015,4512 ,2205 ,2307 
E02000455,2011,Harrow 023,Harrow,E09000015,5947 ,3026 ,2921 
E02000456,2011,Harrow 024,Harrow,E09000015,4867 ,2408 ,2459 
E02000457,2011,Harrow 025,Harrow,E09000015,4085 ,2051 ,2034 
E02000459,2011,Harrow 027,Harrow,E09000015,5584 ,2812 ,2772 
E02000460,2011,Harrow 028,Harrow,E09000015,4343 ,2128 ,2215 
E02000461,2011,Harrow 029,Harrow,E09000015,4875 ,2716 ,2159 
E02000462,2011,Harrow 030,Harrow,E09000015,4424 ,2257 ,2167 
E02000463,2011,Harrow 031,Harrow,E09000015,5672 ,2780 ,2892 
E02006795,2011,Harrow 032,Harrow,E09000015,5476 ,2754 ,2722 
E02006882,2011,Harrow 033,Harrow,E09000015,9809 ,4846 ,4963 
E02000464,2011,Havering 001,Havering,E09000016,3973 ,1924 ,2049 
E02000465,2011,Havering 002,Havering,E09000016,5209 ,2532 ,2677 
E02000466,2011,Havering 003,Havering,E09000016,5280 ,2487 ,2793 
E02000467,2011,Havering 004,Havering,E09000016,6325 ,3023 ,3302 
E02000468,2011,Havering 005,Havering,E09000016,4943 ,2351 ,2592 
E02000469,2011,Havering 006,Havering,E09000016,4087 ,1957 ,2130 
E02000470,2011,Havering 007,Havering,E09000016,5135 ,2562 ,2573 
E02000471,2011,Havering 008,Havering,E09000016,4674 ,2294 ,2380 
E02000472,2011,Havering 009,Havering,E09000016,5822 ,2844 ,2978 
E02000473,2011,Havering 010,Havering,E09000016,6230 ,3066 ,3164 
E02000474,2011,Havering 011,Havering,E09000016,5364 ,2597 ,2767 
E02000475,2011,Havering 012,Havering,E09000016,6095 ,2998 ,3097 
E02000476,2011,Havering 013,Havering,E09000016,5831 ,2908 ,2923 
E02000477,2011,Havering 014,Havering,E09000016,6127 ,3028 ,3099 
E02000478,2011,Havering 015,Havering,E09000016,3750 ,1894 ,1856 
E02000479,2011,Havering 016,Havering,E09000016,5752 ,2824 ,2928 
E02000480,2011,Havering 017,Havering,E09000016,6544 ,3208 ,3336 
E02000481,2011,Havering 018,Havering,E09000016,4621 ,2219 ,2402 
E02000482,2011,Havering 019,Havering,E09000016,3850 ,1937 ,1913 
E02000483,2011,Havering 020,Havering,E09000016,4838 ,2399 ,2439 
E02000484,2011,Havering 021,Havering,E09000016,5620 ,2826 ,2794 
E02000485,2011,Havering 022,Havering,E09000016,5138 ,2523 ,2615 
E02000486,2011,Havering 023,Havering,E09000016,4807 ,2377 ,2430 
E02000487,2011,Havering 024,Havering,E09000016,4852 ,2426 ,2426 
E02000488,2011,Havering 025,Havering,E09000016,4902 ,2430 ,2472 
E02000489,2011,Havering 026,Havering,E09000016,5120 ,2506 ,2614 
E02000490,2011,Havering 027,Havering,E09000016,4829 ,2348 ,2481 
E02000491,2011,Havering 028,Havering,E09000016,5592 ,2818 ,2774 
E02000492,2011,Havering 029,Havering,E09000016,3952 ,1999 ,1953 
E02000493,2011,Havering 030,Havering,E09000016,4125 ,1936 ,2189 
E02000494,2011,Hillingdon 001,Hillingdon,E09000017,4751 ,2244 ,2507 
E02000495,2011,Hillingdon 002,Hillingdon,E09000017,6232 ,2999 ,3233 
E02000496,2011,Hillingdon 003,Hillingdon,E09000017,4785 ,2332 ,2453 
E02000497,2011,Hillingdon 004,Hillingdon,E09000017,5511 ,2684 ,2827 
E02000498,2011,Hillingdon 005,Hillingdon,E09000017,3878 ,1875 ,2003 
E02000499,2011,Hillingdon 006,Hillingdon,E09000017,4866 ,2396 ,2470 
E02000500,2011,Hillingdon 007,Hillingdon,E09000017,5021 ,2528 ,2493 
E02000501,2011,Hillingdon 008,Hillingdon,E09000017,5364 ,2586 ,2778 
E02000502,2011,Hillingdon 009,Hillingdon,E09000017,4980 ,2460 ,2520 
E02000503,2011,Hillingdon 010,Hillingdon,E09000017,6250 ,3208 ,3042 
E02000504,2011,Hillingdon 011,Hillingdon,E09000017,4550 ,2245 ,2305 
E02000506,2011,Hillingdon 013,Hillingdon,E09000017,4934 ,2447 ,2487 
E02000507,2011,Hillingdon 014,Hillingdon,E09000017,5273 ,2653 ,2620 
E02000508,2011,Hillingdon 015,Hillingdon,E09000017,7220 ,3958 ,3262 
E02000509,2011,Hillingdon 016,Hillingdon,E09000017,7864 ,3934 ,3930 
E02000510,2011,Hillingdon 017,Hillingdon,E09000017,5818 ,2904 ,2914 
E02000511,2011,Hillingdon 018,Hillingdon,E09000017,6270 ,3149 ,3121 
E02000512,2011,Hillingdon 019,Hillingdon,E09000017,5372 ,2696 ,2676 
E02000513,2011,Hillingdon 020,Hillingdon,E09000017,5845 ,2785 ,3060 
E02000514,2011,Hillingdon 021,Hillingdon,E09000017,6636 ,3403 ,3233 
E02000515,2011,Hillingdon 022,Hillingdon,E09000017,7543 ,3865 ,3678 
E02000516,2011,Hillingdon 023,Hillingdon,E09000017,5677 ,2812 ,2865 
E02000517,2011,Hillingdon 024,Hillingdon,E09000017,5690 ,2746 ,2944 
E02000518,2011,Hillingdon 025,Hillingdon,E09000017,5750 ,2864 ,2886 
E02000519,2011,Hillingdon 026,Hillingdon,E09000017,5821 ,2963 ,2858 
E02000520,2011,Hillingdon 027,Hillingdon,E09000017,7717 ,3959 ,3758 
E02000521,2011,Hillingdon 028,Hillingdon,E09000017,6647 ,3306 ,3341 
E02000522,2011,Hillingdon 029,Hillingdon,E09000017,5624 ,2708 ,2916 
E02000523,2011,Hillingdon 030,Hillingdon,E09000017,6546 ,3308 ,3238 
E02000524,2011,Hillingdon 031,Hillingdon,E09000017,4814 ,2674 ,2140 
E02000525,2011,Hillingdon 032,Hillingdon,E09000017,6077 ,3057 ,3020 
E02006796,2011,Hillingdon 033,Hillingdon,E09000017,5710 ,2801 ,2909 
E02000526,2011,Hounslow 001,Hounslow,E09000018,6020 ,2943 ,3077 
E02000528,2011,Hounslow 003,Hounslow,E09000018,7567 ,3725 ,3842 
E02000529,2011,Hounslow 004,Hounslow,E09000018,5847 ,2994 ,2853 
E02000530,2011,Hounslow 005,Hounslow,E09000018,4525 ,2234 ,2291 
E02000531,2011,Hounslow 006,Hounslow,E09000018,7809 ,3863 ,3946 
E02000532,2011,Hounslow 007,Hounslow,E09000018,6379 ,3158 ,3221 
E02000533,2011,Hounslow 008,Hounslow,E09000018,5921 ,2963 ,2958 
E02000534,2011,Hounslow 009,Hounslow,E09000018,5668 ,2940 ,2728 
E02000535,2011,Hounslow 010,Hounslow,E09000018,6453 ,3352 ,3101 
E02000536,2011,Hounslow 011,Hounslow,E09000018,6456 ,3330 ,3126 
E02000537,2011,Hounslow 012,Hounslow,E09000018,6184 ,3298 ,2886 
E02000538,2011,Hounslow 013,Hounslow,E09000018,6136 ,3225 ,2911 
E02000539,2011,Hounslow 014,Hounslow,E09000018,7562 ,3685 ,3877 
E02000540,2011,Hounslow 015,Hounslow,E09000018,6574 ,3579 ,2995 
E02000541,2011,Hounslow 016,Hounslow,E09000018,6244 ,3260 ,2984 
E02000542,2011,Hounslow 017,Hounslow,E09000018,6642 ,3520 ,3122 
E02000543,2011,Hounslow 018,Hounslow,E09000018,8606 ,4590 ,4016 
E02000544,2011,Hounslow 019,Hounslow,E09000018,5698 ,2864 ,2834 
E02000545,2011,Hounslow 020,Hounslow,E09000018,5679 ,2721 ,2958 
E02000546,2011,Hounslow 021,Hounslow,E09000018,6834 ,3574 ,3260 
E02000547,2011,Hounslow 022,Hounslow,E09000018,6306 ,3167 ,3139 
E02000548,2011,Hounslow 023,Hounslow,E09000018,6145 ,3027 ,3118 
E02000549,2011,Hounslow 024,Hounslow,E09000018,7442 ,3788 ,3654 
E02000550,2011,Hounslow 025,Hounslow,E09000018,7161 ,3511 ,3650 
E02000551,2011,Hounslow 026,Hounslow,E09000018,5665 ,2761 ,2904 
E02000552,2011,Hounslow 027,Hounslow,E09000018,5797 ,2994 ,2803 
E02000553,2011,Hounslow 028,Hounslow,E09000018,4387 ,2142 ,2245 
E02006792,2011,Hounslow 029,Hounslow,E09000018,6235 ,3196 ,3039 
E02000554,2011,Islington 001,Islington,E09000019,6642 ,3127 ,3515 
E02000555,2011,Islington 002,Islington,E09000019,6827 ,3237 ,3590 
E02000556,2011,Islington 003,Islington,E09000019,7694 ,3803 ,3891 
E02000557,2011,Islington 004,Islington,E09000019,5926 ,2882 ,3044 
E02000558,2011,Islington 005,Islington,E09000019,6034 ,2985 ,3049 
E02000559,2011,Islington 006,Islington,E09000019,6865 ,3531 ,3334 
E02000560,2011,Islington 007,Islington,E09000019,5771 ,2969 ,2802 
E02000561,2011,Islington 008,Islington,E09000019,5879 ,2832 ,3047 
E02000562,2011,Islington 009,Islington,E09000019,5748 ,2757 ,2991 
E02000563,2011,Islington 010,Islington,E09000019,6322 ,3009 ,3313 
E02000564,2011,Islington 011,Islington,E09000019,8516 ,4258 ,4258 
E02000565,2011,Islington 012,Islington,E09000019,5979 ,2793 ,3186 
E02000566,2011,Islington 013,Islington,E09000019,6300 ,3091 ,3209 
E02000567,2011,Islington 014,Islington,E09000019,7909 ,3766 ,4143 
E02000568,2011,Islington 015,Islington,E09000019,7287 ,3858 ,3429 
E02000569,2011,Islington 016,Islington,E09000019,7311 ,3443 ,3868 
E02000570,2011,Islington 017,Islington,E09000019,6807 ,3385 ,3422 
E02000571,2011,Islington 018,Islington,E09000019,5925 ,2977 ,2948 
E02000572,2011,Islington 019,Islington,E09000019,6160 ,2939 ,3221 
E02000573,2011,Islington 020,Islington,E09000019,6869 ,3505 ,3364 
E02000574,2011,Islington 021,Islington,E09000019,6867 ,3446 ,3421 
E02000575,2011,Islington 022,Islington,E09000019,9888 ,5198 ,4690 
E02000576,2011,Islington 023,Islington,E09000019,7061 ,3717 ,3344 
E02000577,2011,Kensington and Chelsea 001,Kensington and Chelsea,E09000020,4991 ,2397 ,2594 
E02000578,2011,Kensington and Chelsea 002,Kensington and Chelsea,E09000020,3930 ,1823 ,2107 
E02000579,2011,Kensington and Chelsea 003,Kensington and Chelsea,E09000020,6151 ,2892 ,3259 
E02000580,2011,Kensington and Chelsea 004,Kensington and Chelsea,E09000020,6669 ,3284 ,3385 
E02000581,2011,Kensington and Chelsea 005,Kensington and Chelsea,E09000020,4871 ,2241 ,2630 
E02000582,2011,Kensington and Chelsea 006,Kensington and Chelsea,E09000020,5743 ,2860 ,2883 
E02000583,2011,Kensington and Chelsea 007,Kensington and Chelsea,E09000020,5275 ,2478 ,2797 
E02000584,2011,Kensington and Chelsea 008,Kensington and Chelsea,E09000020,5898 ,2836 ,3062 
E02000585,2011,Kensington and Chelsea 009,Kensington and Chelsea,E09000020,5975 ,2900 ,3075 
E02000586,2011,Kensington and Chelsea 010,Kensington and Chelsea,E09000020,5794 ,2919 ,2875 
E02000587,2011,Kensington and Chelsea 011,Kensington and Chelsea,E09000020,5386 ,2717 ,2669 
E02000588,2011,Kensington and Chelsea 012,Kensington and Chelsea,E09000020,6123 ,3169 ,2954 
E02000589,2011,Kensington and Chelsea 013,Kensington and Chelsea,E09000020,6742 ,3710 ,3032 
E02000590,2011,Kensington and Chelsea 014,Kensington and Chelsea,E09000020,5067 ,2424 ,2643 
E02000591,2011,Kensington and Chelsea 015,Kensington and Chelsea,E09000020,5310 ,2802 ,2508 
E02000592,2011,Kensington and Chelsea 016,Kensington and Chelsea,E09000020,5099 ,2570 ,2529 
E02000593,2011,Kensington and Chelsea 017,Kensington and Chelsea,E09000020,5850 ,3095 ,2755 
E02000594,2011,Kensington and Chelsea 018,Kensington and Chelsea,E09000020,4901 ,2405 ,2496 
E02000595,2011,Kensington and Chelsea 019,Kensington and Chelsea,E09000020,5161 ,2487 ,2674 
E02000596,2011,Kensington and Chelsea 020,Kensington and Chelsea,E09000020,5926 ,2968 ,2958 
E02000597,2011,Kensington and Chelsea 021,Kensington and Chelsea,E09000020,5062 ,2361 ,2701 
E02000598,2011,Kingston upon Thames 001,Kingston upon Thames,E09000021,4978 ,2364 ,2614 
E02000599,2011,Kingston upon Thames 002,Kingston upon Thames,E09000021,4807 ,2326 ,2481 
E02000600,2011,Kingston upon Thames 003,Kingston upon Thames,E09000021,5762 ,2781 ,2981 
E02000601,2011,Kingston upon Thames 004,Kingston upon Thames,E09000021,7297 ,3636 ,3661 
E02000602,2011,Kingston upon Thames 005,Kingston upon Thames,E09000021,6976 ,3466 ,3510 
E02000603,2011,Kingston upon Thames 006,Kingston upon Thames,E09000021,5413 ,2590 ,2823 
E02000604,2011,Kingston upon Thames 007,Kingston upon Thames,E09000021,5795 ,2852 ,2943 
E02000605,2011,Kingston upon Thames 008,Kingston upon Thames,E09000021,5246 ,2558 ,2688 
E02000606,2011,Kingston upon Thames 009,Kingston upon Thames,E09000021,8098 ,4224 ,3874 
E02000607,2011,Kingston upon Thames 010,Kingston upon Thames,E09000021,4994 ,2438 ,2556 
E02000608,2011,Kingston upon Thames 011,Kingston upon Thames,E09000021,5677 ,2887 ,2790 
E02000609,2011,Kingston upon Thames 012,Kingston upon Thames,E09000021,4709 ,2308 ,2401 
E02000610,2011,Kingston upon Thames 013,Kingston upon Thames,E09000021,5591 ,2888 ,2703 
E02000611,2011,Kingston upon Thames 014,Kingston upon Thames,E09000021,4655 ,2316 ,2339 
E02000612,2011,Kingston upon Thames 015,Kingston upon Thames,E09000021,5281 ,2579 ,2702 
E02000613,2011,Kingston upon Thames 016,Kingston upon Thames,E09000021,5293 ,2550 ,2743 
E02000614,2011,Kingston upon Thames 017,Kingston upon Thames,E09000021,5698 ,2821 ,2877 
E02000615,2011,Kingston upon Thames 018,Kingston upon Thames,E09000021,4944 ,2436 ,2508 
E02000616,2011,Kingston upon Thames 019,Kingston upon Thames,E09000021,4063 ,2016 ,2047 
E02000617,2011,Kingston upon Thames 020,Kingston upon Thames,E09000021,5595 ,2703 ,2892 
E02000619,2011,Lambeth 002,Lambeth,E09000022,5900 ,3022 ,2878 
E02000620,2011,Lambeth 003,Lambeth,E09000022,7139 ,3823 ,3316 
E02000621,2011,Lambeth 004,Lambeth,E09000022,8447 ,4668 ,3779 
E02000622,2011,Lambeth 005,Lambeth,E09000022,6440 ,3475 ,2965 
E02000623,2011,Lambeth 006,Lambeth,E09000022,5821 ,2979 ,2842 
E02000624,2011,Lambeth 007,Lambeth,E09000022,6087 ,3119 ,2968 
E02000625,2011,Lambeth 008,Lambeth,E09000022,6197 ,3179 ,3018 
E02000626,2011,Lambeth 009,Lambeth,E09000022,5842 ,2891 ,2951 
E02000627,2011,Lambeth 010,Lambeth,E09000022,7487 ,3803 ,3684 
E02000628,2011,Lambeth 011,Lambeth,E09000022,7086 ,3578 ,3508 
E02000629,2011,Lambeth 012,Lambeth,E09000022,7390 ,3766 ,3624 
E02000630,2011,Lambeth 013,Lambeth,E09000022,5811 ,2933 ,2878 
E02000631,2011,Lambeth 014,Lambeth,E09000022,6557 ,3195 ,3362 
E02000632,2011,Lambeth 015,Lambeth,E09000022,8259 ,4212 ,4047 
E02000633,2011,Lambeth 016,Lambeth,E09000022,6573 ,3268 ,3305 
E02000634,2011,Lambeth 017,Lambeth,E09000022,5313 ,2633 ,2680 
E02000635,2011,Lambeth 018,Lambeth,E09000022,7156 ,3595 ,3561 
E02000636,2011,Lambeth 019,Lambeth,E09000022,5932 ,2954 ,2978 
E02000637,2011,Lambeth 020,Lambeth,E09000022,6956 ,3572 ,3384 
E02000638,2011,Lambeth 021,Lambeth,E09000022,7484 ,3800 ,3684 
E02000639,2011,Lambeth 022,Lambeth,E09000022,5815 ,2794 ,3021 
E02000640,2011,Lambeth 023,Lambeth,E09000022,6868 ,3281 ,3587 
E02000641,2011,Lambeth 024,Lambeth,E09000022,6027 ,2808 ,3219 
E02000642,2011,Lambeth 025,Lambeth,E09000022,6740 ,3272 ,3468 
E02000643,2011,Lambeth 026,Lambeth,E09000022,6169 ,2988 ,3181 
E02000644,2011,Lambeth 027,Lambeth,E09000022,6237 ,3100 ,3137 
E02000645,2011,Lambeth 028,Lambeth,E09000022,6513 ,3197 ,3316 
E02000646,2011,Lambeth 029,Lambeth,E09000022,7021 ,3557 ,3464 
E02000647,2011,Lambeth 030,Lambeth,E09000022,5904 ,2934 ,2970 
E02000648,2011,Lambeth 031,Lambeth,E09000022,5030 ,2211 ,2819 
E02000649,2011,Lambeth 032,Lambeth,E09000022,8507 ,4215 ,4292 
E02000650,2011,Lambeth 033,Lambeth,E09000022,5283 ,2467 ,2816 
E02000651,2011,Lambeth 034,Lambeth,E09000022,6185 ,3075 ,3110 
E02000652,2011,Lambeth 035,Lambeth,E09000022,4972 ,2477 ,2495 
E02006801,2011,Lambeth 036,Lambeth,E09000022,6681 ,3550 ,3131 
E02000653,2011,Lewisham 001,Lewisham,E09000023,6347 ,3272 ,3075 
E02000654,2011,Lewisham 002,Lewisham,E09000023,5585 ,2684 ,2901 
E02000655,2011,Lewisham 003,Lewisham,E09000023,6123 ,3051 ,3072 
E02000657,2011,Lewisham 005,Lewisham,E09000023,7176 ,3591 ,3585 
E02000658,2011,Lewisham 006,Lewisham,E09000023,6280 ,3312 ,2968 
E02000659,2011,Lewisham 007,Lewisham,E09000023,5492 ,2699 ,2793 
E02000660,2011,Lewisham 008,Lewisham,E09000023,6456 ,3236 ,3220 
E02000661,2011,Lewisham 009,Lewisham,E09000023,4590 ,2346 ,2244 
E02000662,2011,Lewisham 010,Lewisham,E09000023,5955 ,2867 ,3088 
E02000663,2011,Lewisham 011,Lewisham,E09000023,5525 ,2972 ,2553 
E02000664,2011,Lewisham 012,Lewisham,E09000023,7291 ,3756 ,3535 
E02000665,2011,Lewisham 013,Lewisham,E09000023,5660 ,2857 ,2803 
E02000666,2011,Lewisham 014,Lewisham,E09000023,5192 ,2466 ,2726 
E02000667,2011,Lewisham 015,Lewisham,E09000023,4676 ,2266 ,2410 
E02000668,2011,Lewisham 016,Lewisham,E09000023,4614 ,2276 ,2338 
E02000669,2011,Lewisham 017,Lewisham,E09000023,5674 ,2861 ,2813 
E02000670,2011,Lewisham 018,Lewisham,E09000023,4470 ,2103 ,2367 
E02000671,2011,Lewisham 019,Lewisham,E09000023,6098 ,2982 ,3116 
E02000672,2011,Lewisham 020,Lewisham,E09000023,5907 ,3077 ,2830 
E02000673,2011,Lewisham 021,Lewisham,E09000023,5710 ,2889 ,2821 
E02000674,2011,Lewisham 022,Lewisham,E09000023,5429 ,2517 ,2912 
E02000675,2011,Lewisham 023,Lewisham,E09000023,5645 ,2670 ,2975 
E02000676,2011,Lewisham 024,Lewisham,E09000023,5510 ,2698 ,2812 
E02000677,2011,Lewisham 025,Lewisham,E09000023,4914 ,2412 ,2502 
E02000678,2011,Lewisham 026,Lewisham,E09000023,3880 ,1795 ,2085 
E02000679,2011,Lewisham 027,Lewisham,E09000023,5505 ,2713 ,2792 
E02000680,2011,Lewisham 028,Lewisham,E09000023,4648 ,2329 ,2319 
E02000681,2011,Lewisham 029,Lewisham,E09000023,5318 ,2475 ,2843 
E02000682,2011,Lewisham 030,Lewisham,E09000023,5191 ,2457 ,2734 
E02000683,2011,Lewisham 031,Lewisham,E09000023,4216 ,1953 ,2263 
E02000685,2011,Lewisham 033,Lewisham,E09000023,5172 ,2467 ,2705 
E02000686,2011,Lewisham 034,Lewisham,E09000023,4354 ,1980 ,2374 
E02000687,2011,Lewisham 035,Lewisham,E09000023,5565 ,2869 ,2696 
E02006783,2011,Lewisham 037,Lewisham,E09000023,4533 ,2029 ,2504 
E02006784,2011,Lewisham 038,Lewisham,E09000023,4710 ,2186 ,2524 
E02006798,2011,Lewisham 039,Lewisham,E09000023,5656 ,2812 ,2844 
E02000689,2011,Merton 001,Merton,E09000024,5868 ,2862 ,3006 
E02000690,2011,Merton 002,Merton,E09000024,3403 ,1680 ,1723 
E02000691,2011,Merton 003,Merton,E09000024,5519 ,2772 ,2747 
E02000692,2011,Merton 004,Merton,E09000024,5491 ,2770 ,2721 
E02000693,2011,Merton 005,Merton,E09000024,7444 ,3886 ,3558 
E02000694,2011,Merton 006,Merton,E09000024,6535 ,3194 ,3341 
E02000695,2011,Merton 007,Merton,E09000024,5860 ,3144 ,2716 
E02000696,2011,Merton 008,Merton,E09000024,6127 ,3104 ,3023 
E02000697,2011,Merton 009,Merton,E09000024,6435 ,3256 ,3179 
E02000698,2011,Merton 010,Merton,E09000024,5027 ,2441 ,2586 
E02000699,2011,Merton 011,Merton,E09000024,5586 ,2728 ,2858 
E02000700,2011,Merton 012,Merton,E09000024,6140 ,2955 ,3185 
E02000701,2011,Merton 013,Merton,E09000024,5785 ,2880 ,2905 
E02000702,2011,Merton 014,Merton,E09000024,5211 ,2528 ,2683 
E02000703,2011,Merton 015,Merton,E09000024,5132 ,2599 ,2533 
E02000704,2011,Merton 016,Merton,E09000024,5600 ,2790 ,2810 
E02000705,2011,Merton 017,Merton,E09000024,5538 ,2708 ,2830 
E02000706,2011,Merton 018,Merton,E09000024,5766 ,2745 ,3021 
E02000707,2011,Merton 019,Merton,E09000024,4933 ,2332 ,2601 
E02000708,2011,Merton 020,Merton,E09000024,5575 ,2756 ,2819 
E02000709,2011,Merton 021,Merton,E09000024,5079 ,2553 ,2526 
E02000710,2011,Merton 022,Merton,E09000024,5446 ,2697 ,2749 
E02000711,2011,Merton 023,Merton,E09000024,5576 ,2815 ,2761 
E02000712,2011,Merton 024,Merton,E09000024,5714 ,2834 ,2880 
E02000713,2011,Merton 025,Merton,E09000024,4979 ,2500 ,2479 
E02000714,2011,Newham 001,Newham,E09000025,5824 ,3071 ,2753 
E02000715,2011,Newham 002,Newham,E09000025,4931 ,2661 ,2270 
E02000716,2011,Newham 003,Newham,E09000025,5196 ,2863 ,2333 
E02000717,2011,Newham 004,Newham,E09000025,5687 ,3127 ,2560 
E02000718,2011,Newham 005,Newham,E09000025,4342 ,2168 ,2174 
E02000719,2011,Newham 006,Newham,E09000025,6173 ,3248 ,2925 
E02000720,2011,Newham 007,Newham,E09000025,5465 ,3055 ,2410 
E02000721,2011,Newham 008,Newham,E09000025,7029 ,3980 ,3049 
E02000722,2011,Newham 009,Newham,E09000025,6364 ,3366 ,2998 
E02000723,2011,Newham 010,Newham,E09000025,7728 ,4385 ,3343 
E02000724,2011,Newham 011,Newham,E09000025,6654 ,3795 ,2859 
E02000725,2011,Newham 012,Newham,E09000025,7152 ,3704 ,3448 
E02000726,2011,Newham 013,Newham,E09000025,7119 ,3872 ,3247 
E02000727,2011,Newham 014,Newham,E09000025,6168 ,3673 ,2495 
E02000728,2011,Newham 015,Newham,E09000025,5865 ,3294 ,2571 
E02000729,2011,Newham 016,Newham,E09000025,5168 ,2762 ,2406 
E02000730,2011,Newham 017,Newham,E09000025,6631 ,3807 ,2824 
E02000731,2011,Newham 018,Newham,E09000025,7355 ,4404 ,2951 
E02000732,2011,Newham 019,Newham,E09000025,5193 ,2890 ,2303 
E02000733,2011,Newham 020,Newham,E09000025,6953 ,3588 ,3365 
E02000734,2011,Newham 021,Newham,E09000025,5339 ,2781 ,2558 
E02000735,2011,Newham 022,Newham,E09000025,5359 ,2972 ,2387 
E02000736,2011,Newham 023,Newham,E09000025,5688 ,2967 ,2721 
E02000737,2011,Newham 024,Newham,E09000025,6274 ,3218 ,3056 
E02000738,2011,Newham 025,Newham,E09000025,5841 ,3116 ,2725 
E02000739,2011,Newham 026,Newham,E09000025,4953 ,2556 ,2397 
E02000740,2011,Newham 027,Newham,E09000025,4928 ,2475 ,2453 
E02000741,2011,Newham 028,Newham,E09000025,5654 ,2895 ,2759 
E02000742,2011,Newham 029,Newham,E09000025,5239 ,2646 ,2593 
E02000743,2011,Newham 030,Newham,E09000025,5399 ,2742 ,2657 
E02000744,2011,Newham 031,Newham,E09000025,5516 ,2761 ,2755 
E02000745,2011,Newham 032,Newham,E09000025,5866 ,2848 ,3018 
E02000746,2011,Newham 033,Newham,E09000025,5587 ,2640 ,2947 
E02000747,2011,Newham 034,Newham,E09000025,8121 ,4304 ,3817 
E02000748,2011,Newham 035,Newham,E09000025,4526 ,2178 ,2348 
E02000749,2011,Newham 036,Newham,E09000025,5524 ,2650 ,2874 
E02000750,2011,Newham 037,Newham,E09000025,8108 ,4273 ,3835 
E02000751,2011,Redbridge 001,Redbridge,E09000026,6607 ,3265 ,3342 
E02000752,2011,Redbridge 002,Redbridge,E09000026,4352 ,2068 ,2284 
E02000753,2011,Redbridge 003,Redbridge,E09000026,3910 ,1825 ,2085 
E02000754,2011,Redbridge 004,Redbridge,E09000026,4393 ,2148 ,2245 
E02000755,2011,Redbridge 005,Redbridge,E09000026,3509 ,1706 ,1803 
E02000756,2011,Redbridge 006,Redbridge,E09000026,8505 ,4123 ,4382 
E02000757,2011,Redbridge 007,Redbridge,E09000026,8196 ,4097 ,4099 
E02000758,2011,Redbridge 008,Redbridge,E09000026,3841 ,1880 ,1961 
E02000759,2011,Redbridge 009,Redbridge,E09000026,8204 ,4002 ,4202 
E02000760,2011,Redbridge 010,Redbridge,E09000026,4419 ,2143 ,2276 
E02000762,2011,Redbridge 012,Redbridge,E09000026,4202 ,2130 ,2072 
E02000763,2011,Redbridge 013,Redbridge,E09000026,4569 ,2220 ,2349 
E02000764,2011,Redbridge 014,Redbridge,E09000026,8101 ,3970 ,4131 
E02000765,2011,Redbridge 015,Redbridge,E09000026,4146 ,2080 ,2066 
E02000767,2011,Redbridge 017,Redbridge,E09000026,5033 ,2483 ,2550 
E02000768,2011,Redbridge 018,Redbridge,E09000026,3787 ,1839 ,1948 
E02000769,2011,Redbridge 019,Redbridge,E09000026,9457 ,4559 ,4898 
E02000770,2011,Redbridge 020,Redbridge,E09000026,4978 ,2513 ,2465 
E02000772,2011,Redbridge 022,Redbridge,E09000026,5356 ,2761 ,2595 
E02000773,2011,Redbridge 023,Redbridge,E09000026,6256 ,3087 ,3169 
E02000774,2011,Redbridge 024,Redbridge,E09000026,4976 ,2624 ,2352 
E02000776,2011,Redbridge 026,Redbridge,E09000026,4322 ,2182 ,2140 
E02000777,2011,Redbridge 027,Redbridge,E09000026,3944 ,1887 ,2057 
E02000779,2011,Redbridge 029,Redbridge,E09000026,5391 ,2865 ,2526 
E02000780,2011,Redbridge 030,Redbridge,E09000026,9891 ,5156 ,4735 
E02000781,2011,Redbridge 031,Redbridge,E09000026,8962 ,4554 ,4408 
E02000782,2011,Redbridge 032,Redbridge,E09000026,6175 ,3191 ,2984 
E02000783,2011,Redbridge 033,Redbridge,E09000026,4564 ,2329 ,2235 
E02006800,2011,Redbridge 034,Redbridge,E09000026,9072 ,4683 ,4389 
E02006924,2011,Redbridge 035,Redbridge,E09000026,8688 ,4571 ,4117 
E02006925,2011,Redbridge 036,Redbridge,E09000026,8617 ,4216 ,4401 
E02000784,2011,Richmond upon Thames 001,Richmond upon Thames,E09000027,6815 ,3312 ,3503 
E02000785,2011,Richmond upon Thames 002,Richmond upon Thames,E09000027,6535 ,3247 ,3288 
E02000786,2011,Richmond upon Thames 003,Richmond upon Thames,E09000027,7552 ,3647 ,3905 
E02000787,2011,Richmond upon Thames 004,Richmond upon Thames,E09000027,7450 ,3677 ,3773 
E02000788,2011,Richmond upon Thames 005,Richmond upon Thames,E09000027,5807 ,2815 ,2992 
E02000789,2011,Richmond upon Thames 006,Richmond upon Thames,E09000027,4284 ,2130 ,2154 
E02000790,2011,Richmond upon Thames 007,Richmond upon Thames,E09000027,4261 ,2115 ,2146 
E02000791,2011,Richmond upon Thames 008,Richmond upon Thames,E09000027,4450 ,2288 ,2162 
E02000792,2011,Richmond upon Thames 009,Richmond upon Thames,E09000027,4788 ,2403 ,2385 
E02000793,2011,Richmond upon Thames 010,Richmond upon Thames,E09000027,5385 ,2677 ,2708 
E02000794,2011,Richmond upon Thames 011,Richmond upon Thames,E09000027,4542 ,2276 ,2266 
E02000795,2011,Richmond upon Thames 012,Richmond upon Thames,E09000027,4137 ,2105 ,2032 
E02000796,2011,Richmond upon Thames 013,Richmond upon Thames,E09000027,6824 ,3409 ,3415 
E02000797,2011,Richmond upon Thames 014,Richmond upon Thames,E09000027,5264 ,2676 ,2588 
E02000798,2011,Richmond upon Thames 015,Richmond upon Thames,E09000027,7088 ,3446 ,3642 
E02000799,2011,Richmond upon Thames 016,Richmond upon Thames,E09000027,4594 ,2233 ,2361 
E02000800,2011,Richmond upon Thames 017,Richmond upon Thames,E09000027,3370 ,1666 ,1704 
E02000801,2011,Richmond upon Thames 018,Richmond upon Thames,E09000027,4614 ,2218 ,2396 
E02000802,2011,Richmond upon Thames 019,Richmond upon Thames,E09000027,4435 ,2191 ,2244 
E02000803,2011,Richmond upon Thames 020,Richmond upon Thames,E09000027,6201 ,2953 ,3248 
E02000804,2011,Richmond upon Thames 021,Richmond upon Thames,E09000027,4808 ,2322 ,2486 
E02000805,2011,Richmond upon Thames 022,Richmond upon Thames,E09000027,6864 ,3369 ,3495 
E02000806,2011,Richmond upon Thames 023,Richmond upon Thames,E09000027,6589 ,3174 ,3415 
E02000807,2011,Southwark 001,Southwark,E09000028,6953 ,3593 ,3360 
E02000808,2011,Southwark 002,Southwark,E09000028,7618 ,4000 ,3618 
E02000809,2011,Southwark 003,Southwark,E09000028,10292 ,5732 ,4560 
E02000810,2011,Southwark 004,Southwark,E09000028,6894 ,3399 ,3495 
E02000812,2011,Southwark 006,Southwark,E09000028,8096 ,4026 ,4070 
E02000813,2011,Southwark 007,Southwark,E09000028,6287 ,3060 ,3227 
E02000814,2011,Southwark 008,Southwark,E09000028,7216 ,3709 ,3507 
E02000815,2011,Southwark 009,Southwark,E09000028,5406 ,2769 ,2637 
E02000816,2011,Southwark 010,Southwark,E09000028,6673 ,3256 ,3417 
E02000817,2011,Southwark 011,Southwark,E09000028,4455 ,2198 ,2257 
E02000818,2011,Southwark 012,Southwark,E09000028,5660 ,2895 ,2765 
E02000819,2011,Southwark 013,Southwark,E09000028,6151 ,3054 ,3097 
E02000820,2011,Southwark 014,Southwark,E09000028,6530 ,3480 ,3050 
E02000821,2011,Southwark 015,Southwark,E09000028,5855 ,2883 ,2972 
E02000822,2011,Southwark 016,Southwark,E09000028,5786 ,2934 ,2852 
E02000823,2011,Southwark 017,Southwark,E09000028,5705 ,2837 ,2868 
E02000824,2011,Southwark 018,Southwark,E09000028,6443 ,3101 ,3342 
E02000825,2011,Southwark 019,Southwark,E09000028,6621 ,3143 ,3478 
E02000826,2011,Southwark 020,Southwark,E09000028,6452 ,3150 ,3302 
E02000827,2011,Southwark 021,Southwark,E09000028,7493 ,3786 ,3707 
E02000828,2011,Southwark 022,Southwark,E09000028,5958 ,2940 ,3018 
E02000829,2011,Southwark 023,Southwark,E09000028,7601 ,3984 ,3617 
E02000830,2011,Southwark 024,Southwark,E09000028,6752 ,3303 ,3449 
E02000831,2011,Southwark 025,Southwark,E09000028,6919 ,3413 ,3506 
E02000832,2011,Southwark 026,Southwark,E09000028,6864 ,3225 ,3639 
E02000833,2011,Southwark 027,Southwark,E09000028,5589 ,2542 ,3047 
E02000834,2011,Southwark 028,Southwark,E09000028,7040 ,3336 ,3704 
E02000835,2011,Southwark 029,Southwark,E09000028,5041 ,2420 ,2621 
E02000836,2011,Southwark 030,Southwark,E09000028,5912 ,2853 ,3059 
E02000837,2011,Southwark 031,Southwark,E09000028,5860 ,2801 ,3059 
E02000838,2011,Southwark 032,Southwark,E09000028,6562 ,3111 ,3451 
E02000839,2011,Southwark 033,Southwark,E09000028,5377 ,2601 ,2776 
E02006802,2011,Southwark 034,Southwark,E09000028,6317 ,3279 ,3038 
E02000840,2011,Sutton 001,Sutton,E09000029,5446 ,2557 ,2889 
E02000841,2011,Sutton 002,Sutton,E09000029,5843 ,2765 ,3078 
E02000842,2011,Sutton 003,Sutton,E09000029,5117 ,2530 ,2587 
E02000843,2011,Sutton 004,Sutton,E09000029,5244 ,2551 ,2693 
E02000844,2011,Sutton 005,Sutton,E09000029,5218 ,2514 ,2704 
E02000845,2011,Sutton 006,Sutton,E09000029,6067 ,2931 ,3136 
E02000846,2011,Sutton 007,Sutton,E09000029,4566 ,2258 ,2308 
E02000847,2011,Sutton 008,Sutton,E09000029,5635 ,2816 ,2819 
E02000848,2011,Sutton 009,Sutton,E09000029,5165 ,2571 ,2594 
E02000849,2011,Sutton 010,Sutton,E09000029,5077 ,2479 ,2598 
E02000850,2011,Sutton 011,Sutton,E09000029,6909 ,3427 ,3482 
E02000851,2011,Sutton 012,Sutton,E09000029,5773 ,2940 ,2833 
E02000852,2011,Sutton 013,Sutton,E09000029,5226 ,2572 ,2654 
E02000853,2011,Sutton 014,Sutton,E09000029,5167 ,2510 ,2657 
E02000854,2011,Sutton 015,Sutton,E09000029,4799 ,2375 ,2424 
E02000855,2011,Sutton 016,Sutton,E09000029,5015 ,2490 ,2525 
E02000856,2011,Sutton 017,Sutton,E09000029,5622 ,2792 ,2830 
E02000857,2011,Sutton 018,Sutton,E09000029,5525 ,2805 ,2720 
E02000858,2011,Sutton 019,Sutton,E09000029,5036 ,2325 ,2711 
E02000859,2011,Sutton 020,Sutton,E09000029,5202 ,2503 ,2699 
E02000860,2011,Sutton 021,Sutton,E09000029,5331 ,2718 ,2613 
E02000861,2011,Sutton 022,Sutton,E09000029,4943 ,2421 ,2522 
E02000863,2011,Sutton 024,Sutton,E09000029,4121 ,1998 ,2123 
E02006836,2011,Sutton 025,Sutton,E09000029,5163 ,2555 ,2608 
E02000864,2011,Tower Hamlets 001,Tower Hamlets,E09000030,5853 ,2848 ,3005 
E02000865,2011,Tower Hamlets 002,Tower Hamlets,E09000030,5114 ,2514 ,2600 
E02000866,2011,Tower Hamlets 003,Tower Hamlets,E09000030,7266 ,3581 ,3685 
E02000867,2011,Tower Hamlets 004,Tower Hamlets,E09000030,7740 ,3932 ,3808 
E02000868,2011,Tower Hamlets 005,Tower Hamlets,E09000030,5236 ,2685 ,2551 
E02000869,2011,Tower Hamlets 006,Tower Hamlets,E09000030,4278 ,2237 ,2041 
E02000870,2011,Tower Hamlets 007,Tower Hamlets,E09000030,4728 ,2338 ,2390 
E02000871,2011,Tower Hamlets 008,Tower Hamlets,E09000030,5895 ,3070 ,2825 
E02000872,2011,Tower Hamlets 009,Tower Hamlets,E09000030,5831 ,3111 ,2720 
E02000873,2011,Tower Hamlets 010,Tower Hamlets,E09000030,6739 ,3346 ,3393 
E02000874,2011,Tower Hamlets 011,Tower Hamlets,E09000030,5190 ,2676 ,2514 
E02000875,2011,Tower Hamlets 012,Tower Hamlets,E09000030,6685 ,3416 ,3269 
E02000876,2011,Tower Hamlets 013,Tower Hamlets,E09000030,5614 ,3027 ,2587 
E02000877,2011,Tower Hamlets 014,Tower Hamlets,E09000030,6884 ,3551 ,3333 
E02000878,2011,Tower Hamlets 015,Tower Hamlets,E09000030,8438 ,4542 ,3896 
E02000879,2011,Tower Hamlets 016,Tower Hamlets,E09000030,5380 ,2743 ,2637 
E02000880,2011,Tower Hamlets 017,Tower Hamlets,E09000030,4243 ,2264 ,1979 
E02000881,2011,Tower Hamlets 018,Tower Hamlets,E09000030,4596 ,2301 ,2295 
E02000882,2011,Tower Hamlets 019,Tower Hamlets,E09000030,5794 ,2932 ,2862 
E02000883,2011,Tower Hamlets 020,Tower Hamlets,E09000030,5253 ,2652 ,2601 
E02000884,2011,Tower Hamlets 021,Tower Hamlets,E09000030,7506 ,4277 ,3229 
E02000885,2011,Tower Hamlets 022,Tower Hamlets,E09000030,4753 ,2466 ,2287 
E02000886,2011,Tower Hamlets 023,Tower Hamlets,E09000030,5655 ,3119 ,2536 
E02000887,2011,Tower Hamlets 024,Tower Hamlets,E09000030,5922 ,2969 ,2953 
E02000888,2011,Tower Hamlets 025,Tower Hamlets,E09000030,6164 ,3365 ,2799 
E02000889,2011,Tower Hamlets 026,Tower Hamlets,E09000030,5209 ,2913 ,2296 
E02000890,2011,Tower Hamlets 027,Tower Hamlets,E09000030,4853 ,2709 ,2144 
E02000891,2011,Tower Hamlets 028,Tower Hamlets,E09000030,10235 ,5500 ,4735 
E02000893,2011,Tower Hamlets 030,Tower Hamlets,E09000030,5026 ,2548 ,2478 
E02000894,2011,Tower Hamlets 031,Tower Hamlets,E09000030,8373 ,4431 ,3942 
E02006853,2011,Tower Hamlets 032,Tower Hamlets,E09000030,5558 ,2941 ,2617 
E02006854,2011,Tower Hamlets 033,Tower Hamlets,E09000030,4965 ,2799 ,2166 
E02000895,2011,Waltham Forest 001,Waltham Forest,E09000031,4794 ,2303 ,2491 
E02000896,2011,Waltham Forest 002,Waltham Forest,E09000031,5772 ,2880 ,2892 
E02000897,2011,Waltham Forest 003,Waltham Forest,E09000031,5117 ,2413 ,2704 
E02000898,2011,Waltham Forest 004,Waltham Forest,E09000031,5043 ,2444 ,2599 
E02000899,2011,Waltham Forest 005,Waltham Forest,E09000031,5261 ,2570 ,2691 
E02000900,2011,Waltham Forest 006,Waltham Forest,E09000031,5385 ,2587 ,2798 
E02000901,2011,Waltham Forest 007,Waltham Forest,E09000031,6320 ,3023 ,3297 
E02000902,2011,Waltham Forest 008,Waltham Forest,E09000031,5494 ,2665 ,2829 
E02000903,2011,Waltham Forest 009,Waltham Forest,E09000031,6077 ,2954 ,3123 
E02000904,2011,Waltham Forest 010,Waltham Forest,E09000031,5700 ,2833 ,2867 
E02000905,2011,Waltham Forest 011,Waltham Forest,E09000031,6659 ,3369 ,3290 
E02000906,2011,Waltham Forest 012,Waltham Forest,E09000031,6421 ,3211 ,3210 
E02000907,2011,Waltham Forest 013,Waltham Forest,E09000031,6630 ,3245 ,3385 
E02000908,2011,Waltham Forest 014,Waltham Forest,E09000031,7780 ,4264 ,3516 
E02000909,2011,Waltham Forest 015,Waltham Forest,E09000031,6066 ,2971 ,3095 
E02000910,2011,Waltham Forest 016,Waltham Forest,E09000031,7834 ,4024 ,3810 
E02000911,2011,Waltham Forest 017,Waltham Forest,E09000031,7946 ,4037 ,3909 
E02000912,2011,Waltham Forest 018,Waltham Forest,E09000031,6223 ,3083 ,3140 
E02000913,2011,Waltham Forest 019,Waltham Forest,E09000031,6151 ,3181 ,2970 
E02000914,2011,Waltham Forest 020,Waltham Forest,E09000031,7466 ,3815 ,3651 
E02000915,2011,Waltham Forest 021,Waltham Forest,E09000031,6549 ,3524 ,3025 
E02000916,2011,Waltham Forest 022,Waltham Forest,E09000031,6510 ,3272 ,3238 
E02000917,2011,Waltham Forest 023,Waltham Forest,E09000031,6512 ,3312 ,3200 
E02000918,2011,Waltham Forest 024,Waltham Forest,E09000031,6849 ,3617 ,3232 
E02000919,2011,Waltham Forest 025,Waltham Forest,E09000031,7023 ,3680 ,3343 
E02000920,2011,Waltham Forest 026,Waltham Forest,E09000031,7021 ,3541 ,3480 
E02000921,2011,Waltham Forest 027,Waltham Forest,E09000031,7880 ,3979 ,3901 
E02000922,2011,Waltham Forest 028,Waltham Forest,E09000031,7758 ,4287 ,3471 
E02000923,2011,Wandsworth 001,Wandsworth,E09000032,5623 ,2845 ,2778 
E02000924,2011,Wandsworth 002,Wandsworth,E09000032,8709 ,4314 ,4395 
E02000925,2011,Wandsworth 003,Wandsworth,E09000032,5600 ,2654 ,2946 
E02000926,2011,Wandsworth 004,Wandsworth,E09000032,7178 ,3640 ,3538 
E02000927,2011,Wandsworth 005,Wandsworth,E09000032,5321 ,2560 ,2761 
E02000928,2011,Wandsworth 006,Wandsworth,E09000032,6188 ,2959 ,3229 
E02000929,2011,Wandsworth 007,Wandsworth,E09000032,5139 ,2279 ,2860 
E02000930,2011,Wandsworth 008,Wandsworth,E09000032,8058 ,3890 ,4168 
E02000931,2011,Wandsworth 009,Wandsworth,E09000032,6569 ,3240 ,3329 
E02000932,2011,Wandsworth 010,Wandsworth,E09000032,8468 ,4221 ,4247 
E02000933,2011,Wandsworth 011,Wandsworth,E09000032,6436 ,3098 ,3338 
E02000934,2011,Wandsworth 012,Wandsworth,E09000032,7604 ,3800 ,3804 
E02000935,2011,Wandsworth 013,Wandsworth,E09000032,4835 ,2092 ,2743 
E02000936,2011,Wandsworth 014,Wandsworth,E09000032,6461 ,3103 ,3358 
E02000937,2011,Wandsworth 015,Wandsworth,E09000032,5558 ,2722 ,2836 
E02000938,2011,Wandsworth 016,Wandsworth,E09000032,6519 ,3004 ,3515 
E02000939,2011,Wandsworth 017,Wandsworth,E09000032,5288 ,2612 ,2676 
E02000940,2011,Wandsworth 018,Wandsworth,E09000032,5913 ,2887 ,3026 
E02000941,2011,Wandsworth 019,Wandsworth,E09000032,7329 ,3594 ,3735 
E02000942,2011,Wandsworth 020,Wandsworth,E09000032,6918 ,3344 ,3574 
E02000943,2011,Wandsworth 021,Wandsworth,E09000032,6603 ,3308 ,3295 
E02000944,2011,Wandsworth 022,Wandsworth,E09000032,5196 ,2460 ,2736 
E02000945,2011,Wandsworth 023,Wandsworth,E09000032,5598 ,2573 ,3025 
E02000946,2011,Wandsworth 024,Wandsworth,E09000032,6998 ,3967 ,3031 
E02000947,2011,Wandsworth 025,Wandsworth,E09000032,6547 ,3130 ,3417 
E02000948,2011,Wandsworth 026,Wandsworth,E09000032,8021 ,3876 ,4145 
E02000949,2011,Wandsworth 027,Wandsworth,E09000032,7341 ,3573 ,3768 
E02000950,2011,Wandsworth 028,Wandsworth,E09000032,5573 ,2699 ,2874 
E02000951,2011,Wandsworth 029,Wandsworth,E09000032,5226 ,2538 ,2688 
E02000952,2011,Wandsworth 030,Wandsworth,E09000032,4774 ,2345 ,2429 
E02000953,2011,Wandsworth 031,Wandsworth,E09000032,5599 ,2552 ,3047 
E02000954,2011,Wandsworth 032,Wandsworth,E09000032,4661 ,2242 ,2419 
E02000955,2011,Wandsworth 033,Wandsworth,E09000032,4764 ,2295 ,2469 
E02000956,2011,Wandsworth 034,Wandsworth,E09000032,5884 ,2795 ,3089 
E02000957,2011,Wandsworth 035,Wandsworth,E09000032,7949 ,3945 ,4004 
E02000958,2011,Wandsworth 036,Wandsworth,E09000032,5582 ,2650 ,2932 
E02000959,2011,Wandsworth 037,Wandsworth,E09000032,5080 ,2485 ,2595 
E02000960,2011,Westminster 001,Westminster,E09000033,4502 ,2157 ,2345 
E02000961,2011,Westminster 002,Westminster,E09000033,6421 ,3010 ,3411 
E02000962,2011,Westminster 003,Westminster,E09000033,5903 ,2887 ,3016 
E02000963,2011,Westminster 004,Westminster,E09000033,7028 ,3297 ,3731 
E02000964,2011,Westminster 005,Westminster,E09000033,9156 ,4396 ,4760 
E02000965,2011,Westminster 006,Westminster,E09000033,6710 ,3363 ,3347 
E02000966,2011,Westminster 007,Westminster,E09000033,7338 ,3679 ,3659 
E02000967,2011,Westminster 008,Westminster,E09000033,5777 ,3050 ,2727 
E02000968,2011,Westminster 009,Westminster,E09000033,9480 ,4577 ,4903 
E02000969,2011,Westminster 010,Westminster,E09000033,6195 ,2994 ,3201 
E02000970,2011,Westminster 011,Westminster,E09000033,7053 ,3810 ,3243 
E02000971,2011,Westminster 012,Westminster,E09000033,6704 ,3659 ,3045 
E02000972,2011,Westminster 013,Westminster,E09000033,6993 ,4059 ,2934 
E02000973,2011,Westminster 014,Westminster,E09000033,7804 ,3972 ,3832 
E02000974,2011,Westminster 015,Westminster,E09000033,6593 ,3702 ,2891 
E02000975,2011,Westminster 016,Westminster,E09000033,7275 ,3908 ,3367 
E02000976,2011,Westminster 017,Westminster,E09000033,7971 ,4191 ,3780 
E02000977,2011,Westminster 018,Westminster,E09000033,6315 ,3744 ,2571 
E02000978,2011,Westminster 019,Westminster,E09000033,7134 ,3888 ,3246 
E02000979,2011,Westminster 020,Westminster,E09000033,6180 ,3395 ,2785 
E02000980,2011,Westminster 021,Westminster,E09000033,6329 ,3238 ,3091 
E02000981,2011,Westminster 022,Westminster,E09000033,7276 ,3733 ,3543 
E02000982,2011,Westminster 023,Westminster,E09000033,5738 ,2829 ,2909 
E02000983,2011,Westminster 024,Westminster,E09000033,5946 ,2968 ,2978 
E02000001,2012,City of London 001,City of London,E09000001,5895 ,3326 ,2569 
E02000002,2012,Barking and Dagenham 001,Barking and Dagenham,E09000002,3993 ,1837 ,2156 
E02000003,2012,Barking and Dagenham 002,Barking and Dagenham,E09000002,6665 ,3247 ,3418 
E02000004,2012,Barking and Dagenham 003,Barking and Dagenham,E09000002,4106 ,1999 ,2107 
E02000005,2012,Barking and Dagenham 004,Barking and Dagenham,E09000002,5518 ,2632 ,2886 
E02000007,2012,Barking and Dagenham 006,Barking and Dagenham,E09000002,5560 ,2595 ,2965 
E02000008,2012,Barking and Dagenham 007,Barking and Dagenham,E09000002,7393 ,3454 ,3939 
E02000009,2012,Barking and Dagenham 008,Barking and Dagenham,E09000002,5820 ,2811 ,3009 
E02000010,2012,Barking and Dagenham 009,Barking and Dagenham,E09000002,5616 ,2625 ,2991 
E02000011,2012,Barking and Dagenham 010,Barking and Dagenham,E09000002,4042 ,2037 ,2005 
E02000012,2012,Barking and Dagenham 011,Barking and Dagenham,E09000002,6609 ,3289 ,3320 
E02000013,2012,Barking and Dagenham 012,Barking and Dagenham,E09000002,5256 ,2499 ,2757 
E02000014,2012,Barking and Dagenham 013,Barking and Dagenham,E09000002,5988 ,2806 ,3182 
E02000015,2012,Barking and Dagenham 014,Barking and Dagenham,E09000002,4916 ,2341 ,2575 
E02000016,2012,Barking and Dagenham 015,Barking and Dagenham,E09000002,5724 ,3062 ,2662 
E02000017,2012,Barking and Dagenham 016,Barking and Dagenham,E09000002,6068 ,3349 ,2719 
E02000018,2012,Barking and Dagenham 017,Barking and Dagenham,E09000002,5719 ,2709 ,3010 
E02000019,2012,Barking and Dagenham 018,Barking and Dagenham,E09000002,5433 ,2592 ,2841 
E02000020,2012,Barking and Dagenham 019,Barking and Dagenham,E09000002,6082 ,3051 ,3031 
E02000021,2012,Barking and Dagenham 020,Barking and Dagenham,E09000002,5237 ,2498 ,2739 
E02000022,2012,Barking and Dagenham 021,Barking and Dagenham,E09000002,5594 ,2778 ,2816 
E02000023,2012,Barking and Dagenham 022,Barking and Dagenham,E09000002,4078 ,1991 ,2087 
E02006799,2012,Barking and Dagenham 023,Barking and Dagenham,E09000002,6484 ,3084 ,3400 
E02000024,2012,Barnet 001,Barnet,E09000003,6734 ,3291 ,3443 
E02000025,2012,Barnet 002,Barnet,E09000003,5484 ,2650 ,2834 
E02000026,2012,Barnet 003,Barnet,E09000003,4158 ,1984 ,2174 
E02000027,2012,Barnet 004,Barnet,E09000003,6225 ,2925 ,3300 
E02000028,2012,Barnet 005,Barnet,E09000003,4159 ,2078 ,2081 
E02000029,2012,Barnet 006,Barnet,E09000003,5744 ,2819 ,2925 
E02000030,2012,Barnet 007,Barnet,E09000003,5739 ,2729 ,3010 
E02000031,2012,Barnet 008,Barnet,E09000003,4706 ,2329 ,2377 
E02000032,2012,Barnet 009,Barnet,E09000003,5060 ,2453 ,2607 
E02000033,2012,Barnet 010,Barnet,E09000003,5774 ,2802 ,2972 
E02000034,2012,Barnet 011,Barnet,E09000003,5711 ,2703 ,3008 
E02000035,2012,Barnet 012,Barnet,E09000003,5444 ,2660 ,2784 
E02000036,2012,Barnet 013,Barnet,E09000003,7015 ,3410 ,3605 
E02000037,2012,Barnet 014,Barnet,E09000003,6143 ,2902 ,3241 
E02000038,2012,Barnet 015,Barnet,E09000003,7554 ,3828 ,3726 
E02000039,2012,Barnet 016,Barnet,E09000003,4346 ,2096 ,2250 
E02000040,2012,Barnet 017,Barnet,E09000003,4571 ,2135 ,2436 
E02000041,2012,Barnet 018,Barnet,E09000003,5961 ,2951 ,3010 
E02000042,2012,Barnet 019,Barnet,E09000003,7569 ,3781 ,3788 
E02000043,2012,Barnet 020,Barnet,E09000003,5050 ,2442 ,2608 
E02000044,2012,Barnet 021,Barnet,E09000003,5425 ,2504 ,2921 
E02000045,2012,Barnet 022,Barnet,E09000003,7347 ,3578 ,3769 
E02000046,2012,Barnet 023,Barnet,E09000003,5233 ,2621 ,2612 
E02000047,2012,Barnet 024,Barnet,E09000003,7653 ,3671 ,3982 
E02000048,2012,Barnet 025,Barnet,E09000003,6479 ,3153 ,3326 
E02000049,2012,Barnet 026,Barnet,E09000003,5622 ,2562 ,3060 
E02000050,2012,Barnet 027,Barnet,E09000003,7033 ,3441 ,3592 
E02000051,2012,Barnet 028,Barnet,E09000003,5770 ,2917 ,2853 
E02000052,2012,Barnet 029,Barnet,E09000003,7152 ,3528 ,3624 
E02000053,2012,Barnet 030,Barnet,E09000003,6850 ,3484 ,3366 
E02000054,2012,Barnet 031,Barnet,E09000003,5274 ,2607 ,2667 
E02000055,2012,Barnet 032,Barnet,E09000003,7905 ,4007 ,3898 
E02000056,2012,Barnet 033,Barnet,E09000003,5710 ,2749 ,2961 
E02000057,2012,Barnet 034,Barnet,E09000003,4810 ,2386 ,2424 
E02000058,2012,Barnet 035,Barnet,E09000003,6581 ,3091 ,3490 
E02000059,2012,Barnet 036,Barnet,E09000003,7430 ,3816 ,3614 
E02000060,2012,Barnet 037,Barnet,E09000003,6550 ,3237 ,3313 
E02000061,2012,Barnet 038,Barnet,E09000003,5694 ,2839 ,2855 
E02000062,2012,Barnet 039,Barnet,E09000003,4523 ,2189 ,2334 
E02000063,2012,Barnet 040,Barnet,E09000003,4886 ,2456 ,2430 
E02000064,2012,Barnet 041,Barnet,E09000003,4440 ,2142 ,2298 
E02000065,2012,Bexley 001,Bexley,E09000004,5252 ,2526 ,2726 
E02000066,2012,Bexley 002,Bexley,E09000004,6306 ,2962 ,3344 
E02000067,2012,Bexley 003,Bexley,E09000004,5888 ,2820 ,3068 
E02000068,2012,Bexley 004,Bexley,E09000004,4930 ,2361 ,2569 
E02000069,2012,Bexley 005,Bexley,E09000004,3926 ,1904 ,2022 
E02000070,2012,Bexley 006,Bexley,E09000004,5054 ,2433 ,2621 
E02000071,2012,Bexley 007,Bexley,E09000004,4915 ,2365 ,2550 
E02000072,2012,Bexley 008,Bexley,E09000004,7563 ,3558 ,4005 
E02000073,2012,Bexley 009,Bexley,E09000004,6710 ,3268 ,3442 
E02000074,2012,Bexley 010,Bexley,E09000004,4950 ,2305 ,2645 
E02000075,2012,Bexley 011,Bexley,E09000004,4971 ,2430 ,2541 
E02000077,2012,Bexley 013,Bexley,E09000004,5076 ,2440 ,2636 
E02000078,2012,Bexley 014,Bexley,E09000004,5070 ,2446 ,2624 
E02000079,2012,Bexley 015,Bexley,E09000004,4918 ,2383 ,2535 
E02000080,2012,Bexley 016,Bexley,E09000004,6132 ,2989 ,3143 
E02000081,2012,Bexley 017,Bexley,E09000004,4694 ,2319 ,2375 
E02000082,2012,Bexley 018,Bexley,E09000004,5955 ,2959 ,2996 
E02000083,2012,Bexley 019,Bexley,E09000004,6535 ,3273 ,3262 
E02000084,2012,Bexley 020,Bexley,E09000004,6880 ,3404 ,3476 
E02000085,2012,Bexley 021,Bexley,E09000004,5234 ,2521 ,2713 
E02000086,2012,Bexley 022,Bexley,E09000004,4916 ,2421 ,2495 
E02000087,2012,Bexley 023,Bexley,E09000004,4640 ,2322 ,2318 
E02000088,2012,Bexley 024,Bexley,E09000004,4953 ,2418 ,2535 
E02000089,2012,Bexley 025,Bexley,E09000004,4910 ,2420 ,2490 
E02000090,2012,Bexley 026,Bexley,E09000004,5716 ,2739 ,2977 
E02000091,2012,Bexley 027,Bexley,E09000004,6190 ,2972 ,3218 
E02000092,2012,Bexley 028,Bexley,E09000004,4135 ,1933 ,2202 
E02006785,2012,Bexley 029,Bexley,E09000004,4112 ,2007 ,2105 
E02000093,2012,Brent 001,Brent,E09000005,7337 ,3693 ,3644 
E02000094,2012,Brent 002,Brent,E09000005,5962 ,3058 ,2904 
E02000095,2012,Brent 003,Brent,E09000005,6717 ,3431 ,3286 
E02000096,2012,Brent 004,Brent,E09000005,4838 ,2432 ,2406 
E02000097,2012,Brent 005,Brent,E09000005,6032 ,3140 ,2892 
E02000098,2012,Brent 006,Brent,E09000005,5362 ,2734 ,2628 
E02000099,2012,Brent 007,Brent,E09000005,5862 ,2987 ,2875 
E02000100,2012,Brent 008,Brent,E09000005,5971 ,2842 ,3129 
E02000101,2012,Brent 009,Brent,E09000005,6324 ,3179 ,3145 
E02000102,2012,Brent 010,Brent,E09000005,5047 ,2505 ,2542 
E02000103,2012,Brent 011,Brent,E09000005,5680 ,2822 ,2858 
E02000104,2012,Brent 012,Brent,E09000005,4537 ,2374 ,2163 
E02000105,2012,Brent 013,Brent,E09000005,6583 ,3492 ,3091 
E02000106,2012,Brent 014,Brent,E09000005,7112 ,3651 ,3461 
E02000107,2012,Brent 015,Brent,E09000005,8240 ,4277 ,3963 
E02000108,2012,Brent 016,Brent,E09000005,4488 ,2396 ,2092 
E02000109,2012,Brent 017,Brent,E09000005,7087 ,3808 ,3279 
E02000110,2012,Brent 018,Brent,E09000005,6210 ,3148 ,3062 
E02000111,2012,Brent 019,Brent,E09000005,7080 ,3806 ,3274 
E02000112,2012,Brent 020,Brent,E09000005,6854 ,3730 ,3124 
E02000113,2012,Brent 021,Brent,E09000005,6235 ,2962 ,3273 
E02000114,2012,Brent 022,Brent,E09000005,6990 ,3571 ,3419 
E02000115,2012,Brent 023,Brent,E09000005,6422 ,3352 ,3070 
E02000116,2012,Brent 024,Brent,E09000005,6089 ,3122 ,2967 
E02000117,2012,Brent 025,Brent,E09000005,8007 ,3897 ,4110 
E02000118,2012,Brent 026,Brent,E09000005,6931 ,3681 ,3250 
E02000119,2012,Brent 027,Brent,E09000005,4798 ,2316 ,2482 
E02000120,2012,Brent 028,Brent,E09000005,7178 ,3516 ,3662 
E02000121,2012,Brent 029,Brent,E09000005,6672 ,3434 ,3238 
E02000122,2012,Brent 030,Brent,E09000005,5450 ,2643 ,2807 
E02000123,2012,Brent 031,Brent,E09000005,10509 ,5366 ,5143 
E02000124,2012,Brent 032,Brent,E09000005,7624 ,3828 ,3796 
E02000125,2012,Brent 033,Brent,E09000005,7772 ,3841 ,3931 
E02000126,2012,Brent 034,Brent,E09000005,5003 ,2469 ,2534 
E02000127,2012,Bromley 001,Bromley,E09000006,5533 ,2509 ,3024 
E02000128,2012,Bromley 002,Bromley,E09000006,4742 ,2250 ,2492 
E02000130,2012,Bromley 004,Bromley,E09000006,5621 ,2683 ,2938 
E02000131,2012,Bromley 005,Bromley,E09000006,7002 ,3478 ,3524 
E02000132,2012,Bromley 006,Bromley,E09000006,6408 ,3193 ,3215 
E02000133,2012,Bromley 007,Bromley,E09000006,5927 ,2883 ,3044 
E02000134,2012,Bromley 008,Bromley,E09000006,7532 ,3687 ,3845 
E02000135,2012,Bromley 009,Bromley,E09000006,6881 ,3278 ,3603 
E02000136,2012,Bromley 010,Bromley,E09000006,3402 ,1626 ,1776 
E02000137,2012,Bromley 011,Bromley,E09000006,5238 ,2545 ,2693 
E02000138,2012,Bromley 012,Bromley,E09000006,5236 ,2616 ,2620 
E02000139,2012,Bromley 013,Bromley,E09000006,5225 ,2499 ,2726 
E02000140,2012,Bromley 014,Bromley,E09000006,5022 ,2314 ,2708 
E02000141,2012,Bromley 015,Bromley,E09000006,4909 ,2349 ,2560 
E02000142,2012,Bromley 016,Bromley,E09000006,5404 ,2648 ,2756 
E02000144,2012,Bromley 018,Bromley,E09000006,6006 ,3005 ,3001 
E02000145,2012,Bromley 019,Bromley,E09000006,5164 ,2337 ,2827 
E02000146,2012,Bromley 020,Bromley,E09000006,5626 ,2751 ,2875 
E02000147,2012,Bromley 021,Bromley,E09000006,4987 ,2441 ,2546 
E02000148,2012,Bromley 022,Bromley,E09000006,4038 ,1983 ,2055 
E02000149,2012,Bromley 023,Bromley,E09000006,4992 ,2327 ,2665 
E02000150,2012,Bromley 024,Bromley,E09000006,5516 ,2662 ,2854 
E02000151,2012,Bromley 025,Bromley,E09000006,4574 ,2203 ,2371 
E02000152,2012,Bromley 026,Bromley,E09000006,4301 ,2037 ,2264 
E02000153,2012,Bromley 027,Bromley,E09000006,4911 ,2371 ,2540 
E02000154,2012,Bromley 028,Bromley,E09000006,5245 ,2599 ,2646 
E02000155,2012,Bromley 029,Bromley,E09000006,4223 ,2059 ,2164 
E02000156,2012,Bromley 030,Bromley,E09000006,7413 ,3640 ,3773 
E02000157,2012,Bromley 031,Bromley,E09000006,4759 ,2367 ,2392 
E02000158,2012,Bromley 032,Bromley,E09000006,4363 ,2119 ,2244 
E02000159,2012,Bromley 033,Bromley,E09000006,4274 ,2068 ,2206 
E02000160,2012,Bromley 034,Bromley,E09000006,5092 ,2505 ,2587 
E02000161,2012,Bromley 035,Bromley,E09000006,5333 ,2615 ,2718 
E02000162,2012,Bromley 036,Bromley,E09000006,3931 ,1823 ,2108 
E02000163,2012,Bromley 037,Bromley,E09000006,4742 ,2341 ,2401 
E02000165,2012,Bromley 039,Bromley,E09000006,4814 ,2380 ,2434 
E02006782,2012,Bromley 040,Bromley,E09000006,4873 ,2311 ,2562 
E02006787,2012,Bromley 041,Bromley,E09000006,5033 ,2397 ,2636 
E02006789,2012,Bromley 042,Bromley,E09000006,3916 ,1883 ,2033 
E02000166,2012,Camden 001,Camden,E09000007,5421 ,2506 ,2915 
E02000167,2012,Camden 002,Camden,E09000007,4895 ,2399 ,2496 
E02000168,2012,Camden 003,Camden,E09000007,6014 ,2910 ,3104 
E02000169,2012,Camden 004,Camden,E09000007,4723 ,2261 ,2462 
E02000170,2012,Camden 005,Camden,E09000007,6243 ,3187 ,3056 
E02000171,2012,Camden 006,Camden,E09000007,5812 ,2831 ,2981 
E02000172,2012,Camden 007,Camden,E09000007,7469 ,3645 ,3824 
E02000173,2012,Camden 008,Camden,E09000007,5597 ,2801 ,2796 
E02000174,2012,Camden 009,Camden,E09000007,6444 ,3005 ,3439 
E02000175,2012,Camden 010,Camden,E09000007,6930 ,3310 ,3620 
E02000176,2012,Camden 011,Camden,E09000007,4895 ,2437 ,2458 
E02000177,2012,Camden 012,Camden,E09000007,6503 ,3111 ,3392 
E02000178,2012,Camden 013,Camden,E09000007,7159 ,3662 ,3497 
E02000179,2012,Camden 014,Camden,E09000007,4451 ,2133 ,2318 
E02000180,2012,Camden 015,Camden,E09000007,5873 ,2896 ,2977 
E02000181,2012,Camden 016,Camden,E09000007,5999 ,2908 ,3091 
E02000182,2012,Camden 017,Camden,E09000007,4826 ,2226 ,2600 
E02000183,2012,Camden 018,Camden,E09000007,5539 ,2693 ,2846 
E02000184,2012,Camden 019,Camden,E09000007,6564 ,3175 ,3389 
E02000185,2012,Camden 020,Camden,E09000007,5874 ,2758 ,3116 
E02000186,2012,Camden 021,Camden,E09000007,5287 ,2759 ,2528 
E02000187,2012,Camden 022,Camden,E09000007,5867 ,2822 ,3045 
E02000188,2012,Camden 023,Camden,E09000007,6222 ,3270 ,2952 
E02000189,2012,Camden 024,Camden,E09000007,4464 ,2255 ,2209 
E02000190,2012,Camden 025,Camden,E09000007,6183 ,3077 ,3106 
E02000191,2012,Camden 026,Camden,E09000007,7144 ,3936 ,3208 
E02000192,2012,Camden 027,Camden,E09000007,5492 ,2988 ,2504 
E02000193,2012,Camden 028,Camden,E09000007,6625 ,3575 ,3050 
E02000194,2012,Croydon 001,Croydon,E09000008,6312 ,3185 ,3127 
E02000195,2012,Croydon 002,Croydon,E09000008,6253 ,3086 ,3167 
E02000196,2012,Croydon 003,Croydon,E09000008,5170 ,2550 ,2620 
E02000197,2012,Croydon 004,Croydon,E09000008,6019 ,2843 ,3176 
E02000198,2012,Croydon 005,Croydon,E09000008,5389 ,2544 ,2845 
E02000199,2012,Croydon 006,Croydon,E09000008,5723 ,2696 ,3027 
E02000200,2012,Croydon 007,Croydon,E09000008,5920 ,2823 ,3097 
E02000201,2012,Croydon 008,Croydon,E09000008,5782 ,2751 ,3031 
E02000202,2012,Croydon 009,Croydon,E09000008,5669 ,2804 ,2865 
E02000203,2012,Croydon 010,Croydon,E09000008,5049 ,2417 ,2632 
E02000204,2012,Croydon 011,Croydon,E09000008,6164 ,2933 ,3231 
E02000206,2012,Croydon 013,Croydon,E09000008,6429 ,3078 ,3351 
E02000207,2012,Croydon 014,Croydon,E09000008,6218 ,2936 ,3282 
E02000208,2012,Croydon 015,Croydon,E09000008,6720 ,3187 ,3533 
E02000209,2012,Croydon 016,Croydon,E09000008,5514 ,2643 ,2871 
E02000210,2012,Croydon 017,Croydon,E09000008,5841 ,2844 ,2997 
E02000211,2012,Croydon 018,Croydon,E09000008,5337 ,2610 ,2727 
E02000212,2012,Croydon 019,Croydon,E09000008,5655 ,2754 ,2901 
E02000213,2012,Croydon 020,Croydon,E09000008,6662 ,3338 ,3324 
E02000214,2012,Croydon 021,Croydon,E09000008,4300 ,2150 ,2150 
E02000215,2012,Croydon 022,Croydon,E09000008,7506 ,3925 ,3581 
E02000216,2012,Croydon 023,Croydon,E09000008,4133 ,2093 ,2040 
E02000217,2012,Croydon 024,Croydon,E09000008,7136 ,3575 ,3561 
E02000218,2012,Croydon 025,Croydon,E09000008,4300 ,1956 ,2344 
E02000219,2012,Croydon 026,Croydon,E09000008,4932 ,2440 ,2492 
E02000220,2012,Croydon 027,Croydon,E09000008,7476 ,3900 ,3576 
E02000221,2012,Croydon 028,Croydon,E09000008,6593 ,3102 ,3491 
E02000222,2012,Croydon 029,Croydon,E09000008,5703 ,2854 ,2849 
E02000223,2012,Croydon 030,Croydon,E09000008,4978 ,2126 ,2852 
E02000224,2012,Croydon 031,Croydon,E09000008,5414 ,2736 ,2678 
E02000225,2012,Croydon 032,Croydon,E09000008,4957 ,2317 ,2640 
E02000226,2012,Croydon 033,Croydon,E09000008,5023 ,2518 ,2505 
E02000227,2012,Croydon 034,Croydon,E09000008,7736 ,3680 ,4056 
E02000228,2012,Croydon 035,Croydon,E09000008,4794 ,2369 ,2425 
E02000229,2012,Croydon 036,Croydon,E09000008,4014 ,1878 ,2136 
E02000230,2012,Croydon 037,Croydon,E09000008,6775 ,3395 ,3380 
E02000231,2012,Croydon 038,Croydon,E09000008,5094 ,2519 ,2575 
E02000232,2012,Croydon 039,Croydon,E09000008,3951 ,1923 ,2028 
E02000233,2012,Croydon 040,Croydon,E09000008,4046 ,1953 ,2093 
E02000234,2012,Croydon 041,Croydon,E09000008,5368 ,2646 ,2722 
E02000235,2012,Croydon 042,Croydon,E09000008,4707 ,2280 ,2427 
E02000236,2012,Croydon 043,Croydon,E09000008,5090 ,2516 ,2574 
E02000237,2012,Croydon 044,Croydon,E09000008,4626 ,2247 ,2379 
E02006788,2012,Croydon 045,Croydon,E09000008,5079 ,2284 ,2795 
E02000238,2012,Ealing 001,Ealing,E09000009,6656 ,3449 ,3207 
E02000239,2012,Ealing 002,Ealing,E09000009,6261 ,3246 ,3015 
E02000240,2012,Ealing 003,Ealing,E09000009,6803 ,3262 ,3541 
E02000241,2012,Ealing 004,Ealing,E09000009,4676 ,2375 ,2301 
E02000242,2012,Ealing 005,Ealing,E09000009,4781 ,2556 ,2225 
E02000243,2012,Ealing 006,Ealing,E09000009,5807 ,2951 ,2856 
E02000244,2012,Ealing 007,Ealing,E09000009,5086 ,2661 ,2425 
E02000245,2012,Ealing 008,Ealing,E09000009,5436 ,2601 ,2835 
E02000246,2012,Ealing 009,Ealing,E09000009,5632 ,2721 ,2911 
E02000247,2012,Ealing 010,Ealing,E09000009,6719 ,3224 ,3495 
E02000248,2012,Ealing 011,Ealing,E09000009,5227 ,2650 ,2577 
E02000249,2012,Ealing 012,Ealing,E09000009,5193 ,2613 ,2580 
E02000250,2012,Ealing 013,Ealing,E09000009,4226 ,2037 ,2189 
E02000251,2012,Ealing 014,Ealing,E09000009,5490 ,2817 ,2673 
E02000252,2012,Ealing 015,Ealing,E09000009,7306 ,3940 ,3366 
E02000253,2012,Ealing 016,Ealing,E09000009,6181 ,2941 ,3240 
E02000254,2012,Ealing 017,Ealing,E09000009,6165 ,3180 ,2985 
E02000255,2012,Ealing 018,Ealing,E09000009,6384 ,3061 ,3323 
E02000256,2012,Ealing 019,Ealing,E09000009,6452 ,3284 ,3168 
E02000257,2012,Ealing 020,Ealing,E09000009,9952 ,5022 ,4930 
E02000258,2012,Ealing 021,Ealing,E09000009,4843 ,2527 ,2316 
E02000259,2012,Ealing 022,Ealing,E09000009,4367 ,2109 ,2258 
E02000260,2012,Ealing 023,Ealing,E09000009,6054 ,3215 ,2839 
E02000261,2012,Ealing 024,Ealing,E09000009,7793 ,3841 ,3952 
E02000262,2012,Ealing 025,Ealing,E09000009,6584 ,3343 ,3241 
E02000263,2012,Ealing 026,Ealing,E09000009,8089 ,4411 ,3678 
E02000264,2012,Ealing 027,Ealing,E09000009,5813 ,2948 ,2865 
E02000265,2012,Ealing 028,Ealing,E09000009,7776 ,3885 ,3891 
E02000266,2012,Ealing 029,Ealing,E09000009,8403 ,4193 ,4210 
E02000267,2012,Ealing 030,Ealing,E09000009,4927 ,2396 ,2531 
E02000268,2012,Ealing 031,Ealing,E09000009,6667 ,3339 ,3328 
E02000269,2012,Ealing 032,Ealing,E09000009,5710 ,2787 ,2923 
E02000270,2012,Ealing 033,Ealing,E09000009,5329 ,2553 ,2776 
E02000271,2012,Ealing 034,Ealing,E09000009,4742 ,2353 ,2389 
E02000272,2012,Ealing 035,Ealing,E09000009,4498 ,2219 ,2279 
E02000274,2012,Ealing 037,Ealing,E09000009,8943 ,4915 ,4028 
E02000275,2012,Ealing 038,Ealing,E09000009,4952 ,2584 ,2368 
E02000276,2012,Ealing 039,Ealing,E09000009,4827 ,2462 ,2365 
E02006791,2012,Ealing 040,Ealing,E09000009,4917 ,2400 ,2517 
E02000277,2012,Enfield 001,Enfield,E09000010,4697 ,2231 ,2466 
E02000278,2012,Enfield 002,Enfield,E09000010,5626 ,2605 ,3021 
E02000279,2012,Enfield 003,Enfield,E09000010,7654 ,3525 ,4129 
E02000280,2012,Enfield 004,Enfield,E09000010,5484 ,2602 ,2882 
E02000281,2012,Enfield 005,Enfield,E09000010,5728 ,2699 ,3029 
E02000282,2012,Enfield 006,Enfield,E09000010,5821 ,2690 ,3131 
E02000283,2012,Enfield 007,Enfield,E09000010,5446 ,2589 ,2857 
E02000284,2012,Enfield 008,Enfield,E09000010,5487 ,2658 ,2829 
E02000285,2012,Enfield 009,Enfield,E09000010,4263 ,2076 ,2187 
E02000286,2012,Enfield 010,Enfield,E09000010,5465 ,2781 ,2684 
E02000287,2012,Enfield 011,Enfield,E09000010,4265 ,2082 ,2183 
E02000288,2012,Enfield 012,Enfield,E09000010,6982 ,3355 ,3627 
E02000289,2012,Enfield 013,Enfield,E09000010,4140 ,1995 ,2145 
E02000290,2012,Enfield 014,Enfield,E09000010,4700 ,2219 ,2481 
E02000291,2012,Enfield 015,Enfield,E09000010,6056 ,3023 ,3033 
E02000292,2012,Enfield 016,Enfield,E09000010,6351 ,3079 ,3272 
E02000293,2012,Enfield 017,Enfield,E09000010,3944 ,1977 ,1967 
E02000294,2012,Enfield 018,Enfield,E09000010,5745 ,2772 ,2973 
E02000295,2012,Enfield 019,Enfield,E09000010,5541 ,2691 ,2850 
E02000296,2012,Enfield 020,Enfield,E09000010,6597 ,3155 ,3442 
E02000297,2012,Enfield 021,Enfield,E09000010,6101 ,3013 ,3088 
E02000298,2012,Enfield 022,Enfield,E09000010,5264 ,2636 ,2628 
E02000299,2012,Enfield 023,Enfield,E09000010,5982 ,2847 ,3135 
E02000300,2012,Enfield 024,Enfield,E09000010,5455 ,2601 ,2854 
E02000301,2012,Enfield 025,Enfield,E09000010,6678 ,3116 ,3562 
E02000302,2012,Enfield 026,Enfield,E09000010,5542 ,2682 ,2860 
E02000303,2012,Enfield 027,Enfield,E09000010,5535 ,2628 ,2907 
E02000304,2012,Enfield 028,Enfield,E09000010,5358 ,2630 ,2728 
E02000305,2012,Enfield 029,Enfield,E09000010,6305 ,3181 ,3124 
E02000306,2012,Enfield 030,Enfield,E09000010,6017 ,2789 ,3228 
E02000307,2012,Enfield 031,Enfield,E09000010,6605 ,3164 ,3441 
E02000308,2012,Enfield 032,Enfield,E09000010,5478 ,2814 ,2664 
E02000309,2012,Enfield 033,Enfield,E09000010,7000 ,3449 ,3551 
E02000311,2012,Enfield 035,Enfield,E09000010,6932 ,3330 ,3602 
E02000312,2012,Enfield 036,Enfield,E09000010,8081 ,4234 ,3847 
E02006793,2012,Enfield 037,Enfield,E09000010,6041 ,2787 ,3254 
E02000313,2012,Greenwich 001,Greenwich,E09000011,4490 ,2251 ,2239 
E02000314,2012,Greenwich 002,Greenwich,E09000011,9416 ,5137 ,4279 
E02000315,2012,Greenwich 003,Greenwich,E09000011,5755 ,2748 ,3007 
E02000316,2012,Greenwich 004,Greenwich,E09000011,8335 ,4362 ,3973 
E02000317,2012,Greenwich 005,Greenwich,E09000011,5647 ,2820 ,2827 
E02000318,2012,Greenwich 006,Greenwich,E09000011,7148 ,3743 ,3405 
E02000319,2012,Greenwich 007,Greenwich,E09000011,8107 ,4334 ,3773 
E02000320,2012,Greenwich 008,Greenwich,E09000011,4546 ,2190 ,2356 
E02000321,2012,Greenwich 009,Greenwich,E09000011,4987 ,2483 ,2504 
E02000323,2012,Greenwich 011,Greenwich,E09000011,7499 ,3827 ,3672 
E02000324,2012,Greenwich 012,Greenwich,E09000011,4911 ,2427 ,2484 
E02000326,2012,Greenwich 014,Greenwich,E09000011,5094 ,2499 ,2595 
E02000327,2012,Greenwich 015,Greenwich,E09000011,4790 ,2568 ,2222 
E02000328,2012,Greenwich 016,Greenwich,E09000011,4675 ,2362 ,2313 
E02000329,2012,Greenwich 017,Greenwich,E09000011,4244 ,2146 ,2098 
E02000331,2012,Greenwich 019,Greenwich,E09000011,5589 ,2742 ,2847 
E02000332,2012,Greenwich 020,Greenwich,E09000011,4938 ,2485 ,2453 
E02000333,2012,Greenwich 021,Greenwich,E09000011,4379 ,2249 ,2130 
E02000334,2012,Greenwich 022,Greenwich,E09000011,4420 ,2231 ,2189 
E02000335,2012,Greenwich 023,Greenwich,E09000011,4368 ,2179 ,2189 
E02000337,2012,Greenwich 025,Greenwich,E09000011,5412 ,2664 ,2748 
E02000339,2012,Greenwich 027,Greenwich,E09000011,3954 ,1974 ,1980 
E02000340,2012,Greenwich 028,Greenwich,E09000011,3971 ,2017 ,1954 
E02000341,2012,Greenwich 029,Greenwich,E09000011,4948 ,2311 ,2637 
E02000342,2012,Greenwich 030,Greenwich,E09000011,4574 ,2082 ,2492 
E02000343,2012,Greenwich 031,Greenwich,E09000011,4362 ,2208 ,2154 
E02000344,2012,Greenwich 032,Greenwich,E09000011,4146 ,2076 ,2070 
E02006786,2012,Greenwich 033,Greenwich,E09000011,4774 ,2394 ,2380 
E02006927,2012,Greenwich 034,Greenwich,E09000011,5237 ,2574 ,2663 
E02006928,2012,Greenwich 035,Greenwich,E09000011,6222 ,3049 ,3173 
E02006929,2012,Greenwich 036,Greenwich,E09000011,5932 ,2955 ,2977 
E02006930,2012,Greenwich 037,Greenwich,E09000011,5142 ,2647 ,2495 
E02006931,2012,Greenwich 038,Greenwich,E09000011,6744 ,3394 ,3350 
E02000345,2012,Hackney 001,Hackney,E09000012,5330 ,2669 ,2661 
E02000346,2012,Hackney 002,Hackney,E09000012,4322 ,2126 ,2196 
E02000347,2012,Hackney 003,Hackney,E09000012,4999 ,2453 ,2546 
E02000348,2012,Hackney 004,Hackney,E09000012,4974 ,2438 ,2536 
E02000350,2012,Hackney 006,Hackney,E09000012,7181 ,3575 ,3606 
E02000351,2012,Hackney 007,Hackney,E09000012,7020 ,3557 ,3463 
E02000352,2012,Hackney 008,Hackney,E09000012,4707 ,2183 ,2524 
E02000353,2012,Hackney 009,Hackney,E09000012,6032 ,2891 ,3141 
E02000354,2012,Hackney 010,Hackney,E09000012,7295 ,3653 ,3642 
E02000355,2012,Hackney 011,Hackney,E09000012,6555 ,3287 ,3268 
E02000356,2012,Hackney 012,Hackney,E09000012,5648 ,2782 ,2866 
E02000357,2012,Hackney 013,Hackney,E09000012,3989 ,1857 ,2132 
E02000358,2012,Hackney 014,Hackney,E09000012,8585 ,4288 ,4297 
E02000359,2012,Hackney 015,Hackney,E09000012,4776 ,2255 ,2521 
E02000360,2012,Hackney 016,Hackney,E09000012,8327 ,4031 ,4296 
E02000361,2012,Hackney 017,Hackney,E09000012,6131 ,3025 ,3106 
E02000362,2012,Hackney 018,Hackney,E09000012,4590 ,2301 ,2289 
E02000363,2012,Hackney 019,Hackney,E09000012,7359 ,3523 ,3836 
E02000364,2012,Hackney 020,Hackney,E09000012,7026 ,3484 ,3542 
E02000365,2012,Hackney 021,Hackney,E09000012,10614 ,5408 ,5206 
E02000366,2012,Hackney 022,Hackney,E09000012,6186 ,3016 ,3170 
E02000367,2012,Hackney 023,Hackney,E09000012,7902 ,3832 ,4070 
E02000368,2012,Hackney 024,Hackney,E09000012,7012 ,3450 ,3562 
E02000369,2012,Hackney 025,Hackney,E09000012,8988 ,4630 ,4358 
E02000370,2012,Hackney 026,Hackney,E09000012,6509 ,3389 ,3120 
E02000371,2012,Hackney 027,Hackney,E09000012,10815 ,5828 ,4987 
E02006918,2012,Hackney 028,Hackney,E09000012,5452 ,2637 ,2815 
E02006921,2012,Hackney 029,Hackney,E09000012,4908 ,2359 ,2549 
E02000372,2012,Hammersmith and Fulham 001,Hammersmith and Fulham,E09000013,6385 ,3008 ,3377 
E02000373,2012,Hammersmith and Fulham 002,Hammersmith and Fulham,E09000013,4351 ,2009 ,2342 
E02000374,2012,Hammersmith and Fulham 003,Hammersmith and Fulham,E09000013,4706 ,2228 ,2478 
E02000375,2012,Hammersmith and Fulham 004,Hammersmith and Fulham,E09000013,5167 ,2585 ,2582 
E02000376,2012,Hammersmith and Fulham 005,Hammersmith and Fulham,E09000013,5419 ,2804 ,2615 
E02000377,2012,Hammersmith and Fulham 006,Hammersmith and Fulham,E09000013,6098 ,3098 ,3000 
E02000378,2012,Hammersmith and Fulham 007,Hammersmith and Fulham,E09000013,5109 ,2504 ,2605 
E02000379,2012,Hammersmith and Fulham 008,Hammersmith and Fulham,E09000013,5404 ,2668 ,2736 
E02000380,2012,Hammersmith and Fulham 009,Hammersmith and Fulham,E09000013,4248 ,2190 ,2058 
E02000381,2012,Hammersmith and Fulham 010,Hammersmith and Fulham,E09000013,5715 ,2735 ,2980 
E02000382,2012,Hammersmith and Fulham 011,Hammersmith and Fulham,E09000013,4408 ,2188 ,2220 
E02000383,2012,Hammersmith and Fulham 012,Hammersmith and Fulham,E09000013,7319 ,3632 ,3687 
E02000384,2012,Hammersmith and Fulham 013,Hammersmith and Fulham,E09000013,5358 ,2668 ,2690 
E02000385,2012,Hammersmith and Fulham 014,Hammersmith and Fulham,E09000013,5160 ,2631 ,2529 
E02000386,2012,Hammersmith and Fulham 015,Hammersmith and Fulham,E09000013,6005 ,2979 ,3026 
E02000387,2012,Hammersmith and Fulham 016,Hammersmith and Fulham,E09000013,4791 ,2391 ,2400 
E02000388,2012,Hammersmith and Fulham 017,Hammersmith and Fulham,E09000013,6184 ,3064 ,3120 
E02000389,2012,Hammersmith and Fulham 018,Hammersmith and Fulham,E09000013,6098 ,2951 ,3147 
E02000390,2012,Hammersmith and Fulham 019,Hammersmith and Fulham,E09000013,4796 ,2299 ,2497 
E02000391,2012,Hammersmith and Fulham 020,Hammersmith and Fulham,E09000013,5493 ,2693 ,2800 
E02000392,2012,Hammersmith and Fulham 021,Hammersmith and Fulham,E09000013,7015 ,3271 ,3744 
E02000393,2012,Hammersmith and Fulham 022,Hammersmith and Fulham,E09000013,4522 ,2140 ,2382 
E02000394,2012,Hammersmith and Fulham 023,Hammersmith and Fulham,E09000013,5790 ,2773 ,3017 
E02000395,2012,Hammersmith and Fulham 024,Hammersmith and Fulham,E09000013,4211 ,2008 ,2203 
E02000396,2012,Hammersmith and Fulham 025,Hammersmith and Fulham,E09000013,4529 ,2179 ,2350 
E02000397,2012,Haringey 001,Haringey,E09000014,5994 ,3065 ,2929 
E02000398,2012,Haringey 002,Haringey,E09000014,4838 ,2485 ,2353 
E02000400,2012,Haringey 004,Haringey,E09000014,5450 ,2670 ,2780 
E02000401,2012,Haringey 005,Haringey,E09000014,4428 ,2087 ,2341 
E02000402,2012,Haringey 006,Haringey,E09000014,4490 ,2061 ,2429 
E02000403,2012,Haringey 007,Haringey,E09000014,5723 ,2953 ,2770 
E02000404,2012,Haringey 008,Haringey,E09000014,5272 ,2629 ,2643 
E02000405,2012,Haringey 009,Haringey,E09000014,4527 ,2210 ,2317 
E02000406,2012,Haringey 010,Haringey,E09000014,5169 ,2535 ,2634 
E02000407,2012,Haringey 011,Haringey,E09000014,5158 ,2573 ,2585 
E02000408,2012,Haringey 012,Haringey,E09000014,5369 ,2650 ,2719 
E02000409,2012,Haringey 013,Haringey,E09000014,4430 ,2205 ,2225 
E02000410,2012,Haringey 014,Haringey,E09000014,4807 ,2365 ,2442 
E02000411,2012,Haringey 015,Haringey,E09000014,5760 ,2949 ,2811 
E02000412,2012,Haringey 016,Haringey,E09000014,5293 ,2666 ,2627 
E02000413,2012,Haringey 017,Haringey,E09000014,4897 ,2309 ,2588 
E02000414,2012,Haringey 018,Haringey,E09000014,5210 ,2702 ,2508 
E02000415,2012,Haringey 019,Haringey,E09000014,5161 ,2711 ,2450 
E02000416,2012,Haringey 020,Haringey,E09000014,5590 ,2768 ,2822 
E02000417,2012,Haringey 021,Haringey,E09000014,4706 ,2255 ,2451 
E02000418,2012,Haringey 022,Haringey,E09000014,3848 ,1830 ,2018 
E02000419,2012,Haringey 023,Haringey,E09000014,6475 ,3374 ,3101 
E02000420,2012,Haringey 024,Haringey,E09000014,5383 ,2706 ,2677 
E02000421,2012,Haringey 025,Haringey,E09000014,5150 ,2554 ,2596 
E02000422,2012,Haringey 026,Haringey,E09000014,5670 ,2981 ,2689 
E02000423,2012,Haringey 027,Haringey,E09000014,5378 ,2874 ,2504 
E02000424,2012,Haringey 028,Haringey,E09000014,5451 ,2725 ,2726 
E02000425,2012,Haringey 029,Haringey,E09000014,4189 ,2092 ,2097 
E02000426,2012,Haringey 030,Haringey,E09000014,4566 ,2229 ,2337 
E02000427,2012,Haringey 031,Haringey,E09000014,5512 ,2899 ,2613 
E02000428,2012,Haringey 032,Haringey,E09000014,5186 ,2626 ,2560 
E02000429,2012,Haringey 033,Haringey,E09000014,5020 ,2561 ,2459 
E02000430,2012,Haringey 034,Haringey,E09000014,5901 ,3002 ,2899 
E02000431,2012,Haringey 035,Haringey,E09000014,5103 ,2593 ,2510 
E02000432,2012,Haringey 036,Haringey,E09000014,5095 ,2575 ,2520 
E02006794,2012,Haringey 037,Haringey,E09000014,4892 ,2395 ,2497 
E02000433,2012,Harrow 001,Harrow,E09000015,4562 ,2205 ,2357 
E02000434,2012,Harrow 002,Harrow,E09000015,5732 ,2803 ,2929 
E02000435,2012,Harrow 003,Harrow,E09000015,4779 ,2308 ,2471 
E02000436,2012,Harrow 004,Harrow,E09000015,3601 ,1767 ,1834 
E02000437,2012,Harrow 005,Harrow,E09000015,5540 ,2676 ,2864 
E02000438,2012,Harrow 006,Harrow,E09000015,5074 ,2403 ,2671 
E02000439,2012,Harrow 007,Harrow,E09000015,5727 ,2898 ,2829 
E02000440,2012,Harrow 008,Harrow,E09000015,6372 ,3144 ,3228 
E02000441,2012,Harrow 009,Harrow,E09000015,4400 ,2129 ,2271 
E02000442,2012,Harrow 010,Harrow,E09000015,6132 ,3127 ,3005 
E02000443,2012,Harrow 011,Harrow,E09000015,6357 ,3144 ,3213 
E02000444,2012,Harrow 012,Harrow,E09000015,5781 ,2900 ,2881 
E02000445,2012,Harrow 013,Harrow,E09000015,7042 ,3572 ,3470 
E02000447,2012,Harrow 015,Harrow,E09000015,4675 ,2269 ,2406 
E02000448,2012,Harrow 016,Harrow,E09000015,4189 ,2047 ,2142 
E02000449,2012,Harrow 017,Harrow,E09000015,5878 ,3035 ,2843 
E02000451,2012,Harrow 019,Harrow,E09000015,4342 ,2151 ,2191 
E02000452,2012,Harrow 020,Harrow,E09000015,5951 ,3093 ,2858 
E02000453,2012,Harrow 021,Harrow,E09000015,5333 ,2628 ,2705 
E02000454,2012,Harrow 022,Harrow,E09000015,4469 ,2157 ,2312 
E02000455,2012,Harrow 023,Harrow,E09000015,5804 ,2966 ,2838 
E02000456,2012,Harrow 024,Harrow,E09000015,4828 ,2396 ,2432 
E02000457,2012,Harrow 025,Harrow,E09000015,4078 ,2061 ,2017 
E02000459,2012,Harrow 027,Harrow,E09000015,5686 ,2827 ,2859 
E02000460,2012,Harrow 028,Harrow,E09000015,4464 ,2202 ,2262 
E02000461,2012,Harrow 029,Harrow,E09000015,5019 ,2840 ,2179 
E02000462,2012,Harrow 030,Harrow,E09000015,4502 ,2302 ,2200 
E02000463,2012,Harrow 031,Harrow,E09000015,5658 ,2755 ,2903 
E02006795,2012,Harrow 032,Harrow,E09000015,5446 ,2735 ,2711 
E02006882,2012,Harrow 033,Harrow,E09000015,9746 ,4830 ,4916 
E02000464,2012,Havering 001,Havering,E09000016,4000 ,1916 ,2084 
E02000465,2012,Havering 002,Havering,E09000016,5261 ,2550 ,2711 
E02000466,2012,Havering 003,Havering,E09000016,5333 ,2484 ,2849 
E02000467,2012,Havering 004,Havering,E09000016,6409 ,3062 ,3347 
E02000468,2012,Havering 005,Havering,E09000016,5006 ,2384 ,2622 
E02000469,2012,Havering 006,Havering,E09000016,4193 ,1989 ,2204 
E02000470,2012,Havering 007,Havering,E09000016,5122 ,2576 ,2546 
E02000471,2012,Havering 008,Havering,E09000016,4636 ,2273 ,2363 
E02000472,2012,Havering 009,Havering,E09000016,5788 ,2820 ,2968 
E02000473,2012,Havering 010,Havering,E09000016,6239 ,3061 ,3178 
E02000474,2012,Havering 011,Havering,E09000016,5421 ,2620 ,2801 
E02000475,2012,Havering 012,Havering,E09000016,6086 ,2985 ,3101 
E02000476,2012,Havering 013,Havering,E09000016,5964 ,2946 ,3018 
E02000477,2012,Havering 014,Havering,E09000016,6111 ,3009 ,3102 
E02000478,2012,Havering 015,Havering,E09000016,3711 ,1862 ,1849 
E02000479,2012,Havering 016,Havering,E09000016,5822 ,2852 ,2970 
E02000480,2012,Havering 017,Havering,E09000016,6732 ,3280 ,3452 
E02000481,2012,Havering 018,Havering,E09000016,4642 ,2230 ,2412 
E02000482,2012,Havering 019,Havering,E09000016,3860 ,1932 ,1928 
E02000483,2012,Havering 020,Havering,E09000016,4854 ,2410 ,2444 
E02000484,2012,Havering 021,Havering,E09000016,5607 ,2827 ,2780 
E02000485,2012,Havering 022,Havering,E09000016,5196 ,2570 ,2626 
E02000486,2012,Havering 023,Havering,E09000016,4792 ,2367 ,2425 
E02000487,2012,Havering 024,Havering,E09000016,4817 ,2404 ,2413 
E02000488,2012,Havering 025,Havering,E09000016,4864 ,2386 ,2478 
E02000489,2012,Havering 026,Havering,E09000016,5093 ,2504 ,2589 
E02000490,2012,Havering 027,Havering,E09000016,4876 ,2367 ,2509 
E02000491,2012,Havering 028,Havering,E09000016,5575 ,2793 ,2782 
E02000492,2012,Havering 029,Havering,E09000016,3940 ,1977 ,1963 
E02000493,2012,Havering 030,Havering,E09000016,4123 ,1950 ,2173 
E02000494,2012,Hillingdon 001,Hillingdon,E09000017,4733 ,2247 ,2486 
E02000495,2012,Hillingdon 002,Hillingdon,E09000017,6327 ,3048 ,3279 
E02000496,2012,Hillingdon 003,Hillingdon,E09000017,4831 ,2369 ,2462 
E02000497,2012,Hillingdon 004,Hillingdon,E09000017,5667 ,2770 ,2897 
E02000498,2012,Hillingdon 005,Hillingdon,E09000017,3893 ,1889 ,2004 
E02000499,2012,Hillingdon 006,Hillingdon,E09000017,4886 ,2409 ,2477 
E02000500,2012,Hillingdon 007,Hillingdon,E09000017,5085 ,2553 ,2532 
E02000501,2012,Hillingdon 008,Hillingdon,E09000017,5375 ,2601 ,2774 
E02000502,2012,Hillingdon 009,Hillingdon,E09000017,5079 ,2521 ,2558 
E02000503,2012,Hillingdon 010,Hillingdon,E09000017,6296 ,3226 ,3070 
E02000504,2012,Hillingdon 011,Hillingdon,E09000017,4496 ,2226 ,2270 
E02000506,2012,Hillingdon 013,Hillingdon,E09000017,4957 ,2479 ,2478 
E02000507,2012,Hillingdon 014,Hillingdon,E09000017,5271 ,2643 ,2628 
E02000508,2012,Hillingdon 015,Hillingdon,E09000017,7654 ,4190 ,3464 
E02000509,2012,Hillingdon 016,Hillingdon,E09000017,8323 ,4146 ,4177 
E02000510,2012,Hillingdon 017,Hillingdon,E09000017,5922 ,2988 ,2934 
E02000511,2012,Hillingdon 018,Hillingdon,E09000017,6332 ,3169 ,3163 
E02000512,2012,Hillingdon 019,Hillingdon,E09000017,5432 ,2705 ,2727 
E02000513,2012,Hillingdon 020,Hillingdon,E09000017,5733 ,2692 ,3041 
E02000514,2012,Hillingdon 021,Hillingdon,E09000017,6774 ,3495 ,3279 
E02000515,2012,Hillingdon 022,Hillingdon,E09000017,7716 ,3967 ,3749 
E02000516,2012,Hillingdon 023,Hillingdon,E09000017,5821 ,2871 ,2950 
E02000517,2012,Hillingdon 024,Hillingdon,E09000017,5929 ,2867 ,3062 
E02000518,2012,Hillingdon 025,Hillingdon,E09000017,5821 ,2881 ,2940 
E02000519,2012,Hillingdon 026,Hillingdon,E09000017,5974 ,3051 ,2923 
E02000520,2012,Hillingdon 027,Hillingdon,E09000017,7933 ,4067 ,3866 
E02000521,2012,Hillingdon 028,Hillingdon,E09000017,6952 ,3454 ,3498 
E02000522,2012,Hillingdon 029,Hillingdon,E09000017,5773 ,2785 ,2988 
E02000523,2012,Hillingdon 030,Hillingdon,E09000017,6792 ,3463 ,3329 
E02000524,2012,Hillingdon 031,Hillingdon,E09000017,4951 ,2761 ,2190 
E02000525,2012,Hillingdon 032,Hillingdon,E09000017,6252 ,3155 ,3097 
E02006796,2012,Hillingdon 033,Hillingdon,E09000017,5799 ,2849 ,2950 
E02000526,2012,Hounslow 001,Hounslow,E09000018,5970 ,2918 ,3052 
E02000528,2012,Hounslow 003,Hounslow,E09000018,7637 ,3764 ,3873 
E02000529,2012,Hounslow 004,Hounslow,E09000018,5827 ,2982 ,2845 
E02000530,2012,Hounslow 005,Hounslow,E09000018,4535 ,2261 ,2274 
E02000531,2012,Hounslow 006,Hounslow,E09000018,7632 ,3818 ,3814 
E02000532,2012,Hounslow 007,Hounslow,E09000018,6346 ,3157 ,3189 
E02000533,2012,Hounslow 008,Hounslow,E09000018,5807 ,2888 ,2919 
E02000534,2012,Hounslow 009,Hounslow,E09000018,5722 ,3012 ,2710 
E02000535,2012,Hounslow 010,Hounslow,E09000018,6435 ,3351 ,3084 
E02000536,2012,Hounslow 011,Hounslow,E09000018,6550 ,3400 ,3150 
E02000537,2012,Hounslow 012,Hounslow,E09000018,6323 ,3407 ,2916 
E02000538,2012,Hounslow 013,Hounslow,E09000018,6281 ,3298 ,2983 
E02000539,2012,Hounslow 014,Hounslow,E09000018,7723 ,3782 ,3941 
E02000540,2012,Hounslow 015,Hounslow,E09000018,6778 ,3686 ,3092 
E02000541,2012,Hounslow 016,Hounslow,E09000018,6194 ,3261 ,2933 
E02000542,2012,Hounslow 017,Hounslow,E09000018,6978 ,3711 ,3267 
E02000543,2012,Hounslow 018,Hounslow,E09000018,8896 ,4785 ,4111 
E02000544,2012,Hounslow 019,Hounslow,E09000018,5814 ,2933 ,2881 
E02000545,2012,Hounslow 020,Hounslow,E09000018,5773 ,2788 ,2985 
E02000546,2012,Hounslow 021,Hounslow,E09000018,6897 ,3641 ,3256 
E02000547,2012,Hounslow 022,Hounslow,E09000018,6506 ,3264 ,3242 
E02000548,2012,Hounslow 023,Hounslow,E09000018,6284 ,3122 ,3162 
E02000549,2012,Hounslow 024,Hounslow,E09000018,7522 ,3832 ,3690 
E02000550,2012,Hounslow 025,Hounslow,E09000018,7252 ,3573 ,3679 
E02000551,2012,Hounslow 026,Hounslow,E09000018,5798 ,2841 ,2957 
E02000552,2012,Hounslow 027,Hounslow,E09000018,5931 ,3073 ,2858 
E02000553,2012,Hounslow 028,Hounslow,E09000018,4365 ,2121 ,2244 
E02006792,2012,Hounslow 029,Hounslow,E09000018,6227 ,3199 ,3028 
E02000554,2012,Islington 001,Islington,E09000019,6768 ,3208 ,3560 
E02000555,2012,Islington 002,Islington,E09000019,6822 ,3237 ,3585 
E02000556,2012,Islington 003,Islington,E09000019,7711 ,3803 ,3908 
E02000557,2012,Islington 004,Islington,E09000019,6014 ,2908 ,3106 
E02000558,2012,Islington 005,Islington,E09000019,6109 ,3035 ,3074 
E02000559,2012,Islington 006,Islington,E09000019,7036 ,3664 ,3372 
E02000560,2012,Islington 007,Islington,E09000019,5853 ,3028 ,2825 
E02000561,2012,Islington 008,Islington,E09000019,5996 ,2913 ,3083 
E02000562,2012,Islington 009,Islington,E09000019,5802 ,2813 ,2989 
E02000563,2012,Islington 010,Islington,E09000019,6417 ,3078 ,3339 
E02000564,2012,Islington 011,Islington,E09000019,8678 ,4347 ,4331 
E02000565,2012,Islington 012,Islington,E09000019,6086 ,2851 ,3235 
E02000566,2012,Islington 013,Islington,E09000019,6378 ,3097 ,3281 
E02000567,2012,Islington 014,Islington,E09000019,8094 ,3850 ,4244 
E02000568,2012,Islington 015,Islington,E09000019,7717 ,4139 ,3578 
E02000569,2012,Islington 016,Islington,E09000019,7531 ,3574 ,3957 
E02000570,2012,Islington 017,Islington,E09000019,7063 ,3552 ,3511 
E02000571,2012,Islington 018,Islington,E09000019,6027 ,3009 ,3018 
E02000572,2012,Islington 019,Islington,E09000019,6205 ,2939 ,3266 
E02000573,2012,Islington 020,Islington,E09000019,7145 ,3668 ,3477 
E02000574,2012,Islington 021,Islington,E09000019,7104 ,3574 ,3530 
E02000575,2012,Islington 022,Islington,E09000019,10213 ,5421 ,4792 
E02000576,2012,Islington 023,Islington,E09000019,7299 ,3855 ,3444 
E02000577,2012,Kensington and Chelsea 001,Kensington and Chelsea,E09000020,5004 ,2451 ,2553 
E02000578,2012,Kensington and Chelsea 002,Kensington and Chelsea,E09000020,3866 ,1830 ,2036 
E02000579,2012,Kensington and Chelsea 003,Kensington and Chelsea,E09000020,5985 ,2864 ,3121 
E02000580,2012,Kensington and Chelsea 004,Kensington and Chelsea,E09000020,6388 ,3121 ,3267 
E02000581,2012,Kensington and Chelsea 005,Kensington and Chelsea,E09000020,4822 ,2261 ,2561 
E02000582,2012,Kensington and Chelsea 006,Kensington and Chelsea,E09000020,5389 ,2628 ,2761 
E02000583,2012,Kensington and Chelsea 007,Kensington and Chelsea,E09000020,5087 ,2374 ,2713 
E02000584,2012,Kensington and Chelsea 008,Kensington and Chelsea,E09000020,5630 ,2680 ,2950 
E02000585,2012,Kensington and Chelsea 009,Kensington and Chelsea,E09000020,5824 ,2823 ,3001 
E02000586,2012,Kensington and Chelsea 010,Kensington and Chelsea,E09000020,5542 ,2740 ,2802 
E02000587,2012,Kensington and Chelsea 011,Kensington and Chelsea,E09000020,5062 ,2535 ,2527 
E02000588,2012,Kensington and Chelsea 012,Kensington and Chelsea,E09000020,6232 ,3264 ,2968 
E02000589,2012,Kensington and Chelsea 013,Kensington and Chelsea,E09000020,6400 ,3451 ,2949 
E02000590,2012,Kensington and Chelsea 014,Kensington and Chelsea,E09000020,5055 ,2380 ,2675 
E02000591,2012,Kensington and Chelsea 015,Kensington and Chelsea,E09000020,5033 ,2578 ,2455 
E02000592,2012,Kensington and Chelsea 016,Kensington and Chelsea,E09000020,4918 ,2435 ,2483 
E02000593,2012,Kensington and Chelsea 017,Kensington and Chelsea,E09000020,5407 ,2818 ,2589 
E02000594,2012,Kensington and Chelsea 018,Kensington and Chelsea,E09000020,4984 ,2477 ,2507 
E02000595,2012,Kensington and Chelsea 019,Kensington and Chelsea,E09000020,5172 ,2481 ,2691 
E02000596,2012,Kensington and Chelsea 020,Kensington and Chelsea,E09000020,5780 ,2874 ,2906 
E02000597,2012,Kensington and Chelsea 021,Kensington and Chelsea,E09000020,4985 ,2374 ,2611 
E02000598,2012,Kingston upon Thames 001,Kingston upon Thames,E09000021,5014 ,2391 ,2623 
E02000599,2012,Kingston upon Thames 002,Kingston upon Thames,E09000021,4883 ,2342 ,2541 
E02000600,2012,Kingston upon Thames 003,Kingston upon Thames,E09000021,5996 ,2902 ,3094 
E02000601,2012,Kingston upon Thames 004,Kingston upon Thames,E09000021,7513 ,3702 ,3811 
E02000602,2012,Kingston upon Thames 005,Kingston upon Thames,E09000021,7259 ,3619 ,3640 
E02000603,2012,Kingston upon Thames 006,Kingston upon Thames,E09000021,5538 ,2647 ,2891 
E02000604,2012,Kingston upon Thames 007,Kingston upon Thames,E09000021,5820 ,2921 ,2899 
E02000605,2012,Kingston upon Thames 008,Kingston upon Thames,E09000021,5380 ,2651 ,2729 
E02000606,2012,Kingston upon Thames 009,Kingston upon Thames,E09000021,8298 ,4259 ,4039 
E02000607,2012,Kingston upon Thames 010,Kingston upon Thames,E09000021,5012 ,2462 ,2550 
E02000608,2012,Kingston upon Thames 011,Kingston upon Thames,E09000021,5610 ,2834 ,2776 
E02000609,2012,Kingston upon Thames 012,Kingston upon Thames,E09000021,4794 ,2381 ,2413 
E02000610,2012,Kingston upon Thames 013,Kingston upon Thames,E09000021,5738 ,2933 ,2805 
E02000611,2012,Kingston upon Thames 014,Kingston upon Thames,E09000021,4659 ,2314 ,2345 
E02000612,2012,Kingston upon Thames 015,Kingston upon Thames,E09000021,5349 ,2591 ,2758 
E02000613,2012,Kingston upon Thames 016,Kingston upon Thames,E09000021,5311 ,2550 ,2761 
E02000614,2012,Kingston upon Thames 017,Kingston upon Thames,E09000021,5821 ,2907 ,2914 
E02000615,2012,Kingston upon Thames 018,Kingston upon Thames,E09000021,5082 ,2544 ,2538 
E02000616,2012,Kingston upon Thames 019,Kingston upon Thames,E09000021,4122 ,2065 ,2057 
E02000617,2012,Kingston upon Thames 020,Kingston upon Thames,E09000021,5724 ,2783 ,2941 
E02000619,2012,Lambeth 002,Lambeth,E09000022,6099 ,3135 ,2964 
E02000620,2012,Lambeth 003,Lambeth,E09000022,7420 ,3986 ,3434 
E02000621,2012,Lambeth 004,Lambeth,E09000022,8584 ,4680 ,3904 
E02000622,2012,Lambeth 005,Lambeth,E09000022,6638 ,3620 ,3018 
E02000623,2012,Lambeth 006,Lambeth,E09000022,5935 ,3062 ,2873 
E02000624,2012,Lambeth 007,Lambeth,E09000022,6352 ,3281 ,3071 
E02000625,2012,Lambeth 008,Lambeth,E09000022,6239 ,3217 ,3022 
E02000626,2012,Lambeth 009,Lambeth,E09000022,5979 ,2953 ,3026 
E02000627,2012,Lambeth 010,Lambeth,E09000022,7416 ,3713 ,3703 
E02000628,2012,Lambeth 011,Lambeth,E09000022,7091 ,3568 ,3523 
E02000629,2012,Lambeth 012,Lambeth,E09000022,7560 ,3876 ,3684 
E02000630,2012,Lambeth 013,Lambeth,E09000022,5847 ,2946 ,2901 
E02000631,2012,Lambeth 014,Lambeth,E09000022,6756 ,3302 ,3454 
E02000632,2012,Lambeth 015,Lambeth,E09000022,8240 ,4160 ,4080 
E02000633,2012,Lambeth 016,Lambeth,E09000022,6792 ,3329 ,3463 
E02000634,2012,Lambeth 017,Lambeth,E09000022,5355 ,2642 ,2713 
E02000635,2012,Lambeth 018,Lambeth,E09000022,7312 ,3665 ,3647 
E02000636,2012,Lambeth 019,Lambeth,E09000022,6178 ,3096 ,3082 
E02000637,2012,Lambeth 020,Lambeth,E09000022,7143 ,3646 ,3497 
E02000638,2012,Lambeth 021,Lambeth,E09000022,7711 ,4035 ,3676 
E02000639,2012,Lambeth 022,Lambeth,E09000022,5609 ,2654 ,2955 
E02000640,2012,Lambeth 023,Lambeth,E09000022,7014 ,3351 ,3663 
E02000641,2012,Lambeth 024,Lambeth,E09000022,6190 ,2897 ,3293 
E02000642,2012,Lambeth 025,Lambeth,E09000022,6753 ,3316 ,3437 
E02000643,2012,Lambeth 026,Lambeth,E09000022,6378 ,3068 ,3310 
E02000644,2012,Lambeth 027,Lambeth,E09000022,6363 ,3183 ,3180 
E02000645,2012,Lambeth 028,Lambeth,E09000022,6760 ,3325 ,3435 
E02000646,2012,Lambeth 029,Lambeth,E09000022,7295 ,3718 ,3577 
E02000647,2012,Lambeth 030,Lambeth,E09000022,5842 ,2919 ,2923 
E02000648,2012,Lambeth 031,Lambeth,E09000022,5145 ,2278 ,2867 
E02000649,2012,Lambeth 032,Lambeth,E09000022,8810 ,4364 ,4446 
E02000650,2012,Lambeth 033,Lambeth,E09000022,5314 ,2470 ,2844 
E02000651,2012,Lambeth 034,Lambeth,E09000022,6459 ,3254 ,3205 
E02000652,2012,Lambeth 035,Lambeth,E09000022,5160 ,2587 ,2573 
E02006801,2012,Lambeth 036,Lambeth,E09000022,6867 ,3660 ,3207 
E02000653,2012,Lewisham 001,Lewisham,E09000023,6478 ,3387 ,3091 
E02000654,2012,Lewisham 002,Lewisham,E09000023,5527 ,2630 ,2897 
E02000655,2012,Lewisham 003,Lewisham,E09000023,6369 ,3158 ,3211 
E02000657,2012,Lewisham 005,Lewisham,E09000023,7520 ,3743 ,3777 
E02000658,2012,Lewisham 006,Lewisham,E09000023,6469 ,3409 ,3060 
E02000659,2012,Lewisham 007,Lewisham,E09000023,5530 ,2696 ,2834 
E02000660,2012,Lewisham 008,Lewisham,E09000023,6613 ,3309 ,3304 
E02000661,2012,Lewisham 009,Lewisham,E09000023,4783 ,2434 ,2349 
E02000662,2012,Lewisham 010,Lewisham,E09000023,6106 ,2979 ,3127 
E02000663,2012,Lewisham 011,Lewisham,E09000023,5568 ,2956 ,2612 
E02000664,2012,Lewisham 012,Lewisham,E09000023,7431 ,3712 ,3719 
E02000665,2012,Lewisham 013,Lewisham,E09000023,5874 ,2990 ,2884 
E02000666,2012,Lewisham 014,Lewisham,E09000023,5322 ,2540 ,2782 
E02000667,2012,Lewisham 015,Lewisham,E09000023,4702 ,2309 ,2393 
E02000668,2012,Lewisham 016,Lewisham,E09000023,4646 ,2317 ,2329 
E02000669,2012,Lewisham 017,Lewisham,E09000023,5715 ,2897 ,2818 
E02000670,2012,Lewisham 018,Lewisham,E09000023,4513 ,2151 ,2362 
E02000671,2012,Lewisham 019,Lewisham,E09000023,6122 ,2973 ,3149 
E02000672,2012,Lewisham 020,Lewisham,E09000023,5977 ,3153 ,2824 
E02000673,2012,Lewisham 021,Lewisham,E09000023,5772 ,2926 ,2846 
E02000674,2012,Lewisham 022,Lewisham,E09000023,5566 ,2565 ,3001 
E02000675,2012,Lewisham 023,Lewisham,E09000023,5543 ,2616 ,2927 
E02000676,2012,Lewisham 024,Lewisham,E09000023,5629 ,2754 ,2875 
E02000677,2012,Lewisham 025,Lewisham,E09000023,5000 ,2460 ,2540 
E02000678,2012,Lewisham 026,Lewisham,E09000023,3997 ,1857 ,2140 
E02000679,2012,Lewisham 027,Lewisham,E09000023,5539 ,2731 ,2808 
E02000680,2012,Lewisham 028,Lewisham,E09000023,4799 ,2392 ,2407 
E02000681,2012,Lewisham 029,Lewisham,E09000023,5443 ,2529 ,2914 
E02000682,2012,Lewisham 030,Lewisham,E09000023,5333 ,2529 ,2804 
E02000683,2012,Lewisham 031,Lewisham,E09000023,4232 ,1960 ,2272 
E02000685,2012,Lewisham 033,Lewisham,E09000023,5161 ,2468 ,2693 
E02000686,2012,Lewisham 034,Lewisham,E09000023,4443 ,2023 ,2420 
E02000687,2012,Lewisham 035,Lewisham,E09000023,5589 ,2843 ,2746 
E02006783,2012,Lewisham 037,Lewisham,E09000023,4637 ,2065 ,2572 
E02006784,2012,Lewisham 038,Lewisham,E09000023,4854 ,2269 ,2585 
E02006798,2012,Lewisham 039,Lewisham,E09000023,5693 ,2810 ,2883 
E02000689,2012,Merton 001,Merton,E09000024,5623 ,2650 ,2973 
E02000690,2012,Merton 002,Merton,E09000024,3388 ,1658 ,1730 
E02000691,2012,Merton 003,Merton,E09000024,5604 ,2770 ,2834 
E02000692,2012,Merton 004,Merton,E09000024,5634 ,2836 ,2798 
E02000693,2012,Merton 005,Merton,E09000024,7368 ,3835 ,3533 
E02000694,2012,Merton 006,Merton,E09000024,6654 ,3249 ,3405 
E02000695,2012,Merton 007,Merton,E09000024,5853 ,3131 ,2722 
E02000696,2012,Merton 008,Merton,E09000024,6115 ,3093 ,3022 
E02000697,2012,Merton 009,Merton,E09000024,6437 ,3250 ,3187 
E02000698,2012,Merton 010,Merton,E09000024,5079 ,2469 ,2610 
E02000699,2012,Merton 011,Merton,E09000024,5531 ,2688 ,2843 
E02000700,2012,Merton 012,Merton,E09000024,6129 ,2951 ,3178 
E02000701,2012,Merton 013,Merton,E09000024,5774 ,2867 ,2907 
E02000702,2012,Merton 014,Merton,E09000024,5264 ,2564 ,2700 
E02000703,2012,Merton 015,Merton,E09000024,5123 ,2593 ,2530 
E02000704,2012,Merton 016,Merton,E09000024,5667 ,2812 ,2855 
E02000705,2012,Merton 017,Merton,E09000024,5547 ,2721 ,2826 
E02000706,2012,Merton 018,Merton,E09000024,5804 ,2761 ,3043 
E02000707,2012,Merton 019,Merton,E09000024,4969 ,2378 ,2591 
E02000708,2012,Merton 020,Merton,E09000024,5479 ,2701 ,2778 
E02000709,2012,Merton 021,Merton,E09000024,5013 ,2515 ,2498 
E02000710,2012,Merton 022,Merton,E09000024,5555 ,2729 ,2826 
E02000711,2012,Merton 023,Merton,E09000024,5684 ,2883 ,2801 
E02000712,2012,Merton 024,Merton,E09000024,5737 ,2866 ,2871 
E02000713,2012,Merton 025,Merton,E09000024,4974 ,2480 ,2494 
E02000714,2012,Newham 001,Newham,E09000025,5778 ,3036 ,2742 
E02000715,2012,Newham 002,Newham,E09000025,5031 ,2731 ,2300 
E02000716,2012,Newham 003,Newham,E09000025,5259 ,2898 ,2361 
E02000717,2012,Newham 004,Newham,E09000025,5813 ,3230 ,2583 
E02000718,2012,Newham 005,Newham,E09000025,4501 ,2242 ,2259 
E02000719,2012,Newham 006,Newham,E09000025,6155 ,3223 ,2932 
E02000720,2012,Newham 007,Newham,E09000025,5429 ,3033 ,2396 
E02000721,2012,Newham 008,Newham,E09000025,7006 ,3919 ,3087 
E02000722,2012,Newham 009,Newham,E09000025,6378 ,3369 ,3009 
E02000723,2012,Newham 010,Newham,E09000025,8008 ,4520 ,3488 
E02000724,2012,Newham 011,Newham,E09000025,6771 ,3839 ,2932 
E02000725,2012,Newham 012,Newham,E09000025,7063 ,3654 ,3409 
E02000726,2012,Newham 013,Newham,E09000025,7204 ,3870 ,3334 
E02000727,2012,Newham 014,Newham,E09000025,6225 ,3684 ,2541 
E02000728,2012,Newham 015,Newham,E09000025,5869 ,3298 ,2571 
E02000729,2012,Newham 016,Newham,E09000025,5143 ,2724 ,2419 
E02000730,2012,Newham 017,Newham,E09000025,6553 ,3724 ,2829 
E02000731,2012,Newham 018,Newham,E09000025,7405 ,4462 ,2943 
E02000732,2012,Newham 019,Newham,E09000025,5172 ,2872 ,2300 
E02000733,2012,Newham 020,Newham,E09000025,6820 ,3527 ,3293 
E02000734,2012,Newham 021,Newham,E09000025,5445 ,2808 ,2637 
E02000735,2012,Newham 022,Newham,E09000025,5439 ,3034 ,2405 
E02000736,2012,Newham 023,Newham,E09000025,5757 ,2966 ,2791 
E02000737,2012,Newham 024,Newham,E09000025,6323 ,3228 ,3095 
E02000738,2012,Newham 025,Newham,E09000025,5885 ,3148 ,2737 
E02000739,2012,Newham 026,Newham,E09000025,5020 ,2594 ,2426 
E02000740,2012,Newham 027,Newham,E09000025,4868 ,2470 ,2398 
E02000741,2012,Newham 028,Newham,E09000025,5744 ,2964 ,2780 
E02000742,2012,Newham 029,Newham,E09000025,5355 ,2711 ,2644 
E02000743,2012,Newham 030,Newham,E09000025,5543 ,2856 ,2687 
E02000744,2012,Newham 031,Newham,E09000025,5625 ,2828 ,2797 
E02000745,2012,Newham 032,Newham,E09000025,5885 ,2867 ,3018 
E02000746,2012,Newham 033,Newham,E09000025,5780 ,2742 ,3038 
E02000747,2012,Newham 034,Newham,E09000025,8241 ,4355 ,3886 
E02000748,2012,Newham 035,Newham,E09000025,4427 ,2091 ,2336 
E02000749,2012,Newham 036,Newham,E09000025,5536 ,2631 ,2905 
E02000750,2012,Newham 037,Newham,E09000025,8290 ,4318 ,3972 
E02000751,2012,Redbridge 001,Redbridge,E09000026,6629 ,3238 ,3391 
E02000752,2012,Redbridge 002,Redbridge,E09000026,4378 ,2054 ,2324 
E02000753,2012,Redbridge 003,Redbridge,E09000026,3911 ,1834 ,2077 
E02000754,2012,Redbridge 004,Redbridge,E09000026,4461 ,2152 ,2309 
E02000755,2012,Redbridge 005,Redbridge,E09000026,3495 ,1692 ,1803 
E02000756,2012,Redbridge 006,Redbridge,E09000026,8585 ,4152 ,4433 
E02000757,2012,Redbridge 007,Redbridge,E09000026,8399 ,4151 ,4248 
E02000758,2012,Redbridge 008,Redbridge,E09000026,3848 ,1862 ,1986 
E02000759,2012,Redbridge 009,Redbridge,E09000026,8352 ,4034 ,4318 
E02000760,2012,Redbridge 010,Redbridge,E09000026,4450 ,2158 ,2292 
E02000762,2012,Redbridge 012,Redbridge,E09000026,4170 ,2090 ,2080 
E02000763,2012,Redbridge 013,Redbridge,E09000026,4550 ,2220 ,2330 
E02000764,2012,Redbridge 014,Redbridge,E09000026,8145 ,3980 ,4165 
E02000765,2012,Redbridge 015,Redbridge,E09000026,4204 ,2114 ,2090 
E02000767,2012,Redbridge 017,Redbridge,E09000026,5025 ,2451 ,2574 
E02000768,2012,Redbridge 018,Redbridge,E09000026,3728 ,1792 ,1936 
E02000769,2012,Redbridge 019,Redbridge,E09000026,9599 ,4614 ,4985 
E02000770,2012,Redbridge 020,Redbridge,E09000026,4959 ,2509 ,2450 
E02000772,2012,Redbridge 022,Redbridge,E09000026,5498 ,2837 ,2661 
E02000773,2012,Redbridge 023,Redbridge,E09000026,6318 ,3110 ,3208 
E02000774,2012,Redbridge 024,Redbridge,E09000026,4987 ,2615 ,2372 
E02000776,2012,Redbridge 026,Redbridge,E09000026,4358 ,2188 ,2170 
E02000777,2012,Redbridge 027,Redbridge,E09000026,3944 ,1884 ,2060 
E02000779,2012,Redbridge 029,Redbridge,E09000026,5495 ,2939 ,2556 
E02000780,2012,Redbridge 030,Redbridge,E09000026,10103 ,5244 ,4859 
E02000781,2012,Redbridge 031,Redbridge,E09000026,9152 ,4625 ,4527 
E02000782,2012,Redbridge 032,Redbridge,E09000026,6341 ,3280 ,3061 
E02000783,2012,Redbridge 033,Redbridge,E09000026,4594 ,2353 ,2241 
E02006800,2012,Redbridge 034,Redbridge,E09000026,9339 ,4820 ,4519 
E02006924,2012,Redbridge 035,Redbridge,E09000026,8600 ,4503 ,4097 
E02006925,2012,Redbridge 036,Redbridge,E09000026,8664 ,4208 ,4456 
E02000784,2012,Richmond upon Thames 001,Richmond upon Thames,E09000027,6795 ,3275 ,3520 
E02000785,2012,Richmond upon Thames 002,Richmond upon Thames,E09000027,6424 ,3166 ,3258 
E02000786,2012,Richmond upon Thames 003,Richmond upon Thames,E09000027,7589 ,3620 ,3969 
E02000787,2012,Richmond upon Thames 004,Richmond upon Thames,E09000027,7507 ,3671 ,3836 
E02000788,2012,Richmond upon Thames 005,Richmond upon Thames,E09000027,5811 ,2818 ,2993 
E02000789,2012,Richmond upon Thames 006,Richmond upon Thames,E09000027,4299 ,2134 ,2165 
E02000790,2012,Richmond upon Thames 007,Richmond upon Thames,E09000027,4330 ,2142 ,2188 
E02000791,2012,Richmond upon Thames 008,Richmond upon Thames,E09000027,4586 ,2363 ,2223 
E02000792,2012,Richmond upon Thames 009,Richmond upon Thames,E09000027,4756 ,2395 ,2361 
E02000793,2012,Richmond upon Thames 010,Richmond upon Thames,E09000027,5322 ,2645 ,2677 
E02000794,2012,Richmond upon Thames 011,Richmond upon Thames,E09000027,4579 ,2314 ,2265 
E02000795,2012,Richmond upon Thames 012,Richmond upon Thames,E09000027,3923 ,1906 ,2017 
E02000796,2012,Richmond upon Thames 013,Richmond upon Thames,E09000027,6809 ,3387 ,3422 
E02000797,2012,Richmond upon Thames 014,Richmond upon Thames,E09000027,5274 ,2657 ,2617 
E02000798,2012,Richmond upon Thames 015,Richmond upon Thames,E09000027,7166 ,3478 ,3688 
E02000799,2012,Richmond upon Thames 016,Richmond upon Thames,E09000027,4623 ,2231 ,2392 
E02000800,2012,Richmond upon Thames 017,Richmond upon Thames,E09000027,3426 ,1686 ,1740 
E02000801,2012,Richmond upon Thames 018,Richmond upon Thames,E09000027,4525 ,2175 ,2350 
E02000802,2012,Richmond upon Thames 019,Richmond upon Thames,E09000027,4538 ,2227 ,2311 
E02000803,2012,Richmond upon Thames 020,Richmond upon Thames,E09000027,6078 ,2883 ,3195 
E02000804,2012,Richmond upon Thames 021,Richmond upon Thames,E09000027,4782 ,2313 ,2469 
E02000805,2012,Richmond upon Thames 022,Richmond upon Thames,E09000027,6934 ,3417 ,3517 
E02000806,2012,Richmond upon Thames 023,Richmond upon Thames,E09000027,6548 ,3173 ,3375 
E02000807,2012,Southwark 001,Southwark,E09000028,7332 ,3809 ,3523 
E02000808,2012,Southwark 002,Southwark,E09000028,7709 ,4061 ,3648 
E02000809,2012,Southwark 003,Southwark,E09000028,10611 ,5861 ,4750 
E02000810,2012,Southwark 004,Southwark,E09000028,7498 ,3742 ,3756 
E02000812,2012,Southwark 006,Southwark,E09000028,8192 ,4050 ,4142 
E02000813,2012,Southwark 007,Southwark,E09000028,6465 ,3136 ,3329 
E02000814,2012,Southwark 008,Southwark,E09000028,7306 ,3735 ,3571 
E02000815,2012,Southwark 009,Southwark,E09000028,5196 ,2742 ,2454 
E02000816,2012,Southwark 010,Southwark,E09000028,6849 ,3342 ,3507 
E02000817,2012,Southwark 011,Southwark,E09000028,4416 ,2177 ,2239 
E02000818,2012,Southwark 012,Southwark,E09000028,5586 ,2876 ,2710 
E02000819,2012,Southwark 013,Southwark,E09000028,6394 ,3176 ,3218 
E02000820,2012,Southwark 014,Southwark,E09000028,6804 ,3636 ,3168 
E02000821,2012,Southwark 015,Southwark,E09000028,5848 ,2859 ,2989 
E02000822,2012,Southwark 016,Southwark,E09000028,5646 ,2885 ,2761 
E02000823,2012,Southwark 017,Southwark,E09000028,5765 ,2869 ,2896 
E02000824,2012,Southwark 018,Southwark,E09000028,6641 ,3196 ,3445 
E02000825,2012,Southwark 019,Southwark,E09000028,6707 ,3188 ,3519 
E02000826,2012,Southwark 020,Southwark,E09000028,6599 ,3222 ,3377 
E02000827,2012,Southwark 021,Southwark,E09000028,7570 ,3825 ,3745 
E02000828,2012,Southwark 022,Southwark,E09000028,6102 ,3029 ,3073 
E02000829,2012,Southwark 023,Southwark,E09000028,7936 ,4178 ,3758 
E02000830,2012,Southwark 024,Southwark,E09000028,6841 ,3338 ,3503 
E02000831,2012,Southwark 025,Southwark,E09000028,7063 ,3451 ,3612 
E02000832,2012,Southwark 026,Southwark,E09000028,6952 ,3228 ,3724 
E02000833,2012,Southwark 027,Southwark,E09000028,5579 ,2528 ,3051 
E02000834,2012,Southwark 028,Southwark,E09000028,7101 ,3331 ,3770 
E02000835,2012,Southwark 029,Southwark,E09000028,5046 ,2414 ,2632 
E02000836,2012,Southwark 030,Southwark,E09000028,5923 ,2861 ,3062 
E02000837,2012,Southwark 031,Southwark,E09000028,5832 ,2804 ,3028 
E02000838,2012,Southwark 032,Southwark,E09000028,6601 ,3088 ,3513 
E02000839,2012,Southwark 033,Southwark,E09000028,5431 ,2602 ,2829 
E02006802,2012,Southwark 034,Southwark,E09000028,6257 ,3222 ,3035 
E02000840,2012,Sutton 001,Sutton,E09000029,5557 ,2621 ,2936 
E02000841,2012,Sutton 002,Sutton,E09000029,5881 ,2781 ,3100 
E02000842,2012,Sutton 003,Sutton,E09000029,5075 ,2507 ,2568 
E02000843,2012,Sutton 004,Sutton,E09000029,5260 ,2553 ,2707 
E02000844,2012,Sutton 005,Sutton,E09000029,5278 ,2528 ,2750 
E02000845,2012,Sutton 006,Sutton,E09000029,6308 ,3031 ,3277 
E02000846,2012,Sutton 007,Sutton,E09000029,4572 ,2257 ,2315 
E02000847,2012,Sutton 008,Sutton,E09000029,5672 ,2827 ,2845 
E02000848,2012,Sutton 009,Sutton,E09000029,5097 ,2541 ,2556 
E02000849,2012,Sutton 010,Sutton,E09000029,5144 ,2512 ,2632 
E02000850,2012,Sutton 011,Sutton,E09000029,6928 ,3437 ,3491 
E02000851,2012,Sutton 012,Sutton,E09000029,5917 ,3024 ,2893 
E02000852,2012,Sutton 013,Sutton,E09000029,5213 ,2551 ,2662 
E02000853,2012,Sutton 014,Sutton,E09000029,5191 ,2511 ,2680 
E02000854,2012,Sutton 015,Sutton,E09000029,4787 ,2352 ,2435 
E02000855,2012,Sutton 016,Sutton,E09000029,5029 ,2497 ,2532 
E02000856,2012,Sutton 017,Sutton,E09000029,5773 ,2836 ,2937 
E02000857,2012,Sutton 018,Sutton,E09000029,5585 ,2829 ,2756 
E02000858,2012,Sutton 019,Sutton,E09000029,5103 ,2342 ,2761 
E02000859,2012,Sutton 020,Sutton,E09000029,5205 ,2487 ,2718 
E02000860,2012,Sutton 021,Sutton,E09000029,5475 ,2807 ,2668 
E02000861,2012,Sutton 022,Sutton,E09000029,4896 ,2390 ,2506 
E02000863,2012,Sutton 024,Sutton,E09000029,4048 ,1969 ,2079 
E02006836,2012,Sutton 025,Sutton,E09000029,5184 ,2555 ,2629 
E02000864,2012,Tower Hamlets 001,Tower Hamlets,E09000030,5905 ,2896 ,3009 
E02000865,2012,Tower Hamlets 002,Tower Hamlets,E09000030,5242 ,2576 ,2666 
E02000866,2012,Tower Hamlets 003,Tower Hamlets,E09000030,7152 ,3531 ,3621 
E02000867,2012,Tower Hamlets 004,Tower Hamlets,E09000030,7971 ,4033 ,3938 
E02000868,2012,Tower Hamlets 005,Tower Hamlets,E09000030,5319 ,2731 ,2588 
E02000869,2012,Tower Hamlets 006,Tower Hamlets,E09000030,4286 ,2251 ,2035 
E02000870,2012,Tower Hamlets 007,Tower Hamlets,E09000030,4701 ,2310 ,2391 
E02000871,2012,Tower Hamlets 008,Tower Hamlets,E09000030,6272 ,3201 ,3071 
E02000872,2012,Tower Hamlets 009,Tower Hamlets,E09000030,6048 ,3219 ,2829 
E02000873,2012,Tower Hamlets 010,Tower Hamlets,E09000030,6598 ,3220 ,3378 
E02000874,2012,Tower Hamlets 011,Tower Hamlets,E09000030,5124 ,2596 ,2528 
E02000875,2012,Tower Hamlets 012,Tower Hamlets,E09000030,7135 ,3621 ,3514 
E02000876,2012,Tower Hamlets 013,Tower Hamlets,E09000030,5723 ,3037 ,2686 
E02000877,2012,Tower Hamlets 014,Tower Hamlets,E09000030,7194 ,3676 ,3518 
E02000878,2012,Tower Hamlets 015,Tower Hamlets,E09000030,8825 ,4654 ,4171 
E02000879,2012,Tower Hamlets 016,Tower Hamlets,E09000030,5482 ,2799 ,2683 
E02000880,2012,Tower Hamlets 017,Tower Hamlets,E09000030,4311 ,2292 ,2019 
E02000881,2012,Tower Hamlets 018,Tower Hamlets,E09000030,4659 ,2313 ,2346 
E02000882,2012,Tower Hamlets 019,Tower Hamlets,E09000030,5849 ,2946 ,2903 
E02000883,2012,Tower Hamlets 020,Tower Hamlets,E09000030,5330 ,2721 ,2609 
E02000884,2012,Tower Hamlets 021,Tower Hamlets,E09000030,7602 ,4349 ,3253 
E02000885,2012,Tower Hamlets 022,Tower Hamlets,E09000030,4708 ,2458 ,2250 
E02000886,2012,Tower Hamlets 023,Tower Hamlets,E09000030,5672 ,3134 ,2538 
E02000887,2012,Tower Hamlets 024,Tower Hamlets,E09000030,6007 ,3036 ,2971 
E02000888,2012,Tower Hamlets 025,Tower Hamlets,E09000030,6228 ,3429 ,2799 
E02000889,2012,Tower Hamlets 026,Tower Hamlets,E09000030,5270 ,2943 ,2327 
E02000890,2012,Tower Hamlets 027,Tower Hamlets,E09000030,4864 ,2699 ,2165 
E02000891,2012,Tower Hamlets 028,Tower Hamlets,E09000030,10768 ,5830 ,4938 
E02000893,2012,Tower Hamlets 030,Tower Hamlets,E09000030,5127 ,2599 ,2528 
E02000894,2012,Tower Hamlets 031,Tower Hamlets,E09000030,8741 ,4637 ,4104 
E02006853,2012,Tower Hamlets 032,Tower Hamlets,E09000030,6061 ,3174 ,2887 
E02006854,2012,Tower Hamlets 033,Tower Hamlets,E09000030,5433 ,3039 ,2394 
E02000895,2012,Waltham Forest 001,Waltham Forest,E09000031,4762 ,2274 ,2488 
E02000896,2012,Waltham Forest 002,Waltham Forest,E09000031,5704 ,2810 ,2894 
E02000897,2012,Waltham Forest 003,Waltham Forest,E09000031,5144 ,2418 ,2726 
E02000898,2012,Waltham Forest 004,Waltham Forest,E09000031,4994 ,2432 ,2562 
E02000899,2012,Waltham Forest 005,Waltham Forest,E09000031,5266 ,2571 ,2695 
E02000900,2012,Waltham Forest 006,Waltham Forest,E09000031,5403 ,2569 ,2834 
E02000901,2012,Waltham Forest 007,Waltham Forest,E09000031,6319 ,3012 ,3307 
E02000902,2012,Waltham Forest 008,Waltham Forest,E09000031,5483 ,2671 ,2812 
E02000903,2012,Waltham Forest 009,Waltham Forest,E09000031,6127 ,2982 ,3145 
E02000904,2012,Waltham Forest 010,Waltham Forest,E09000031,5759 ,2893 ,2866 
E02000905,2012,Waltham Forest 011,Waltham Forest,E09000031,6848 ,3460 ,3388 
E02000906,2012,Waltham Forest 012,Waltham Forest,E09000031,6409 ,3211 ,3198 
E02000907,2012,Waltham Forest 013,Waltham Forest,E09000031,6725 ,3278 ,3447 
E02000908,2012,Waltham Forest 014,Waltham Forest,E09000031,7956 ,4317 ,3639 
E02000909,2012,Waltham Forest 015,Waltham Forest,E09000031,6161 ,3009 ,3152 
E02000910,2012,Waltham Forest 016,Waltham Forest,E09000031,7926 ,4082 ,3844 
E02000911,2012,Waltham Forest 017,Waltham Forest,E09000031,8127 ,4106 ,4021 
E02000912,2012,Waltham Forest 018,Waltham Forest,E09000031,6244 ,3074 ,3170 
E02000913,2012,Waltham Forest 019,Waltham Forest,E09000031,6204 ,3215 ,2989 
E02000914,2012,Waltham Forest 020,Waltham Forest,E09000031,7591 ,3888 ,3703 
E02000915,2012,Waltham Forest 021,Waltham Forest,E09000031,6649 ,3494 ,3155 
E02000916,2012,Waltham Forest 022,Waltham Forest,E09000031,6472 ,3262 ,3210 
E02000917,2012,Waltham Forest 023,Waltham Forest,E09000031,6552 ,3332 ,3220 
E02000918,2012,Waltham Forest 024,Waltham Forest,E09000031,6805 ,3585 ,3220 
E02000919,2012,Waltham Forest 025,Waltham Forest,E09000031,7020 ,3682 ,3338 
E02000920,2012,Waltham Forest 026,Waltham Forest,E09000031,7040 ,3544 ,3496 
E02000921,2012,Waltham Forest 027,Waltham Forest,E09000031,7928 ,4006 ,3922 
E02000922,2012,Waltham Forest 028,Waltham Forest,E09000031,7839 ,4330 ,3509 
E02000923,2012,Wandsworth 001,Wandsworth,E09000032,5850 ,3001 ,2849 
E02000924,2012,Wandsworth 002,Wandsworth,E09000032,9105 ,4505 ,4600 
E02000925,2012,Wandsworth 003,Wandsworth,E09000032,5690 ,2725 ,2965 
E02000926,2012,Wandsworth 004,Wandsworth,E09000032,7203 ,3612 ,3591 
E02000927,2012,Wandsworth 005,Wandsworth,E09000032,5487 ,2620 ,2867 
E02000928,2012,Wandsworth 006,Wandsworth,E09000032,6057 ,2876 ,3181 
E02000929,2012,Wandsworth 007,Wandsworth,E09000032,5070 ,2201 ,2869 
E02000930,2012,Wandsworth 008,Wandsworth,E09000032,8359 ,4018 ,4341 
E02000931,2012,Wandsworth 009,Wandsworth,E09000032,6905 ,3534 ,3371 
E02000932,2012,Wandsworth 010,Wandsworth,E09000032,8324 ,4068 ,4256 
E02000933,2012,Wandsworth 011,Wandsworth,E09000032,6197 ,2942 ,3255 
E02000934,2012,Wandsworth 012,Wandsworth,E09000032,7845 ,3967 ,3878 
E02000935,2012,Wandsworth 013,Wandsworth,E09000032,4935 ,2108 ,2827 
E02000936,2012,Wandsworth 014,Wandsworth,E09000032,6551 ,3124 ,3427 
E02000937,2012,Wandsworth 015,Wandsworth,E09000032,5669 ,2811 ,2858 
E02000938,2012,Wandsworth 016,Wandsworth,E09000032,6735 ,3144 ,3591 
E02000939,2012,Wandsworth 017,Wandsworth,E09000032,5347 ,2671 ,2676 
E02000940,2012,Wandsworth 018,Wandsworth,E09000032,5917 ,2853 ,3064 
E02000941,2012,Wandsworth 019,Wandsworth,E09000032,7387 ,3595 ,3792 
E02000942,2012,Wandsworth 020,Wandsworth,E09000032,6469 ,3044 ,3425 
E02000943,2012,Wandsworth 021,Wandsworth,E09000032,6481 ,3187 ,3294 
E02000944,2012,Wandsworth 022,Wandsworth,E09000032,4986 ,2285 ,2701 
E02000945,2012,Wandsworth 023,Wandsworth,E09000032,5704 ,2637 ,3067 
E02000946,2012,Wandsworth 024,Wandsworth,E09000032,6530 ,3535 ,2995 
E02000947,2012,Wandsworth 025,Wandsworth,E09000032,6123 ,2824 ,3299 
E02000948,2012,Wandsworth 026,Wandsworth,E09000032,7756 ,3619 ,4137 
E02000949,2012,Wandsworth 027,Wandsworth,E09000032,7026 ,3342 ,3684 
E02000950,2012,Wandsworth 028,Wandsworth,E09000032,5308 ,2497 ,2811 
E02000951,2012,Wandsworth 029,Wandsworth,E09000032,4979 ,2368 ,2611 
E02000952,2012,Wandsworth 030,Wandsworth,E09000032,4452 ,2114 ,2338 
E02000953,2012,Wandsworth 031,Wandsworth,E09000032,5667 ,2492 ,3175 
E02000954,2012,Wandsworth 032,Wandsworth,E09000032,4522 ,2111 ,2411 
E02000955,2012,Wandsworth 033,Wandsworth,E09000032,4610 ,2172 ,2438 
E02000956,2012,Wandsworth 034,Wandsworth,E09000032,5763 ,2720 ,3043 
E02000957,2012,Wandsworth 035,Wandsworth,E09000032,8069 ,4042 ,4027 
E02000958,2012,Wandsworth 036,Wandsworth,E09000032,5756 ,2809 ,2947 
E02000959,2012,Wandsworth 037,Wandsworth,E09000032,5384 ,2688 ,2696 
E02000960,2012,Westminster 001,Westminster,E09000033,4524 ,2178 ,2346 
E02000961,2012,Westminster 002,Westminster,E09000033,6515 ,3072 ,3443 
E02000962,2012,Westminster 003,Westminster,E09000033,5918 ,2886 ,3032 
E02000963,2012,Westminster 004,Westminster,E09000033,7196 ,3403 ,3793 
E02000964,2012,Westminster 005,Westminster,E09000033,9277 ,4450 ,4827 
E02000965,2012,Westminster 006,Westminster,E09000033,6634 ,3304 ,3330 
E02000966,2012,Westminster 007,Westminster,E09000033,7135 ,3557 ,3578 
E02000967,2012,Westminster 008,Westminster,E09000033,6021 ,3113 ,2908 
E02000968,2012,Westminster 009,Westminster,E09000033,9621 ,4691 ,4930 
E02000969,2012,Westminster 010,Westminster,E09000033,6237 ,3031 ,3206 
E02000970,2012,Westminster 011,Westminster,E09000033,7282 ,3895 ,3387 
E02000971,2012,Westminster 012,Westminster,E09000033,6517 ,3522 ,2995 
E02000972,2012,Westminster 013,Westminster,E09000033,7185 ,4188 ,2997 
E02000973,2012,Westminster 014,Westminster,E09000033,7721 ,3847 ,3874 
E02000974,2012,Westminster 015,Westminster,E09000033,6675 ,3747 ,2928 
E02000975,2012,Westminster 016,Westminster,E09000033,7328 ,3878 ,3450 
E02000976,2012,Westminster 017,Westminster,E09000033,7781 ,3996 ,3785 
E02000977,2012,Westminster 018,Westminster,E09000033,6795 ,4012 ,2783 
E02000978,2012,Westminster 019,Westminster,E09000033,7223 ,3908 ,3315 
E02000979,2012,Westminster 020,Westminster,E09000033,6388 ,3502 ,2886 
E02000980,2012,Westminster 021,Westminster,E09000033,6543 ,3385 ,3158 
E02000981,2012,Westminster 022,Westminster,E09000033,7305 ,3691 ,3614 
E02000982,2012,Westminster 023,Westminster,E09000033,5994 ,2992 ,3002 
E02000983,2012,Westminster 024,Westminster,E09000033,6089 ,3030 ,3059 
E02000001,2013,City of London 001,City of London,E09000001,5789 ,3270 ,2519 
E02000002,2013,Barking and Dagenham 001,Barking and Dagenham,E09000002,4127 ,1927 ,2200 
E02000003,2013,Barking and Dagenham 002,Barking and Dagenham,E09000002,6886 ,3388 ,3498 
E02000004,2013,Barking and Dagenham 003,Barking and Dagenham,E09000002,4126 ,1984 ,2142 
E02000005,2013,Barking and Dagenham 004,Barking and Dagenham,E09000002,5747 ,2752 ,2995 
E02000007,2013,Barking and Dagenham 006,Barking and Dagenham,E09000002,5697 ,2705 ,2992 
E02000008,2013,Barking and Dagenham 007,Barking and Dagenham,E09000002,7539 ,3542 ,3997 
E02000009,2013,Barking and Dagenham 008,Barking and Dagenham,E09000002,6094 ,2942 ,3152 
E02000010,2013,Barking and Dagenham 009,Barking and Dagenham,E09000002,5608 ,2648 ,2960 
E02000011,2013,Barking and Dagenham 010,Barking and Dagenham,E09000002,4017 ,2017 ,2000 
E02000012,2013,Barking and Dagenham 011,Barking and Dagenham,E09000002,6781 ,3381 ,3400 
E02000013,2013,Barking and Dagenham 012,Barking and Dagenham,E09000002,5311 ,2502 ,2809 
E02000014,2013,Barking and Dagenham 013,Barking and Dagenham,E09000002,5892 ,2754 ,3138 
E02000015,2013,Barking and Dagenham 014,Barking and Dagenham,E09000002,4824 ,2281 ,2543 
E02000016,2013,Barking and Dagenham 015,Barking and Dagenham,E09000002,5665 ,2992 ,2673 
E02000017,2013,Barking and Dagenham 016,Barking and Dagenham,E09000002,5892 ,3195 ,2697 
E02000018,2013,Barking and Dagenham 017,Barking and Dagenham,E09000002,5787 ,2782 ,3005 
E02000019,2013,Barking and Dagenham 018,Barking and Dagenham,E09000002,5591 ,2687 ,2904 
E02000020,2013,Barking and Dagenham 019,Barking and Dagenham,E09000002,6537 ,3268 ,3269 
E02000021,2013,Barking and Dagenham 020,Barking and Dagenham,E09000002,5355 ,2551 ,2804 
E02000022,2013,Barking and Dagenham 021,Barking and Dagenham,E09000002,5487 ,2701 ,2786 
E02000023,2013,Barking and Dagenham 022,Barking and Dagenham,E09000002,3992 ,1974 ,2018 
E02006799,2013,Barking and Dagenham 023,Barking and Dagenham,E09000002,6719 ,3230 ,3489 
E02000024,2013,Barnet 001,Barnet,E09000003,6706 ,3283 ,3423 
E02000025,2013,Barnet 002,Barnet,E09000003,5500 ,2687 ,2813 
E02000026,2013,Barnet 003,Barnet,E09000003,4130 ,1983 ,2147 
E02000027,2013,Barnet 004,Barnet,E09000003,6226 ,2945 ,3281 
E02000028,2013,Barnet 005,Barnet,E09000003,4161 ,2084 ,2077 
E02000029,2013,Barnet 006,Barnet,E09000003,5749 ,2802 ,2947 
E02000030,2013,Barnet 007,Barnet,E09000003,5807 ,2778 ,3029 
E02000031,2013,Barnet 008,Barnet,E09000003,4651 ,2293 ,2358 
E02000032,2013,Barnet 009,Barnet,E09000003,5115 ,2504 ,2611 
E02000033,2013,Barnet 010,Barnet,E09000003,5829 ,2843 ,2986 
E02000034,2013,Barnet 011,Barnet,E09000003,5671 ,2670 ,3001 
E02000035,2013,Barnet 012,Barnet,E09000003,5396 ,2601 ,2795 
E02000036,2013,Barnet 013,Barnet,E09000003,7165 ,3512 ,3653 
E02000037,2013,Barnet 014,Barnet,E09000003,5936 ,2845 ,3091 
E02000038,2013,Barnet 015,Barnet,E09000003,7608 ,3865 ,3743 
E02000039,2013,Barnet 016,Barnet,E09000003,4495 ,2180 ,2315 
E02000040,2013,Barnet 017,Barnet,E09000003,4595 ,2168 ,2427 
E02000041,2013,Barnet 018,Barnet,E09000003,5955 ,2966 ,2989 
E02000042,2013,Barnet 019,Barnet,E09000003,7665 ,3845 ,3820 
E02000043,2013,Barnet 020,Barnet,E09000003,4989 ,2404 ,2585 
E02000044,2013,Barnet 021,Barnet,E09000003,5522 ,2539 ,2983 
E02000045,2013,Barnet 022,Barnet,E09000003,7400 ,3603 ,3797 
E02000046,2013,Barnet 023,Barnet,E09000003,5329 ,2720 ,2609 
E02000047,2013,Barnet 024,Barnet,E09000003,7761 ,3775 ,3986 
E02000048,2013,Barnet 025,Barnet,E09000003,6560 ,3187 ,3373 
E02000049,2013,Barnet 026,Barnet,E09000003,5668 ,2600 ,3068 
E02000050,2013,Barnet 027,Barnet,E09000003,7187 ,3541 ,3646 
E02000051,2013,Barnet 028,Barnet,E09000003,5831 ,2941 ,2890 
E02000052,2013,Barnet 029,Barnet,E09000003,7180 ,3528 ,3652 
E02000053,2013,Barnet 030,Barnet,E09000003,7642 ,3905 ,3737 
E02000054,2013,Barnet 031,Barnet,E09000003,5336 ,2658 ,2678 
E02000055,2013,Barnet 032,Barnet,E09000003,8077 ,4143 ,3934 
E02000056,2013,Barnet 033,Barnet,E09000003,5481 ,2579 ,2902 
E02000057,2013,Barnet 034,Barnet,E09000003,4857 ,2443 ,2414 
E02000058,2013,Barnet 035,Barnet,E09000003,6564 ,3120 ,3444 
E02000059,2013,Barnet 036,Barnet,E09000003,7636 ,3943 ,3693 
E02000060,2013,Barnet 037,Barnet,E09000003,6727 ,3357 ,3370 
E02000061,2013,Barnet 038,Barnet,E09000003,5798 ,2930 ,2868 
E02000062,2013,Barnet 039,Barnet,E09000003,4569 ,2230 ,2339 
E02000063,2013,Barnet 040,Barnet,E09000003,4983 ,2522 ,2461 
E02000064,2013,Barnet 041,Barnet,E09000003,4445 ,2172 ,2273 
E02000065,2013,Bexley 001,Bexley,E09000004,5396 ,2580 ,2816 
E02000066,2013,Bexley 002,Bexley,E09000004,6487 ,3057 ,3430 
E02000067,2013,Bexley 003,Bexley,E09000004,5996 ,2886 ,3110 
E02000068,2013,Bexley 004,Bexley,E09000004,4968 ,2374 ,2594 
E02000069,2013,Bexley 005,Bexley,E09000004,3937 ,1903 ,2034 
E02000070,2013,Bexley 006,Bexley,E09000004,5072 ,2442 ,2630 
E02000071,2013,Bexley 007,Bexley,E09000004,4999 ,2417 ,2582 
E02000072,2013,Bexley 008,Bexley,E09000004,7201 ,3316 ,3885 
E02000073,2013,Bexley 009,Bexley,E09000004,6770 ,3303 ,3467 
E02000074,2013,Bexley 010,Bexley,E09000004,4938 ,2290 ,2648 
E02000075,2013,Bexley 011,Bexley,E09000004,5024 ,2478 ,2546 
E02000077,2013,Bexley 013,Bexley,E09000004,5137 ,2475 ,2662 
E02000078,2013,Bexley 014,Bexley,E09000004,5072 ,2460 ,2612 
E02000079,2013,Bexley 015,Bexley,E09000004,5054 ,2482 ,2572 
E02000080,2013,Bexley 016,Bexley,E09000004,6234 ,3022 ,3212 
E02000081,2013,Bexley 017,Bexley,E09000004,4670 ,2294 ,2376 
E02000082,2013,Bexley 018,Bexley,E09000004,5960 ,2947 ,3013 
E02000083,2013,Bexley 019,Bexley,E09000004,6753 ,3371 ,3382 
E02000084,2013,Bexley 020,Bexley,E09000004,6949 ,3493 ,3456 
E02000085,2013,Bexley 021,Bexley,E09000004,5191 ,2490 ,2701 
E02000086,2013,Bexley 022,Bexley,E09000004,4846 ,2393 ,2453 
E02000087,2013,Bexley 023,Bexley,E09000004,4727 ,2331 ,2396 
E02000088,2013,Bexley 024,Bexley,E09000004,4986 ,2464 ,2522 
E02000089,2013,Bexley 025,Bexley,E09000004,4946 ,2434 ,2512 
E02000090,2013,Bexley 026,Bexley,E09000004,5694 ,2741 ,2953 
E02000091,2013,Bexley 027,Bexley,E09000004,6166 ,2967 ,3199 
E02000092,2013,Bexley 028,Bexley,E09000004,4070 ,1891 ,2179 
E02006785,2013,Bexley 029,Bexley,E09000004,4160 ,2039 ,2121 
E02000093,2013,Brent 001,Brent,E09000005,7359 ,3701 ,3658 
E02000094,2013,Brent 002,Brent,E09000005,5901 ,3042 ,2859 
E02000095,2013,Brent 003,Brent,E09000005,6616 ,3399 ,3217 
E02000096,2013,Brent 004,Brent,E09000005,4808 ,2388 ,2420 
E02000097,2013,Brent 005,Brent,E09000005,5964 ,3094 ,2870 
E02000098,2013,Brent 006,Brent,E09000005,5443 ,2754 ,2689 
E02000099,2013,Brent 007,Brent,E09000005,5915 ,3011 ,2904 
E02000100,2013,Brent 008,Brent,E09000005,6193 ,2920 ,3273 
E02000101,2013,Brent 009,Brent,E09000005,6288 ,3147 ,3141 
E02000102,2013,Brent 010,Brent,E09000005,4977 ,2494 ,2483 
E02000103,2013,Brent 011,Brent,E09000005,5728 ,2832 ,2896 
E02000104,2013,Brent 012,Brent,E09000005,4553 ,2377 ,2176 
E02000105,2013,Brent 013,Brent,E09000005,6562 ,3506 ,3056 
E02000106,2013,Brent 014,Brent,E09000005,7191 ,3734 ,3457 
E02000107,2013,Brent 015,Brent,E09000005,8300 ,4338 ,3962 
E02000108,2013,Brent 016,Brent,E09000005,4536 ,2398 ,2138 
E02000109,2013,Brent 017,Brent,E09000005,7262 ,3888 ,3374 
E02000110,2013,Brent 018,Brent,E09000005,6214 ,3202 ,3012 
E02000111,2013,Brent 019,Brent,E09000005,7158 ,3873 ,3285 
E02000112,2013,Brent 020,Brent,E09000005,6835 ,3740 ,3095 
E02000113,2013,Brent 021,Brent,E09000005,6178 ,2958 ,3220 
E02000114,2013,Brent 022,Brent,E09000005,7132 ,3714 ,3418 
E02000115,2013,Brent 023,Brent,E09000005,6429 ,3391 ,3038 
E02000116,2013,Brent 024,Brent,E09000005,6238 ,3188 ,3050 
E02000117,2013,Brent 025,Brent,E09000005,8044 ,3953 ,4091 
E02000118,2013,Brent 026,Brent,E09000005,7044 ,3737 ,3307 
E02000119,2013,Brent 027,Brent,E09000005,4813 ,2314 ,2499 
E02000120,2013,Brent 028,Brent,E09000005,7029 ,3454 ,3575 
E02000121,2013,Brent 029,Brent,E09000005,6764 ,3511 ,3253 
E02000122,2013,Brent 030,Brent,E09000005,5452 ,2624 ,2828 
E02000123,2013,Brent 031,Brent,E09000005,10659 ,5475 ,5184 
E02000124,2013,Brent 032,Brent,E09000005,7574 ,3792 ,3782 
E02000125,2013,Brent 033,Brent,E09000005,7733 ,3813 ,3920 
E02000126,2013,Brent 034,Brent,E09000005,4991 ,2474 ,2517 
E02000127,2013,Bromley 001,Bromley,E09000006,5585 ,2547 ,3038 
E02000128,2013,Bromley 002,Bromley,E09000006,4751 ,2245 ,2506 
E02000130,2013,Bromley 004,Bromley,E09000006,5744 ,2721 ,3023 
E02000131,2013,Bromley 005,Bromley,E09000006,7256 ,3601 ,3655 
E02000132,2013,Bromley 006,Bromley,E09000006,6565 ,3282 ,3283 
E02000133,2013,Bromley 007,Bromley,E09000006,6197 ,2996 ,3201 
E02000134,2013,Bromley 008,Bromley,E09000006,7599 ,3704 ,3895 
E02000135,2013,Bromley 009,Bromley,E09000006,7075 ,3370 ,3705 
E02000136,2013,Bromley 010,Bromley,E09000006,3369 ,1600 ,1769 
E02000137,2013,Bromley 011,Bromley,E09000006,5215 ,2551 ,2664 
E02000138,2013,Bromley 012,Bromley,E09000006,5291 ,2663 ,2628 
E02000139,2013,Bromley 013,Bromley,E09000006,5234 ,2522 ,2712 
E02000140,2013,Bromley 014,Bromley,E09000006,5056 ,2341 ,2715 
E02000141,2013,Bromley 015,Bromley,E09000006,5022 ,2429 ,2593 
E02000142,2013,Bromley 016,Bromley,E09000006,5453 ,2668 ,2785 
E02000144,2013,Bromley 018,Bromley,E09000006,6056 ,3034 ,3022 
E02000145,2013,Bromley 019,Bromley,E09000006,5243 ,2371 ,2872 
E02000146,2013,Bromley 020,Bromley,E09000006,5826 ,2836 ,2990 
E02000147,2013,Bromley 021,Bromley,E09000006,4906 ,2399 ,2507 
E02000148,2013,Bromley 022,Bromley,E09000006,4017 ,1991 ,2026 
E02000149,2013,Bromley 023,Bromley,E09000006,4966 ,2329 ,2637 
E02000150,2013,Bromley 024,Bromley,E09000006,5526 ,2676 ,2850 
E02000151,2013,Bromley 025,Bromley,E09000006,4516 ,2170 ,2346 
E02000152,2013,Bromley 026,Bromley,E09000006,4421 ,2084 ,2337 
E02000153,2013,Bromley 027,Bromley,E09000006,4910 ,2342 ,2568 
E02000154,2013,Bromley 028,Bromley,E09000006,5211 ,2571 ,2640 
E02000155,2013,Bromley 029,Bromley,E09000006,4221 ,2059 ,2162 
E02000156,2013,Bromley 030,Bromley,E09000006,7417 ,3638 ,3779 
E02000157,2013,Bromley 031,Bromley,E09000006,4685 ,2334 ,2351 
E02000158,2013,Bromley 032,Bromley,E09000006,4432 ,2150 ,2282 
E02000159,2013,Bromley 033,Bromley,E09000006,4235 ,2056 ,2179 
E02000160,2013,Bromley 034,Bromley,E09000006,5031 ,2446 ,2585 
E02000161,2013,Bromley 035,Bromley,E09000006,5294 ,2581 ,2713 
E02000162,2013,Bromley 036,Bromley,E09000006,3951 ,1834 ,2117 
E02000163,2013,Bromley 037,Bromley,E09000006,4658 ,2286 ,2372 
E02000165,2013,Bromley 039,Bromley,E09000006,4729 ,2322 ,2407 
E02006782,2013,Bromley 040,Bromley,E09000006,4844 ,2273 ,2571 
E02006787,2013,Bromley 041,Bromley,E09000006,5059 ,2396 ,2663 
E02006789,2013,Bromley 042,Bromley,E09000006,3852 ,1853 ,1999 
E02000166,2013,Camden 001,Camden,E09000007,5444 ,2505 ,2939 
E02000167,2013,Camden 002,Camden,E09000007,5073 ,2547 ,2526 
E02000168,2013,Camden 003,Camden,E09000007,5996 ,2945 ,3051 
E02000169,2013,Camden 004,Camden,E09000007,5246 ,2541 ,2705 
E02000170,2013,Camden 005,Camden,E09000007,6391 ,3341 ,3050 
E02000171,2013,Camden 006,Camden,E09000007,5692 ,2750 ,2942 
E02000172,2013,Camden 007,Camden,E09000007,7603 ,3752 ,3851 
E02000173,2013,Camden 008,Camden,E09000007,5801 ,2951 ,2850 
E02000174,2013,Camden 009,Camden,E09000007,6544 ,3112 ,3432 
E02000175,2013,Camden 010,Camden,E09000007,7105 ,3493 ,3612 
E02000176,2013,Camden 011,Camden,E09000007,4901 ,2449 ,2452 
E02000177,2013,Camden 012,Camden,E09000007,6506 ,3119 ,3387 
E02000178,2013,Camden 013,Camden,E09000007,7188 ,3759 ,3429 
E02000179,2013,Camden 014,Camden,E09000007,4488 ,2174 ,2314 
E02000180,2013,Camden 015,Camden,E09000007,6016 ,2952 ,3064 
E02000181,2013,Camden 016,Camden,E09000007,6100 ,2998 ,3102 
E02000182,2013,Camden 017,Camden,E09000007,4915 ,2329 ,2586 
E02000183,2013,Camden 018,Camden,E09000007,5581 ,2780 ,2801 
E02000184,2013,Camden 019,Camden,E09000007,6771 ,3353 ,3418 
E02000185,2013,Camden 020,Camden,E09000007,5978 ,2913 ,3065 
E02000186,2013,Camden 021,Camden,E09000007,5493 ,2905 ,2588 
E02000187,2013,Camden 022,Camden,E09000007,6008 ,2907 ,3101 
E02000188,2013,Camden 023,Camden,E09000007,6071 ,3207 ,2864 
E02000189,2013,Camden 024,Camden,E09000007,4509 ,2226 ,2283 
E02000190,2013,Camden 025,Camden,E09000007,6025 ,3028 ,2997 
E02000191,2013,Camden 026,Camden,E09000007,6987 ,3810 ,3177 
E02000192,2013,Camden 027,Camden,E09000007,5693 ,3122 ,2571 
E02000193,2013,Camden 028,Camden,E09000007,6636 ,3607 ,3029 
E02000194,2013,Croydon 001,Croydon,E09000008,6432 ,3246 ,3186 
E02000195,2013,Croydon 002,Croydon,E09000008,6334 ,3141 ,3193 
E02000196,2013,Croydon 003,Croydon,E09000008,5268 ,2616 ,2652 
E02000197,2013,Croydon 004,Croydon,E09000008,6128 ,2898 ,3230 
E02000198,2013,Croydon 005,Croydon,E09000008,5497 ,2606 ,2891 
E02000199,2013,Croydon 006,Croydon,E09000008,5766 ,2713 ,3053 
E02000200,2013,Croydon 007,Croydon,E09000008,6024 ,2860 ,3164 
E02000201,2013,Croydon 008,Croydon,E09000008,5884 ,2781 ,3103 
E02000202,2013,Croydon 009,Croydon,E09000008,5734 ,2850 ,2884 
E02000203,2013,Croydon 010,Croydon,E09000008,5192 ,2487 ,2705 
E02000204,2013,Croydon 011,Croydon,E09000008,6225 ,2956 ,3269 
E02000206,2013,Croydon 013,Croydon,E09000008,6487 ,3107 ,3380 
E02000207,2013,Croydon 014,Croydon,E09000008,6245 ,2962 ,3283 
E02000208,2013,Croydon 015,Croydon,E09000008,6908 ,3316 ,3592 
E02000209,2013,Croydon 016,Croydon,E09000008,5627 ,2680 ,2947 
E02000210,2013,Croydon 017,Croydon,E09000008,5817 ,2813 ,3004 
E02000211,2013,Croydon 018,Croydon,E09000008,5299 ,2596 ,2703 
E02000212,2013,Croydon 019,Croydon,E09000008,5754 ,2789 ,2965 
E02000213,2013,Croydon 020,Croydon,E09000008,6706 ,3351 ,3355 
E02000214,2013,Croydon 021,Croydon,E09000008,4305 ,2144 ,2161 
E02000215,2013,Croydon 022,Croydon,E09000008,7594 ,4016 ,3578 
E02000216,2013,Croydon 023,Croydon,E09000008,4167 ,2111 ,2056 
E02000217,2013,Croydon 024,Croydon,E09000008,7432 ,3691 ,3741 
E02000218,2013,Croydon 025,Croydon,E09000008,4257 ,1919 ,2338 
E02000219,2013,Croydon 026,Croydon,E09000008,4862 ,2391 ,2471 
E02000220,2013,Croydon 027,Croydon,E09000008,7645 ,3957 ,3688 
E02000221,2013,Croydon 028,Croydon,E09000008,6759 ,3160 ,3599 
E02000222,2013,Croydon 029,Croydon,E09000008,5701 ,2866 ,2835 
E02000223,2013,Croydon 030,Croydon,E09000008,4923 ,2102 ,2821 
E02000224,2013,Croydon 031,Croydon,E09000008,5423 ,2750 ,2673 
E02000225,2013,Croydon 032,Croydon,E09000008,4917 ,2293 ,2624 
E02000226,2013,Croydon 033,Croydon,E09000008,4983 ,2494 ,2489 
E02000227,2013,Croydon 034,Croydon,E09000008,7636 ,3619 ,4017 
E02000228,2013,Croydon 035,Croydon,E09000008,4712 ,2334 ,2378 
E02000229,2013,Croydon 036,Croydon,E09000008,4006 ,1882 ,2124 
E02000230,2013,Croydon 037,Croydon,E09000008,6724 ,3390 ,3334 
E02000231,2013,Croydon 038,Croydon,E09000008,5047 ,2488 ,2559 
E02000232,2013,Croydon 039,Croydon,E09000008,3871 ,1890 ,1981 
E02000233,2013,Croydon 040,Croydon,E09000008,3995 ,1930 ,2065 
E02000234,2013,Croydon 041,Croydon,E09000008,5392 ,2661 ,2731 
E02000235,2013,Croydon 042,Croydon,E09000008,4611 ,2225 ,2386 
E02000236,2013,Croydon 043,Croydon,E09000008,5049 ,2497 ,2552 
E02000237,2013,Croydon 044,Croydon,E09000008,4559 ,2211 ,2348 
E02006788,2013,Croydon 045,Croydon,E09000008,5069 ,2277 ,2792 
E02000238,2013,Ealing 001,Ealing,E09000009,6647 ,3437 ,3210 
E02000239,2013,Ealing 002,Ealing,E09000009,6228 ,3248 ,2980 
E02000240,2013,Ealing 003,Ealing,E09000009,6779 ,3256 ,3523 
E02000241,2013,Ealing 004,Ealing,E09000009,4633 ,2366 ,2267 
E02000242,2013,Ealing 005,Ealing,E09000009,4736 ,2538 ,2198 
E02000243,2013,Ealing 006,Ealing,E09000009,5847 ,2963 ,2884 
E02000244,2013,Ealing 007,Ealing,E09000009,4989 ,2629 ,2360 
E02000245,2013,Ealing 008,Ealing,E09000009,5456 ,2578 ,2878 
E02000246,2013,Ealing 009,Ealing,E09000009,5560 ,2667 ,2893 
E02000247,2013,Ealing 010,Ealing,E09000009,6672 ,3218 ,3454 
E02000248,2013,Ealing 011,Ealing,E09000009,5258 ,2695 ,2563 
E02000249,2013,Ealing 012,Ealing,E09000009,5202 ,2601 ,2601 
E02000250,2013,Ealing 013,Ealing,E09000009,4136 ,1983 ,2153 
E02000251,2013,Ealing 014,Ealing,E09000009,5438 ,2795 ,2643 
E02000252,2013,Ealing 015,Ealing,E09000009,7625 ,4008 ,3617 
E02000253,2013,Ealing 016,Ealing,E09000009,6093 ,2910 ,3183 
E02000254,2013,Ealing 017,Ealing,E09000009,6075 ,3140 ,2935 
E02000255,2013,Ealing 018,Ealing,E09000009,6252 ,2996 ,3256 
E02000256,2013,Ealing 019,Ealing,E09000009,6508 ,3290 ,3218 
E02000257,2013,Ealing 020,Ealing,E09000009,9816 ,4944 ,4872 
E02000258,2013,Ealing 021,Ealing,E09000009,4951 ,2589 ,2362 
E02000259,2013,Ealing 022,Ealing,E09000009,4286 ,2065 ,2221 
E02000260,2013,Ealing 023,Ealing,E09000009,6076 ,3237 ,2839 
E02000261,2013,Ealing 024,Ealing,E09000009,7848 ,3931 ,3917 
E02000262,2013,Ealing 025,Ealing,E09000009,6549 ,3333 ,3216 
E02000263,2013,Ealing 026,Ealing,E09000009,8158 ,4463 ,3695 
E02000264,2013,Ealing 027,Ealing,E09000009,5824 ,2946 ,2878 
E02000265,2013,Ealing 028,Ealing,E09000009,7680 ,3827 ,3853 
E02000266,2013,Ealing 029,Ealing,E09000009,8188 ,4110 ,4078 
E02000267,2013,Ealing 030,Ealing,E09000009,5007 ,2438 ,2569 
E02000268,2013,Ealing 031,Ealing,E09000009,6654 ,3339 ,3315 
E02000269,2013,Ealing 032,Ealing,E09000009,5673 ,2798 ,2875 
E02000270,2013,Ealing 033,Ealing,E09000009,5369 ,2551 ,2818 
E02000271,2013,Ealing 034,Ealing,E09000009,4713 ,2367 ,2346 
E02000272,2013,Ealing 035,Ealing,E09000009,4449 ,2180 ,2269 
E02000274,2013,Ealing 037,Ealing,E09000009,9088 ,5006 ,4082 
E02000275,2013,Ealing 038,Ealing,E09000009,4982 ,2596 ,2386 
E02000276,2013,Ealing 039,Ealing,E09000009,4737 ,2403 ,2334 
E02006791,2013,Ealing 040,Ealing,E09000009,4971 ,2423 ,2548 
E02000277,2013,Enfield 001,Enfield,E09000010,4697 ,2230 ,2467 
E02000278,2013,Enfield 002,Enfield,E09000010,5667 ,2606 ,3061 
E02000279,2013,Enfield 003,Enfield,E09000010,7767 ,3596 ,4171 
E02000280,2013,Enfield 004,Enfield,E09000010,5448 ,2582 ,2866 
E02000281,2013,Enfield 005,Enfield,E09000010,5595 ,2617 ,2978 
E02000282,2013,Enfield 006,Enfield,E09000010,5812 ,2689 ,3123 
E02000283,2013,Enfield 007,Enfield,E09000010,5589 ,2637 ,2952 
E02000284,2013,Enfield 008,Enfield,E09000010,5474 ,2668 ,2806 
E02000285,2013,Enfield 009,Enfield,E09000010,4202 ,2044 ,2158 
E02000286,2013,Enfield 010,Enfield,E09000010,5469 ,2742 ,2727 
E02000287,2013,Enfield 011,Enfield,E09000010,4316 ,2141 ,2175 
E02000288,2013,Enfield 012,Enfield,E09000010,6955 ,3376 ,3579 
E02000289,2013,Enfield 013,Enfield,E09000010,4061 ,1960 ,2101 
E02000290,2013,Enfield 014,Enfield,E09000010,4662 ,2219 ,2443 
E02000291,2013,Enfield 015,Enfield,E09000010,6071 ,2997 ,3074 
E02000292,2013,Enfield 016,Enfield,E09000010,6478 ,3173 ,3305 
E02000293,2013,Enfield 017,Enfield,E09000010,3882 ,1935 ,1947 
E02000294,2013,Enfield 018,Enfield,E09000010,5826 ,2809 ,3017 
E02000295,2013,Enfield 019,Enfield,E09000010,5567 ,2717 ,2850 
E02000296,2013,Enfield 020,Enfield,E09000010,6738 ,3269 ,3469 
E02000297,2013,Enfield 021,Enfield,E09000010,6163 ,3056 ,3107 
E02000298,2013,Enfield 022,Enfield,E09000010,5232 ,2638 ,2594 
E02000299,2013,Enfield 023,Enfield,E09000010,6093 ,2905 ,3188 
E02000300,2013,Enfield 024,Enfield,E09000010,5599 ,2710 ,2889 
E02000301,2013,Enfield 025,Enfield,E09000010,6756 ,3162 ,3594 
E02000302,2013,Enfield 026,Enfield,E09000010,5570 ,2698 ,2872 
E02000303,2013,Enfield 027,Enfield,E09000010,5656 ,2663 ,2993 
E02000304,2013,Enfield 028,Enfield,E09000010,5290 ,2619 ,2671 
E02000305,2013,Enfield 029,Enfield,E09000010,6369 ,3234 ,3135 
E02000306,2013,Enfield 030,Enfield,E09000010,6043 ,2803 ,3240 
E02000307,2013,Enfield 031,Enfield,E09000010,6557 ,3172 ,3385 
E02000308,2013,Enfield 032,Enfield,E09000010,5552 ,2894 ,2658 
E02000309,2013,Enfield 033,Enfield,E09000010,7170 ,3575 ,3595 
E02000311,2013,Enfield 035,Enfield,E09000010,7107 ,3442 ,3665 
E02000312,2013,Enfield 036,Enfield,E09000010,8280 ,4355 ,3925 
E02006793,2013,Enfield 037,Enfield,E09000010,6187 ,2858 ,3329 
E02000313,2013,Greenwich 001,Greenwich,E09000011,4751 ,2429 ,2322 
E02000314,2013,Greenwich 002,Greenwich,E09000011,9931 ,5501 ,4430 
E02000315,2013,Greenwich 003,Greenwich,E09000011,5841 ,2826 ,3015 
E02000316,2013,Greenwich 004,Greenwich,E09000011,8853 ,4636 ,4217 
E02000317,2013,Greenwich 005,Greenwich,E09000011,5671 ,2769 ,2902 
E02000318,2013,Greenwich 006,Greenwich,E09000011,7384 ,3910 ,3474 
E02000319,2013,Greenwich 007,Greenwich,E09000011,8204 ,4435 ,3769 
E02000320,2013,Greenwich 008,Greenwich,E09000011,4641 ,2263 ,2378 
E02000321,2013,Greenwich 009,Greenwich,E09000011,5004 ,2482 ,2522 
E02000323,2013,Greenwich 011,Greenwich,E09000011,7288 ,3645 ,3643 
E02000324,2013,Greenwich 012,Greenwich,E09000011,4998 ,2472 ,2526 
E02000326,2013,Greenwich 014,Greenwich,E09000011,5034 ,2458 ,2576 
E02000327,2013,Greenwich 015,Greenwich,E09000011,4699 ,2503 ,2196 
E02000328,2013,Greenwich 016,Greenwich,E09000011,4545 ,2257 ,2288 
E02000329,2013,Greenwich 017,Greenwich,E09000011,4282 ,2163 ,2119 
E02000331,2013,Greenwich 019,Greenwich,E09000011,5704 ,2815 ,2889 
E02000332,2013,Greenwich 020,Greenwich,E09000011,4967 ,2504 ,2463 
E02000333,2013,Greenwich 021,Greenwich,E09000011,4357 ,2150 ,2207 
E02000334,2013,Greenwich 022,Greenwich,E09000011,4482 ,2272 ,2210 
E02000335,2013,Greenwich 023,Greenwich,E09000011,4398 ,2217 ,2181 
E02000337,2013,Greenwich 025,Greenwich,E09000011,5472 ,2730 ,2742 
E02000339,2013,Greenwich 027,Greenwich,E09000011,3921 ,2002 ,1919 
E02000340,2013,Greenwich 028,Greenwich,E09000011,3997 ,2039 ,1958 
E02000341,2013,Greenwich 029,Greenwich,E09000011,5074 ,2407 ,2667 
E02000342,2013,Greenwich 030,Greenwich,E09000011,4377 ,1942 ,2435 
E02000343,2013,Greenwich 031,Greenwich,E09000011,4398 ,2262 ,2136 
E02000344,2013,Greenwich 032,Greenwich,E09000011,4280 ,2227 ,2053 
E02006786,2013,Greenwich 033,Greenwich,E09000011,4930 ,2485 ,2445 
E02006927,2013,Greenwich 034,Greenwich,E09000011,5487 ,2683 ,2804 
E02006928,2013,Greenwich 035,Greenwich,E09000011,6297 ,3007 ,3290 
E02006929,2013,Greenwich 036,Greenwich,E09000011,5880 ,2866 ,3014 
E02006930,2013,Greenwich 037,Greenwich,E09000011,5002 ,2525 ,2477 
E02006931,2013,Greenwich 038,Greenwich,E09000011,6683 ,3270 ,3413 
E02000345,2013,Hackney 001,Hackney,E09000012,5510 ,2779 ,2731 
E02000346,2013,Hackney 002,Hackney,E09000012,4219 ,2021 ,2198 
E02000347,2013,Hackney 003,Hackney,E09000012,5133 ,2540 ,2593 
E02000348,2013,Hackney 004,Hackney,E09000012,5116 ,2535 ,2581 
E02000350,2013,Hackney 006,Hackney,E09000012,7244 ,3597 ,3647 
E02000351,2013,Hackney 007,Hackney,E09000012,6913 ,3452 ,3461 
E02000352,2013,Hackney 008,Hackney,E09000012,4731 ,2208 ,2523 
E02000353,2013,Hackney 009,Hackney,E09000012,6151 ,2953 ,3198 
E02000354,2013,Hackney 010,Hackney,E09000012,7390 ,3673 ,3717 
E02000355,2013,Hackney 011,Hackney,E09000012,6481 ,3250 ,3231 
E02000356,2013,Hackney 012,Hackney,E09000012,5675 ,2749 ,2926 
E02000357,2013,Hackney 013,Hackney,E09000012,3971 ,1804 ,2167 
E02000358,2013,Hackney 014,Hackney,E09000012,8966 ,4527 ,4439 
E02000359,2013,Hackney 015,Hackney,E09000012,4679 ,2171 ,2508 
E02000360,2013,Hackney 016,Hackney,E09000012,8162 ,3929 ,4233 
E02000361,2013,Hackney 017,Hackney,E09000012,6144 ,3007 ,3137 
E02000362,2013,Hackney 018,Hackney,E09000012,4691 ,2299 ,2392 
E02000363,2013,Hackney 019,Hackney,E09000012,7411 ,3551 ,3860 
E02000364,2013,Hackney 020,Hackney,E09000012,6957 ,3431 ,3526 
E02000365,2013,Hackney 021,Hackney,E09000012,10932 ,5584 ,5348 
E02000366,2013,Hackney 022,Hackney,E09000012,6219 ,3054 ,3165 
E02000367,2013,Hackney 023,Hackney,E09000012,8327 ,4083 ,4244 
E02000368,2013,Hackney 024,Hackney,E09000012,7086 ,3510 ,3576 
E02000369,2013,Hackney 025,Hackney,E09000012,9485 ,4849 ,4636 
E02000370,2013,Hackney 026,Hackney,E09000012,6795 ,3556 ,3239 
E02000371,2013,Hackney 027,Hackney,E09000012,11705 ,6264 ,5441 
E02006918,2013,Hackney 028,Hackney,E09000012,5706 ,2750 ,2956 
E02006921,2013,Hackney 029,Hackney,E09000012,4989 ,2436 ,2553 
E02000372,2013,Hammersmith and Fulham 001,Hammersmith and Fulham,E09000013,6684 ,3122 ,3562 
E02000373,2013,Hammersmith and Fulham 002,Hammersmith and Fulham,E09000013,4176 ,1952 ,2224 
E02000374,2013,Hammersmith and Fulham 003,Hammersmith and Fulham,E09000013,4582 ,2199 ,2383 
E02000375,2013,Hammersmith and Fulham 004,Hammersmith and Fulham,E09000013,5083 ,2557 ,2526 
E02000376,2013,Hammersmith and Fulham 005,Hammersmith and Fulham,E09000013,5285 ,2799 ,2486 
E02000377,2013,Hammersmith and Fulham 006,Hammersmith and Fulham,E09000013,5979 ,3029 ,2950 
E02000378,2013,Hammersmith and Fulham 007,Hammersmith and Fulham,E09000013,4966 ,2483 ,2483 
E02000379,2013,Hammersmith and Fulham 008,Hammersmith and Fulham,E09000013,5342 ,2616 ,2726 
E02000380,2013,Hammersmith and Fulham 009,Hammersmith and Fulham,E09000013,4061 ,2086 ,1975 
E02000381,2013,Hammersmith and Fulham 010,Hammersmith and Fulham,E09000013,5567 ,2710 ,2857 
E02000382,2013,Hammersmith and Fulham 011,Hammersmith and Fulham,E09000013,4309 ,2103 ,2206 
E02000383,2013,Hammersmith and Fulham 012,Hammersmith and Fulham,E09000013,7227 ,3593 ,3634 
E02000384,2013,Hammersmith and Fulham 013,Hammersmith and Fulham,E09000013,5271 ,2640 ,2631 
E02000385,2013,Hammersmith and Fulham 014,Hammersmith and Fulham,E09000013,5081 ,2602 ,2479 
E02000386,2013,Hammersmith and Fulham 015,Hammersmith and Fulham,E09000013,5948 ,2933 ,3015 
E02000387,2013,Hammersmith and Fulham 016,Hammersmith and Fulham,E09000013,4735 ,2418 ,2317 
E02000388,2013,Hammersmith and Fulham 017,Hammersmith and Fulham,E09000013,6019 ,2994 ,3025 
E02000389,2013,Hammersmith and Fulham 018,Hammersmith and Fulham,E09000013,5917 ,2920 ,2997 
E02000390,2013,Hammersmith and Fulham 019,Hammersmith and Fulham,E09000013,4693 ,2309 ,2384 
E02000391,2013,Hammersmith and Fulham 020,Hammersmith and Fulham,E09000013,5476 ,2673 ,2803 
E02000392,2013,Hammersmith and Fulham 021,Hammersmith and Fulham,E09000013,6854 ,3185 ,3669 
E02000393,2013,Hammersmith and Fulham 022,Hammersmith and Fulham,E09000013,4397 ,2071 ,2326 
E02000394,2013,Hammersmith and Fulham 023,Hammersmith and Fulham,E09000013,5796 ,2735 ,3061 
E02000395,2013,Hammersmith and Fulham 024,Hammersmith and Fulham,E09000013,4130 ,1963 ,2167 
E02000396,2013,Hammersmith and Fulham 025,Hammersmith and Fulham,E09000013,4534 ,2172 ,2362 
E02000397,2013,Haringey 001,Haringey,E09000014,6099 ,3140 ,2959 
E02000398,2013,Haringey 002,Haringey,E09000014,4940 ,2542 ,2398 
E02000400,2013,Haringey 004,Haringey,E09000014,5526 ,2709 ,2817 
E02000401,2013,Haringey 005,Haringey,E09000014,4479 ,2133 ,2346 
E02000402,2013,Haringey 006,Haringey,E09000014,4475 ,2074 ,2401 
E02000403,2013,Haringey 007,Haringey,E09000014,5957 ,3072 ,2885 
E02000404,2013,Haringey 008,Haringey,E09000014,5447 ,2760 ,2687 
E02000405,2013,Haringey 009,Haringey,E09000014,4480 ,2207 ,2273 
E02000406,2013,Haringey 010,Haringey,E09000014,5347 ,2643 ,2704 
E02000407,2013,Haringey 011,Haringey,E09000014,5244 ,2657 ,2587 
E02000408,2013,Haringey 012,Haringey,E09000014,5464 ,2697 ,2767 
E02000409,2013,Haringey 013,Haringey,E09000014,4456 ,2217 ,2239 
E02000410,2013,Haringey 014,Haringey,E09000014,4716 ,2307 ,2409 
E02000411,2013,Haringey 015,Haringey,E09000014,6411 ,3278 ,3133 
E02000412,2013,Haringey 016,Haringey,E09000014,5518 ,2833 ,2685 
E02000413,2013,Haringey 017,Haringey,E09000014,4899 ,2299 ,2600 
E02000414,2013,Haringey 018,Haringey,E09000014,5316 ,2794 ,2522 
E02000415,2013,Haringey 019,Haringey,E09000014,5318 ,2790 ,2528 
E02000416,2013,Haringey 020,Haringey,E09000014,5679 ,2850 ,2829 
E02000417,2013,Haringey 021,Haringey,E09000014,4674 ,2264 ,2410 
E02000418,2013,Haringey 022,Haringey,E09000014,3848 ,1841 ,2007 
E02000419,2013,Haringey 023,Haringey,E09000014,6628 ,3527 ,3101 
E02000420,2013,Haringey 024,Haringey,E09000014,5458 ,2753 ,2705 
E02000421,2013,Haringey 025,Haringey,E09000014,5236 ,2583 ,2653 
E02000422,2013,Haringey 026,Haringey,E09000014,5746 ,3038 ,2708 
E02000423,2013,Haringey 027,Haringey,E09000014,5538 ,2927 ,2611 
E02000424,2013,Haringey 028,Haringey,E09000014,5482 ,2765 ,2717 
E02000425,2013,Haringey 029,Haringey,E09000014,4349 ,2210 ,2139 
E02000426,2013,Haringey 030,Haringey,E09000014,4463 ,2142 ,2321 
E02000427,2013,Haringey 031,Haringey,E09000014,5617 ,2989 ,2628 
E02000428,2013,Haringey 032,Haringey,E09000014,5357 ,2702 ,2655 
E02000429,2013,Haringey 033,Haringey,E09000014,5009 ,2564 ,2445 
E02000430,2013,Haringey 034,Haringey,E09000014,5972 ,3065 ,2907 
E02000431,2013,Haringey 035,Haringey,E09000014,5025 ,2530 ,2495 
E02000432,2013,Haringey 036,Haringey,E09000014,5145 ,2619 ,2526 
E02006794,2013,Haringey 037,Haringey,E09000014,5068 ,2536 ,2532 
E02000433,2013,Harrow 001,Harrow,E09000015,4582 ,2227 ,2355 
E02000434,2013,Harrow 002,Harrow,E09000015,5727 ,2790 ,2937 
E02000435,2013,Harrow 003,Harrow,E09000015,4839 ,2349 ,2490 
E02000436,2013,Harrow 004,Harrow,E09000015,3522 ,1736 ,1786 
E02000437,2013,Harrow 005,Harrow,E09000015,5553 ,2672 ,2881 
E02000438,2013,Harrow 006,Harrow,E09000015,5062 ,2434 ,2628 
E02000439,2013,Harrow 007,Harrow,E09000015,5755 ,2923 ,2832 
E02000440,2013,Harrow 008,Harrow,E09000015,6364 ,3162 ,3202 
E02000441,2013,Harrow 009,Harrow,E09000015,4386 ,2106 ,2280 
E02000442,2013,Harrow 010,Harrow,E09000015,6109 ,3120 ,2989 
E02000443,2013,Harrow 011,Harrow,E09000015,6298 ,3117 ,3181 
E02000444,2013,Harrow 012,Harrow,E09000015,5718 ,2881 ,2837 
E02000445,2013,Harrow 013,Harrow,E09000015,7072 ,3617 ,3455 
E02000447,2013,Harrow 015,Harrow,E09000015,4609 ,2224 ,2385 
E02000448,2013,Harrow 016,Harrow,E09000015,4180 ,2064 ,2116 
E02000449,2013,Harrow 017,Harrow,E09000015,5791 ,2991 ,2800 
E02000451,2013,Harrow 019,Harrow,E09000015,4301 ,2126 ,2175 
E02000452,2013,Harrow 020,Harrow,E09000015,5827 ,3044 ,2783 
E02000453,2013,Harrow 021,Harrow,E09000015,5450 ,2671 ,2779 
E02000454,2013,Harrow 022,Harrow,E09000015,4387 ,2118 ,2269 
E02000455,2013,Harrow 023,Harrow,E09000015,5862 ,2998 ,2864 
E02000456,2013,Harrow 024,Harrow,E09000015,4810 ,2387 ,2423 
E02000457,2013,Harrow 025,Harrow,E09000015,4082 ,2074 ,2008 
E02000459,2013,Harrow 027,Harrow,E09000015,5748 ,2852 ,2896 
E02000460,2013,Harrow 028,Harrow,E09000015,4455 ,2206 ,2249 
E02000461,2013,Harrow 029,Harrow,E09000015,5036 ,2870 ,2166 
E02000462,2013,Harrow 030,Harrow,E09000015,4454 ,2306 ,2148 
E02000463,2013,Harrow 031,Harrow,E09000015,5594 ,2731 ,2863 
E02006795,2013,Harrow 032,Harrow,E09000015,5397 ,2738 ,2659 
E02006882,2013,Harrow 033,Harrow,E09000015,9659 ,4782 ,4877 
E02000464,2013,Havering 001,Havering,E09000016,4029 ,1901 ,2128 
E02000465,2013,Havering 002,Havering,E09000016,5306 ,2559 ,2747 
E02000466,2013,Havering 003,Havering,E09000016,5287 ,2455 ,2832 
E02000467,2013,Havering 004,Havering,E09000016,6480 ,3084 ,3396 
E02000468,2013,Havering 005,Havering,E09000016,4906 ,2334 ,2572 
E02000469,2013,Havering 006,Havering,E09000016,4211 ,1983 ,2228 
E02000470,2013,Havering 007,Havering,E09000016,5113 ,2569 ,2544 
E02000471,2013,Havering 008,Havering,E09000016,4561 ,2229 ,2332 
E02000472,2013,Havering 009,Havering,E09000016,5697 ,2779 ,2918 
E02000473,2013,Havering 010,Havering,E09000016,6290 ,3090 ,3200 
E02000474,2013,Havering 011,Havering,E09000016,5419 ,2593 ,2826 
E02000475,2013,Havering 012,Havering,E09000016,6099 ,3008 ,3091 
E02000476,2013,Havering 013,Havering,E09000016,6030 ,2983 ,3047 
E02000477,2013,Havering 014,Havering,E09000016,6120 ,3016 ,3104 
E02000478,2013,Havering 015,Havering,E09000016,3677 ,1856 ,1821 
E02000479,2013,Havering 016,Havering,E09000016,5999 ,2867 ,3132 
E02000480,2013,Havering 017,Havering,E09000016,6896 ,3303 ,3593 
E02000481,2013,Havering 018,Havering,E09000016,4678 ,2239 ,2439 
E02000482,2013,Havering 019,Havering,E09000016,3895 ,1939 ,1956 
E02000483,2013,Havering 020,Havering,E09000016,4891 ,2421 ,2470 
E02000484,2013,Havering 021,Havering,E09000016,5517 ,2780 ,2737 
E02000485,2013,Havering 022,Havering,E09000016,5212 ,2566 ,2646 
E02000486,2013,Havering 023,Havering,E09000016,4836 ,2384 ,2452 
E02000487,2013,Havering 024,Havering,E09000016,4857 ,2430 ,2427 
E02000488,2013,Havering 025,Havering,E09000016,4840 ,2372 ,2468 
E02000489,2013,Havering 026,Havering,E09000016,5091 ,2499 ,2592 
E02000490,2013,Havering 027,Havering,E09000016,4871 ,2337 ,2534 
E02000491,2013,Havering 028,Havering,E09000016,5583 ,2766 ,2817 
E02000492,2013,Havering 029,Havering,E09000016,3904 ,1979 ,1925 
E02000493,2013,Havering 030,Havering,E09000016,4039 ,1899 ,2140 
E02000494,2013,Hillingdon 001,Hillingdon,E09000017,4612 ,2205 ,2407 
E02000495,2013,Hillingdon 002,Hillingdon,E09000017,6402 ,3071 ,3331 
E02000496,2013,Hillingdon 003,Hillingdon,E09000017,4810 ,2356 ,2454 
E02000497,2013,Hillingdon 004,Hillingdon,E09000017,5688 ,2774 ,2914 
E02000498,2013,Hillingdon 005,Hillingdon,E09000017,3810 ,1846 ,1964 
E02000499,2013,Hillingdon 006,Hillingdon,E09000017,4854 ,2390 ,2464 
E02000500,2013,Hillingdon 007,Hillingdon,E09000017,5091 ,2549 ,2542 
E02000501,2013,Hillingdon 008,Hillingdon,E09000017,5395 ,2633 ,2762 
E02000502,2013,Hillingdon 009,Hillingdon,E09000017,5270 ,2601 ,2669 
E02000503,2013,Hillingdon 010,Hillingdon,E09000017,6237 ,3197 ,3040 
E02000504,2013,Hillingdon 011,Hillingdon,E09000017,4457 ,2216 ,2241 
E02000506,2013,Hillingdon 013,Hillingdon,E09000017,4998 ,2493 ,2505 
E02000507,2013,Hillingdon 014,Hillingdon,E09000017,5175 ,2584 ,2591 
E02000508,2013,Hillingdon 015,Hillingdon,E09000017,8044 ,4414 ,3630 
E02000509,2013,Hillingdon 016,Hillingdon,E09000017,9150 ,4598 ,4552 
E02000510,2013,Hillingdon 017,Hillingdon,E09000017,5842 ,2945 ,2897 
E02000511,2013,Hillingdon 018,Hillingdon,E09000017,6344 ,3210 ,3134 
E02000512,2013,Hillingdon 019,Hillingdon,E09000017,5440 ,2697 ,2743 
E02000513,2013,Hillingdon 020,Hillingdon,E09000017,5850 ,2780 ,3070 
E02000514,2013,Hillingdon 021,Hillingdon,E09000017,6852 ,3561 ,3291 
E02000515,2013,Hillingdon 022,Hillingdon,E09000017,7766 ,4003 ,3763 
E02000516,2013,Hillingdon 023,Hillingdon,E09000017,5856 ,2881 ,2975 
E02000517,2013,Hillingdon 024,Hillingdon,E09000017,6010 ,2905 ,3105 
E02000518,2013,Hillingdon 025,Hillingdon,E09000017,5809 ,2863 ,2946 
E02000519,2013,Hillingdon 026,Hillingdon,E09000017,5986 ,3046 ,2940 
E02000520,2013,Hillingdon 027,Hillingdon,E09000017,8209 ,4232 ,3977 
E02000521,2013,Hillingdon 028,Hillingdon,E09000017,7158 ,3553 ,3605 
E02000522,2013,Hillingdon 029,Hillingdon,E09000017,5791 ,2818 ,2973 
E02000523,2013,Hillingdon 030,Hillingdon,E09000017,7014 ,3606 ,3408 
E02000524,2013,Hillingdon 031,Hillingdon,E09000017,5064 ,2832 ,2232 
E02000525,2013,Hillingdon 032,Hillingdon,E09000017,6364 ,3228 ,3136 
E02006796,2013,Hillingdon 033,Hillingdon,E09000017,5744 ,2834 ,2910 
E02000526,2013,Hounslow 001,Hounslow,E09000018,5846 ,2846 ,3000 
E02000528,2013,Hounslow 003,Hounslow,E09000018,7623 ,3714 ,3909 
E02000529,2013,Hounslow 004,Hounslow,E09000018,5881 ,3028 ,2853 
E02000530,2013,Hounslow 005,Hounslow,E09000018,4572 ,2280 ,2292 
E02000531,2013,Hounslow 006,Hounslow,E09000018,7480 ,3740 ,3740 
E02000532,2013,Hounslow 007,Hounslow,E09000018,6277 ,3130 ,3147 
E02000533,2013,Hounslow 008,Hounslow,E09000018,5837 ,2932 ,2905 
E02000534,2013,Hounslow 009,Hounslow,E09000018,5757 ,3029 ,2728 
E02000535,2013,Hounslow 010,Hounslow,E09000018,6452 ,3384 ,3068 
E02000536,2013,Hounslow 011,Hounslow,E09000018,6517 ,3372 ,3145 
E02000537,2013,Hounslow 012,Hounslow,E09000018,6398 ,3477 ,2921 
E02000538,2013,Hounslow 013,Hounslow,E09000018,6383 ,3349 ,3034 
E02000539,2013,Hounslow 014,Hounslow,E09000018,7662 ,3734 ,3928 
E02000540,2013,Hounslow 015,Hounslow,E09000018,6992 ,3822 ,3170 
E02000541,2013,Hounslow 016,Hounslow,E09000018,6383 ,3381 ,3002 
E02000542,2013,Hounslow 017,Hounslow,E09000018,7281 ,3878 ,3403 
E02000543,2013,Hounslow 018,Hounslow,E09000018,9073 ,4933 ,4140 
E02000544,2013,Hounslow 019,Hounslow,E09000018,5854 ,2960 ,2894 
E02000545,2013,Hounslow 020,Hounslow,E09000018,5783 ,2783 ,3000 
E02000546,2013,Hounslow 021,Hounslow,E09000018,6843 ,3589 ,3254 
E02000547,2013,Hounslow 022,Hounslow,E09000018,6555 ,3290 ,3265 
E02000548,2013,Hounslow 023,Hounslow,E09000018,6335 ,3165 ,3170 
E02000549,2013,Hounslow 024,Hounslow,E09000018,7534 ,3846 ,3688 
E02000550,2013,Hounslow 025,Hounslow,E09000018,7315 ,3594 ,3721 
E02000551,2013,Hounslow 026,Hounslow,E09000018,5855 ,2863 ,2992 
E02000552,2013,Hounslow 027,Hounslow,E09000018,5991 ,3141 ,2850 
E02000553,2013,Hounslow 028,Hounslow,E09000018,4428 ,2149 ,2279 
E02006792,2013,Hounslow 029,Hounslow,E09000018,6342 ,3258 ,3084 
E02000554,2013,Islington 001,Islington,E09000019,6885 ,3298 ,3587 
E02000555,2013,Islington 002,Islington,E09000019,6669 ,3119 ,3550 
E02000556,2013,Islington 003,Islington,E09000019,7829 ,3848 ,3981 
E02000557,2013,Islington 004,Islington,E09000019,5971 ,2844 ,3127 
E02000558,2013,Islington 005,Islington,E09000019,6310 ,3101 ,3209 
E02000559,2013,Islington 006,Islington,E09000019,7192 ,3752 ,3440 
E02000560,2013,Islington 007,Islington,E09000019,5942 ,3028 ,2914 
E02000561,2013,Islington 008,Islington,E09000019,5950 ,2888 ,3062 
E02000562,2013,Islington 009,Islington,E09000019,5879 ,2866 ,3013 
E02000563,2013,Islington 010,Islington,E09000019,6325 ,3109 ,3216 
E02000564,2013,Islington 011,Islington,E09000019,8959 ,4495 ,4464 
E02000565,2013,Islington 012,Islington,E09000019,6225 ,2930 ,3295 
E02000566,2013,Islington 013,Islington,E09000019,6640 ,3245 ,3395 
E02000567,2013,Islington 014,Islington,E09000019,8372 ,4042 ,4330 
E02000568,2013,Islington 015,Islington,E09000019,8180 ,4387 ,3793 
E02000569,2013,Islington 016,Islington,E09000019,7765 ,3739 ,4026 
E02000570,2013,Islington 017,Islington,E09000019,7146 ,3664 ,3482 
E02000571,2013,Islington 018,Islington,E09000019,6238 ,3134 ,3104 
E02000572,2013,Islington 019,Islington,E09000019,6204 ,2885 ,3319 
E02000573,2013,Islington 020,Islington,E09000019,7217 ,3754 ,3463 
E02000574,2013,Islington 021,Islington,E09000019,6901 ,3496 ,3405 
E02000575,2013,Islington 022,Islington,E09000019,10609 ,5690 ,4919 
E02000576,2013,Islington 023,Islington,E09000019,7942 ,4208 ,3734 
E02000577,2013,Kensington and Chelsea 001,Kensington and Chelsea,E09000020,4953 ,2451 ,2502 
E02000578,2013,Kensington and Chelsea 002,Kensington and Chelsea,E09000020,3886 ,1844 ,2042 
E02000579,2013,Kensington and Chelsea 003,Kensington and Chelsea,E09000020,5939 ,2867 ,3072 
E02000580,2013,Kensington and Chelsea 004,Kensington and Chelsea,E09000020,6287 ,3070 ,3217 
E02000581,2013,Kensington and Chelsea 005,Kensington and Chelsea,E09000020,4724 ,2218 ,2506 
E02000582,2013,Kensington and Chelsea 006,Kensington and Chelsea,E09000020,5225 ,2548 ,2677 
E02000583,2013,Kensington and Chelsea 007,Kensington and Chelsea,E09000020,4961 ,2314 ,2647 
E02000584,2013,Kensington and Chelsea 008,Kensington and Chelsea,E09000020,4947 ,2187 ,2760 
E02000585,2013,Kensington and Chelsea 009,Kensington and Chelsea,E09000020,5768 ,2810 ,2958 
E02000586,2013,Kensington and Chelsea 010,Kensington and Chelsea,E09000020,5397 ,2706 ,2691 
E02000587,2013,Kensington and Chelsea 011,Kensington and Chelsea,E09000020,4935 ,2443 ,2492 
E02000588,2013,Kensington and Chelsea 012,Kensington and Chelsea,E09000020,5923 ,3244 ,2679 
E02000589,2013,Kensington and Chelsea 013,Kensington and Chelsea,E09000020,6445 ,3487 ,2958 
E02000590,2013,Kensington and Chelsea 014,Kensington and Chelsea,E09000020,5041 ,2365 ,2676 
E02000591,2013,Kensington and Chelsea 015,Kensington and Chelsea,E09000020,5044 ,2599 ,2445 
E02000592,2013,Kensington and Chelsea 016,Kensington and Chelsea,E09000020,5043 ,2532 ,2511 
E02000593,2013,Kensington and Chelsea 017,Kensington and Chelsea,E09000020,5486 ,2883 ,2603 
E02000594,2013,Kensington and Chelsea 018,Kensington and Chelsea,E09000020,5065 ,2514 ,2551 
E02000595,2013,Kensington and Chelsea 019,Kensington and Chelsea,E09000020,5200 ,2482 ,2718 
E02000596,2013,Kensington and Chelsea 020,Kensington and Chelsea,E09000020,5828 ,2948 ,2880 
E02000597,2013,Kensington and Chelsea 021,Kensington and Chelsea,E09000020,4976 ,2415 ,2561 
E02000598,2013,Kingston upon Thames 001,Kingston upon Thames,E09000021,5062 ,2413 ,2649 
E02000599,2013,Kingston upon Thames 002,Kingston upon Thames,E09000021,5017 ,2391 ,2626 
E02000600,2013,Kingston upon Thames 003,Kingston upon Thames,E09000021,6066 ,2984 ,3082 
E02000601,2013,Kingston upon Thames 004,Kingston upon Thames,E09000021,7673 ,3769 ,3904 
E02000602,2013,Kingston upon Thames 005,Kingston upon Thames,E09000021,7269 ,3632 ,3637 
E02000603,2013,Kingston upon Thames 006,Kingston upon Thames,E09000021,5521 ,2672 ,2849 
E02000604,2013,Kingston upon Thames 007,Kingston upon Thames,E09000021,5938 ,3000 ,2938 
E02000605,2013,Kingston upon Thames 008,Kingston upon Thames,E09000021,5371 ,2671 ,2700 
E02000606,2013,Kingston upon Thames 009,Kingston upon Thames,E09000021,8420 ,4318 ,4102 
E02000607,2013,Kingston upon Thames 010,Kingston upon Thames,E09000021,5075 ,2459 ,2616 
E02000608,2013,Kingston upon Thames 011,Kingston upon Thames,E09000021,6203 ,2973 ,3230 
E02000609,2013,Kingston upon Thames 012,Kingston upon Thames,E09000021,4833 ,2395 ,2438 
E02000610,2013,Kingston upon Thames 013,Kingston upon Thames,E09000021,5777 ,2962 ,2815 
E02000611,2013,Kingston upon Thames 014,Kingston upon Thames,E09000021,4626 ,2303 ,2323 
E02000612,2013,Kingston upon Thames 015,Kingston upon Thames,E09000021,5308 ,2613 ,2695 
E02000613,2013,Kingston upon Thames 016,Kingston upon Thames,E09000021,5398 ,2613 ,2785 
E02000614,2013,Kingston upon Thames 017,Kingston upon Thames,E09000021,5876 ,2970 ,2906 
E02000615,2013,Kingston upon Thames 018,Kingston upon Thames,E09000021,5093 ,2580 ,2513 
E02000616,2013,Kingston upon Thames 019,Kingston upon Thames,E09000021,4120 ,2074 ,2046 
E02000617,2013,Kingston upon Thames 020,Kingston upon Thames,E09000021,5749 ,2797 ,2952 
E02000619,2013,Lambeth 002,Lambeth,E09000022,6145 ,3171 ,2974 
E02000620,2013,Lambeth 003,Lambeth,E09000022,7373 ,3923 ,3450 
E02000621,2013,Lambeth 004,Lambeth,E09000022,8890 ,4883 ,4007 
E02000622,2013,Lambeth 005,Lambeth,E09000022,6780 ,3735 ,3045 
E02000623,2013,Lambeth 006,Lambeth,E09000022,6175 ,3257 ,2918 
E02000624,2013,Lambeth 007,Lambeth,E09000022,6445 ,3407 ,3038 
E02000625,2013,Lambeth 008,Lambeth,E09000022,6192 ,3215 ,2977 
E02000626,2013,Lambeth 009,Lambeth,E09000022,5965 ,2974 ,2991 
E02000627,2013,Lambeth 010,Lambeth,E09000022,7401 ,3756 ,3645 
E02000628,2013,Lambeth 011,Lambeth,E09000022,6876 ,3455 ,3421 
E02000629,2013,Lambeth 012,Lambeth,E09000022,7189 ,3629 ,3560 
E02000630,2013,Lambeth 013,Lambeth,E09000022,6151 ,3167 ,2984 
E02000631,2013,Lambeth 014,Lambeth,E09000022,6942 ,3432 ,3510 
E02000632,2013,Lambeth 015,Lambeth,E09000022,7609 ,3792 ,3817 
E02000633,2013,Lambeth 016,Lambeth,E09000022,6684 ,3215 ,3469 
E02000634,2013,Lambeth 017,Lambeth,E09000022,5069 ,2428 ,2641 
E02000635,2013,Lambeth 018,Lambeth,E09000022,7202 ,3655 ,3547 
E02000636,2013,Lambeth 019,Lambeth,E09000022,5966 ,2971 ,2995 
E02000637,2013,Lambeth 020,Lambeth,E09000022,7031 ,3525 ,3506 
E02000638,2013,Lambeth 021,Lambeth,E09000022,8028 ,4284 ,3744 
E02000639,2013,Lambeth 022,Lambeth,E09000022,5772 ,2719 ,3053 
E02000640,2013,Lambeth 023,Lambeth,E09000022,7268 ,3501 ,3767 
E02000641,2013,Lambeth 024,Lambeth,E09000022,6191 ,2875 ,3316 
E02000642,2013,Lambeth 025,Lambeth,E09000022,6749 ,3289 ,3460 
E02000643,2013,Lambeth 026,Lambeth,E09000022,6771 ,3313 ,3458 
E02000644,2013,Lambeth 027,Lambeth,E09000022,6525 ,3269 ,3256 
E02000645,2013,Lambeth 028,Lambeth,E09000022,6747 ,3298 ,3449 
E02000646,2013,Lambeth 029,Lambeth,E09000022,7567 ,3892 ,3675 
E02000647,2013,Lambeth 030,Lambeth,E09000022,6154 ,3119 ,3035 
E02000648,2013,Lambeth 031,Lambeth,E09000022,5225 ,2286 ,2939 
E02000649,2013,Lambeth 032,Lambeth,E09000022,9398 ,4710 ,4688 
E02000650,2013,Lambeth 033,Lambeth,E09000022,5366 ,2488 ,2878 
E02000651,2013,Lambeth 034,Lambeth,E09000022,6663 ,3368 ,3295 
E02000652,2013,Lambeth 035,Lambeth,E09000022,5657 ,2927 ,2730 
E02006801,2013,Lambeth 036,Lambeth,E09000022,7311 ,3707 ,3604 
E02000653,2013,Lewisham 001,Lewisham,E09000023,6503 ,3358 ,3145 
E02000654,2013,Lewisham 002,Lewisham,E09000023,5780 ,2744 ,3036 
E02000655,2013,Lewisham 003,Lewisham,E09000023,6367 ,3084 ,3283 
E02000657,2013,Lewisham 005,Lewisham,E09000023,7370 ,3698 ,3672 
E02000658,2013,Lewisham 006,Lewisham,E09000023,6414 ,3308 ,3106 
E02000659,2013,Lewisham 007,Lewisham,E09000023,5708 ,2829 ,2879 
E02000660,2013,Lewisham 008,Lewisham,E09000023,6803 ,3424 ,3379 
E02000661,2013,Lewisham 009,Lewisham,E09000023,5029 ,2625 ,2404 
E02000662,2013,Lewisham 010,Lewisham,E09000023,6464 ,3244 ,3220 
E02000663,2013,Lewisham 011,Lewisham,E09000023,5507 ,2932 ,2575 
E02000664,2013,Lewisham 012,Lewisham,E09000023,7673 ,3855 ,3818 
E02000665,2013,Lewisham 013,Lewisham,E09000023,6061 ,3128 ,2933 
E02000666,2013,Lewisham 014,Lewisham,E09000023,5321 ,2529 ,2792 
E02000667,2013,Lewisham 015,Lewisham,E09000023,4788 ,2365 ,2423 
E02000668,2013,Lewisham 016,Lewisham,E09000023,4824 ,2437 ,2387 
E02000669,2013,Lewisham 017,Lewisham,E09000023,5639 ,2850 ,2789 
E02000670,2013,Lewisham 018,Lewisham,E09000023,4552 ,2170 ,2382 
E02000671,2013,Lewisham 019,Lewisham,E09000023,6060 ,2924 ,3136 
E02000672,2013,Lewisham 020,Lewisham,E09000023,6012 ,3194 ,2818 
E02000673,2013,Lewisham 021,Lewisham,E09000023,5723 ,2895 ,2828 
E02000674,2013,Lewisham 022,Lewisham,E09000023,5685 ,2632 ,3053 
E02000675,2013,Lewisham 023,Lewisham,E09000023,5752 ,2786 ,2966 
E02000676,2013,Lewisham 024,Lewisham,E09000023,5559 ,2706 ,2853 
E02000677,2013,Lewisham 025,Lewisham,E09000023,5079 ,2498 ,2581 
E02000678,2013,Lewisham 026,Lewisham,E09000023,4067 ,1891 ,2176 
E02000679,2013,Lewisham 027,Lewisham,E09000023,5665 ,2757 ,2908 
E02000680,2013,Lewisham 028,Lewisham,E09000023,4939 ,2494 ,2445 
E02000681,2013,Lewisham 029,Lewisham,E09000023,5482 ,2484 ,2998 
E02000682,2013,Lewisham 030,Lewisham,E09000023,5462 ,2633 ,2829 
E02000683,2013,Lewisham 031,Lewisham,E09000023,3920 ,1823 ,2097 
E02000685,2013,Lewisham 033,Lewisham,E09000023,5551 ,2659 ,2892 
E02000686,2013,Lewisham 034,Lewisham,E09000023,4483 ,2035 ,2448 
E02000687,2013,Lewisham 035,Lewisham,E09000023,5825 ,2987 ,2838 
E02006783,2013,Lewisham 037,Lewisham,E09000023,4655 ,2090 ,2565 
E02006784,2013,Lewisham 038,Lewisham,E09000023,5145 ,2463 ,2682 
E02006798,2013,Lewisham 039,Lewisham,E09000023,5671 ,2827 ,2844 
E02000689,2013,Merton 001,Merton,E09000024,5673 ,2690 ,2983 
E02000690,2013,Merton 002,Merton,E09000024,3213 ,1534 ,1679 
E02000691,2013,Merton 003,Merton,E09000024,5476 ,2692 ,2784 
E02000692,2013,Merton 004,Merton,E09000024,5266 ,2585 ,2681 
E02000693,2013,Merton 005,Merton,E09000024,7351 ,3749 ,3602 
E02000694,2013,Merton 006,Merton,E09000024,6634 ,3225 ,3409 
E02000695,2013,Merton 007,Merton,E09000024,5913 ,3216 ,2697 
E02000696,2013,Merton 008,Merton,E09000024,6289 ,3158 ,3131 
E02000697,2013,Merton 009,Merton,E09000024,6359 ,3184 ,3175 
E02000698,2013,Merton 010,Merton,E09000024,4915 ,2362 ,2553 
E02000699,2013,Merton 011,Merton,E09000024,5370 ,2618 ,2752 
E02000700,2013,Merton 012,Merton,E09000024,6093 ,2951 ,3142 
E02000701,2013,Merton 013,Merton,E09000024,5755 ,2873 ,2882 
E02000702,2013,Merton 014,Merton,E09000024,5549 ,2674 ,2875 
E02000703,2013,Merton 015,Merton,E09000024,5023 ,2530 ,2493 
E02000704,2013,Merton 016,Merton,E09000024,5672 ,2771 ,2901 
E02000705,2013,Merton 017,Merton,E09000024,5687 ,2808 ,2879 
E02000706,2013,Merton 018,Merton,E09000024,5950 ,2843 ,3107 
E02000707,2013,Merton 019,Merton,E09000024,5007 ,2382 ,2625 
E02000708,2013,Merton 020,Merton,E09000024,5611 ,2761 ,2850 
E02000709,2013,Merton 021,Merton,E09000024,4983 ,2510 ,2473 
E02000710,2013,Merton 022,Merton,E09000024,5627 ,2813 ,2814 
E02000711,2013,Merton 023,Merton,E09000024,5780 ,2900 ,2880 
E02000712,2013,Merton 024,Merton,E09000024,5762 ,2898 ,2864 
E02000713,2013,Merton 025,Merton,E09000024,4890 ,2448 ,2442 
E02000714,2013,Newham 001,Newham,E09000025,5896 ,3131 ,2765 
E02000715,2013,Newham 002,Newham,E09000025,4913 ,2643 ,2270 
E02000716,2013,Newham 003,Newham,E09000025,5224 ,2853 ,2371 
E02000717,2013,Newham 004,Newham,E09000025,5826 ,3179 ,2647 
E02000718,2013,Newham 005,Newham,E09000025,4563 ,2284 ,2279 
E02000719,2013,Newham 006,Newham,E09000025,6089 ,3183 ,2906 
E02000720,2013,Newham 007,Newham,E09000025,5418 ,2990 ,2428 
E02000721,2013,Newham 008,Newham,E09000025,6880 ,3797 ,3083 
E02000722,2013,Newham 009,Newham,E09000025,6274 ,3218 ,3056 
E02000723,2013,Newham 010,Newham,E09000025,7837 ,4393 ,3444 
E02000724,2013,Newham 011,Newham,E09000025,6695 ,3752 ,2943 
E02000725,2013,Newham 012,Newham,E09000025,7075 ,3601 ,3474 
E02000726,2013,Newham 013,Newham,E09000025,7812 ,4262 ,3550 
E02000727,2013,Newham 014,Newham,E09000025,5938 ,3466 ,2472 
E02000728,2013,Newham 015,Newham,E09000025,5771 ,3195 ,2576 
E02000729,2013,Newham 016,Newham,E09000025,5058 ,2656 ,2402 
E02000730,2013,Newham 017,Newham,E09000025,6387 ,3571 ,2816 
E02000731,2013,Newham 018,Newham,E09000025,7411 ,4398 ,3013 
E02000732,2013,Newham 019,Newham,E09000025,5197 ,2850 ,2347 
E02000733,2013,Newham 020,Newham,E09000025,7161 ,3738 ,3423 
E02000734,2013,Newham 021,Newham,E09000025,5674 ,2992 ,2682 
E02000735,2013,Newham 022,Newham,E09000025,5469 ,3098 ,2371 
E02000736,2013,Newham 023,Newham,E09000025,5763 ,3006 ,2757 
E02000737,2013,Newham 024,Newham,E09000025,6468 ,3318 ,3150 
E02000738,2013,Newham 025,Newham,E09000025,5966 ,3206 ,2760 
E02000739,2013,Newham 026,Newham,E09000025,5250 ,2754 ,2496 
E02000740,2013,Newham 027,Newham,E09000025,4936 ,2510 ,2426 
E02000741,2013,Newham 028,Newham,E09000025,5950 ,3079 ,2871 
E02000742,2013,Newham 029,Newham,E09000025,5528 ,2807 ,2721 
E02000743,2013,Newham 030,Newham,E09000025,5986 ,3098 ,2888 
E02000744,2013,Newham 031,Newham,E09000025,5860 ,2985 ,2875 
E02000745,2013,Newham 032,Newham,E09000025,5900 ,2868 ,3032 
E02000746,2013,Newham 033,Newham,E09000025,5895 ,2809 ,3086 
E02000747,2013,Newham 034,Newham,E09000025,8331 ,4394 ,3937 
E02000748,2013,Newham 035,Newham,E09000025,4381 ,2049 ,2332 
E02000749,2013,Newham 036,Newham,E09000025,5469 ,2582 ,2887 
E02000750,2013,Newham 037,Newham,E09000025,8583 ,4487 ,4096 
E02000751,2013,Redbridge 001,Redbridge,E09000026,6552 ,3197 ,3355 
E02000752,2013,Redbridge 002,Redbridge,E09000026,4426 ,2068 ,2358 
E02000753,2013,Redbridge 003,Redbridge,E09000026,4032 ,1886 ,2146 
E02000754,2013,Redbridge 004,Redbridge,E09000026,4484 ,2156 ,2328 
E02000755,2013,Redbridge 005,Redbridge,E09000026,3608 ,1759 ,1849 
E02000756,2013,Redbridge 006,Redbridge,E09000026,8630 ,4194 ,4436 
E02000757,2013,Redbridge 007,Redbridge,E09000026,8516 ,4217 ,4299 
E02000758,2013,Redbridge 008,Redbridge,E09000026,3842 ,1851 ,1991 
E02000759,2013,Redbridge 009,Redbridge,E09000026,8549 ,4149 ,4400 
E02000760,2013,Redbridge 010,Redbridge,E09000026,4500 ,2146 ,2354 
E02000762,2013,Redbridge 012,Redbridge,E09000026,4255 ,2133 ,2122 
E02000763,2013,Redbridge 013,Redbridge,E09000026,4528 ,2199 ,2329 
E02000764,2013,Redbridge 014,Redbridge,E09000026,8181 ,3959 ,4222 
E02000765,2013,Redbridge 015,Redbridge,E09000026,4270 ,2107 ,2163 
E02000767,2013,Redbridge 017,Redbridge,E09000026,5042 ,2459 ,2583 
E02000768,2013,Redbridge 018,Redbridge,E09000026,3707 ,1770 ,1937 
E02000769,2013,Redbridge 019,Redbridge,E09000026,9900 ,4791 ,5109 
E02000770,2013,Redbridge 020,Redbridge,E09000026,5050 ,2560 ,2490 
E02000772,2013,Redbridge 022,Redbridge,E09000026,5514 ,2842 ,2672 
E02000773,2013,Redbridge 023,Redbridge,E09000026,6450 ,3184 ,3266 
E02000774,2013,Redbridge 024,Redbridge,E09000026,5025 ,2607 ,2418 
E02000776,2013,Redbridge 026,Redbridge,E09000026,4417 ,2191 ,2226 
E02000777,2013,Redbridge 027,Redbridge,E09000026,3967 ,1906 ,2061 
E02000779,2013,Redbridge 029,Redbridge,E09000026,5468 ,2854 ,2614 
E02000780,2013,Redbridge 030,Redbridge,E09000026,10202 ,5217 ,4985 
E02000781,2013,Redbridge 031,Redbridge,E09000026,9134 ,4636 ,4498 
E02000782,2013,Redbridge 032,Redbridge,E09000026,6393 ,3253 ,3140 
E02000783,2013,Redbridge 033,Redbridge,E09000026,4589 ,2322 ,2267 
E02006800,2013,Redbridge 034,Redbridge,E09000026,9285 ,4719 ,4566 
E02006924,2013,Redbridge 035,Redbridge,E09000026,8800 ,4656 ,4144 
E02006925,2013,Redbridge 036,Redbridge,E09000026,8786 ,4290 ,4496 
E02000784,2013,Richmond upon Thames 001,Richmond upon Thames,E09000027,6750 ,3247 ,3503 
E02000785,2013,Richmond upon Thames 002,Richmond upon Thames,E09000027,6259 ,3042 ,3217 
E02000786,2013,Richmond upon Thames 003,Richmond upon Thames,E09000027,7623 ,3636 ,3987 
E02000787,2013,Richmond upon Thames 004,Richmond upon Thames,E09000027,7546 ,3663 ,3883 
E02000788,2013,Richmond upon Thames 005,Richmond upon Thames,E09000027,5860 ,2856 ,3004 
E02000789,2013,Richmond upon Thames 006,Richmond upon Thames,E09000027,4322 ,2160 ,2162 
E02000790,2013,Richmond upon Thames 007,Richmond upon Thames,E09000027,4430 ,2191 ,2239 
E02000791,2013,Richmond upon Thames 008,Richmond upon Thames,E09000027,4515 ,2302 ,2213 
E02000792,2013,Richmond upon Thames 009,Richmond upon Thames,E09000027,4751 ,2384 ,2367 
E02000793,2013,Richmond upon Thames 010,Richmond upon Thames,E09000027,5304 ,2667 ,2637 
E02000794,2013,Richmond upon Thames 011,Richmond upon Thames,E09000027,4596 ,2308 ,2288 
E02000795,2013,Richmond upon Thames 012,Richmond upon Thames,E09000027,3914 ,1898 ,2016 
E02000796,2013,Richmond upon Thames 013,Richmond upon Thames,E09000027,6729 ,3349 ,3380 
E02000797,2013,Richmond upon Thames 014,Richmond upon Thames,E09000027,5397 ,2706 ,2691 
E02000798,2013,Richmond upon Thames 015,Richmond upon Thames,E09000027,7192 ,3483 ,3709 
E02000799,2013,Richmond upon Thames 016,Richmond upon Thames,E09000027,4632 ,2223 ,2409 
E02000800,2013,Richmond upon Thames 017,Richmond upon Thames,E09000027,3433 ,1691 ,1742 
E02000801,2013,Richmond upon Thames 018,Richmond upon Thames,E09000027,4595 ,2203 ,2392 
E02000802,2013,Richmond upon Thames 019,Richmond upon Thames,E09000027,4513 ,2238 ,2275 
E02000803,2013,Richmond upon Thames 020,Richmond upon Thames,E09000027,6013 ,2841 ,3172 
E02000804,2013,Richmond upon Thames 021,Richmond upon Thames,E09000027,4826 ,2353 ,2473 
E02000805,2013,Richmond upon Thames 022,Richmond upon Thames,E09000027,7111 ,3519 ,3592 
E02000806,2013,Richmond upon Thames 023,Richmond upon Thames,E09000027,6489 ,3157 ,3332 
E02000807,2013,Southwark 001,Southwark,E09000028,7363 ,3760 ,3603 
E02000808,2013,Southwark 002,Southwark,E09000028,7907 ,4065 ,3842 
E02000809,2013,Southwark 003,Southwark,E09000028,11286 ,6287 ,4999 
E02000810,2013,Southwark 004,Southwark,E09000028,8420 ,4368 ,4052 
E02000812,2013,Southwark 006,Southwark,E09000028,8137 ,3857 ,4280 
E02000813,2013,Southwark 007,Southwark,E09000028,6940 ,3318 ,3622 
E02000814,2013,Southwark 008,Southwark,E09000028,7284 ,3709 ,3575 
E02000815,2013,Southwark 009,Southwark,E09000028,5385 ,2577 ,2808 
E02000816,2013,Southwark 010,Southwark,E09000028,7021 ,3446 ,3575 
E02000817,2013,Southwark 011,Southwark,E09000028,4469 ,2222 ,2247 
E02000818,2013,Southwark 012,Southwark,E09000028,5552 ,2756 ,2796 
E02000819,2013,Southwark 013,Southwark,E09000028,6396 ,3185 ,3211 
E02000820,2013,Southwark 014,Southwark,E09000028,6988 ,3779 ,3209 
E02000821,2013,Southwark 015,Southwark,E09000028,5622 ,2699 ,2923 
E02000822,2013,Southwark 016,Southwark,E09000028,5403 ,2696 ,2707 
E02000823,2013,Southwark 017,Southwark,E09000028,6004 ,2945 ,3059 
E02000824,2013,Southwark 018,Southwark,E09000028,6579 ,3152 ,3427 
E02000825,2013,Southwark 019,Southwark,E09000028,6679 ,3203 ,3476 
E02000826,2013,Southwark 020,Southwark,E09000028,6454 ,3211 ,3243 
E02000827,2013,Southwark 021,Southwark,E09000028,7738 ,3916 ,3822 
E02000828,2013,Southwark 022,Southwark,E09000028,6024 ,2939 ,3085 
E02000829,2013,Southwark 023,Southwark,E09000028,8289 ,4380 ,3909 
E02000830,2013,Southwark 024,Southwark,E09000028,6834 ,3310 ,3524 
E02000831,2013,Southwark 025,Southwark,E09000028,7236 ,3592 ,3644 
E02000832,2013,Southwark 026,Southwark,E09000028,7316 ,3495 ,3821 
E02000833,2013,Southwark 027,Southwark,E09000028,5407 ,2439 ,2968 
E02000834,2013,Southwark 028,Southwark,E09000028,7285 ,3422 ,3863 
E02000835,2013,Southwark 029,Southwark,E09000028,5290 ,2560 ,2730 
E02000836,2013,Southwark 030,Southwark,E09000028,6006 ,2949 ,3057 
E02000837,2013,Southwark 031,Southwark,E09000028,6161 ,3063 ,3098 
E02000838,2013,Southwark 032,Southwark,E09000028,6426 ,2994 ,3432 
E02000839,2013,Southwark 033,Southwark,E09000028,5367 ,2591 ,2776 
E02006802,2013,Southwark 034,Southwark,E09000028,6012 ,2906 ,3106 
E02000840,2013,Sutton 001,Sutton,E09000029,5525 ,2566 ,2959 
E02000841,2013,Sutton 002,Sutton,E09000029,5872 ,2796 ,3076 
E02000842,2013,Sutton 003,Sutton,E09000029,5130 ,2539 ,2591 
E02000843,2013,Sutton 004,Sutton,E09000029,5328 ,2576 ,2752 
E02000844,2013,Sutton 005,Sutton,E09000029,5280 ,2544 ,2736 
E02000845,2013,Sutton 006,Sutton,E09000029,6360 ,3102 ,3258 
E02000846,2013,Sutton 007,Sutton,E09000029,4617 ,2277 ,2340 
E02000847,2013,Sutton 008,Sutton,E09000029,5728 ,2847 ,2881 
E02000848,2013,Sutton 009,Sutton,E09000029,5119 ,2569 ,2550 
E02000849,2013,Sutton 010,Sutton,E09000029,5168 ,2546 ,2622 
E02000850,2013,Sutton 011,Sutton,E09000029,7003 ,3466 ,3537 
E02000851,2013,Sutton 012,Sutton,E09000029,6051 ,3086 ,2965 
E02000852,2013,Sutton 013,Sutton,E09000029,5236 ,2563 ,2673 
E02000853,2013,Sutton 014,Sutton,E09000029,5130 ,2473 ,2657 
E02000854,2013,Sutton 015,Sutton,E09000029,4868 ,2376 ,2492 
E02000855,2013,Sutton 016,Sutton,E09000029,5093 ,2512 ,2581 
E02000856,2013,Sutton 017,Sutton,E09000029,5833 ,2866 ,2967 
E02000857,2013,Sutton 018,Sutton,E09000029,5562 ,2793 ,2769 
E02000858,2013,Sutton 019,Sutton,E09000029,5129 ,2360 ,2769 
E02000859,2013,Sutton 020,Sutton,E09000029,5244 ,2513 ,2731 
E02000860,2013,Sutton 021,Sutton,E09000029,5499 ,2795 ,2704 
E02000861,2013,Sutton 022,Sutton,E09000029,4862 ,2384 ,2478 
E02000863,2013,Sutton 024,Sutton,E09000029,4034 ,1963 ,2071 
E02006836,2013,Sutton 025,Sutton,E09000029,5087 ,2508 ,2579 
E02000864,2013,Tower Hamlets 001,Tower Hamlets,E09000030,6203 ,3091 ,3112 
E02000865,2013,Tower Hamlets 002,Tower Hamlets,E09000030,5310 ,2613 ,2697 
E02000866,2013,Tower Hamlets 003,Tower Hamlets,E09000030,7337 ,3712 ,3625 
E02000867,2013,Tower Hamlets 004,Tower Hamlets,E09000030,8536 ,4370 ,4166 
E02000868,2013,Tower Hamlets 005,Tower Hamlets,E09000030,5436 ,2772 ,2664 
E02000869,2013,Tower Hamlets 006,Tower Hamlets,E09000030,4415 ,2315 ,2100 
E02000870,2013,Tower Hamlets 007,Tower Hamlets,E09000030,4702 ,2318 ,2384 
E02000871,2013,Tower Hamlets 008,Tower Hamlets,E09000030,6983 ,3579 ,3404 
E02000872,2013,Tower Hamlets 009,Tower Hamlets,E09000030,6348 ,3366 ,2982 
E02000873,2013,Tower Hamlets 010,Tower Hamlets,E09000030,6877 ,3340 ,3537 
E02000874,2013,Tower Hamlets 011,Tower Hamlets,E09000030,5125 ,2620 ,2505 
E02000875,2013,Tower Hamlets 012,Tower Hamlets,E09000030,7837 ,3991 ,3846 
E02000876,2013,Tower Hamlets 013,Tower Hamlets,E09000030,5935 ,3158 ,2777 
E02000877,2013,Tower Hamlets 014,Tower Hamlets,E09000030,7504 ,3835 ,3669 
E02000878,2013,Tower Hamlets 015,Tower Hamlets,E09000030,9072 ,4854 ,4218 
E02000879,2013,Tower Hamlets 016,Tower Hamlets,E09000030,5828 ,3018 ,2810 
E02000880,2013,Tower Hamlets 017,Tower Hamlets,E09000030,4432 ,2370 ,2062 
E02000881,2013,Tower Hamlets 018,Tower Hamlets,E09000030,4917 ,2406 ,2511 
E02000882,2013,Tower Hamlets 019,Tower Hamlets,E09000030,6163 ,3155 ,3008 
E02000883,2013,Tower Hamlets 020,Tower Hamlets,E09000030,5417 ,2700 ,2717 
E02000884,2013,Tower Hamlets 021,Tower Hamlets,E09000030,7838 ,4505 ,3333 
E02000885,2013,Tower Hamlets 022,Tower Hamlets,E09000030,4913 ,2572 ,2341 
E02000886,2013,Tower Hamlets 023,Tower Hamlets,E09000030,5874 ,3219 ,2655 
E02000887,2013,Tower Hamlets 024,Tower Hamlets,E09000030,6126 ,3022 ,3104 
E02000888,2013,Tower Hamlets 025,Tower Hamlets,E09000030,6537 ,3668 ,2869 
E02000889,2013,Tower Hamlets 026,Tower Hamlets,E09000030,5312 ,2915 ,2397 
E02000890,2013,Tower Hamlets 027,Tower Hamlets,E09000030,4603 ,2483 ,2120 
E02000891,2013,Tower Hamlets 028,Tower Hamlets,E09000030,10985 ,5955 ,5030 
E02000893,2013,Tower Hamlets 030,Tower Hamlets,E09000030,5016 ,2503 ,2513 
E02000894,2013,Tower Hamlets 031,Tower Hamlets,E09000030,8522 ,4446 ,4076 
E02006853,2013,Tower Hamlets 032,Tower Hamlets,E09000030,6515 ,3429 ,3086 
E02006854,2013,Tower Hamlets 033,Tower Hamlets,E09000030,5696 ,3185 ,2511 
E02000895,2013,Waltham Forest 001,Waltham Forest,E09000031,4803 ,2296 ,2507 
E02000896,2013,Waltham Forest 002,Waltham Forest,E09000031,5748 ,2849 ,2899 
E02000897,2013,Waltham Forest 003,Waltham Forest,E09000031,5234 ,2499 ,2735 
E02000898,2013,Waltham Forest 004,Waltham Forest,E09000031,5022 ,2498 ,2524 
E02000899,2013,Waltham Forest 005,Waltham Forest,E09000031,5429 ,2705 ,2724 
E02000900,2013,Waltham Forest 006,Waltham Forest,E09000031,5542 ,2652 ,2890 
E02000901,2013,Waltham Forest 007,Waltham Forest,E09000031,6409 ,3091 ,3318 
E02000902,2013,Waltham Forest 008,Waltham Forest,E09000031,5547 ,2709 ,2838 
E02000903,2013,Waltham Forest 009,Waltham Forest,E09000031,6027 ,2931 ,3096 
E02000904,2013,Waltham Forest 010,Waltham Forest,E09000031,5810 ,2940 ,2870 
E02000905,2013,Waltham Forest 011,Waltham Forest,E09000031,6767 ,3416 ,3351 
E02000906,2013,Waltham Forest 012,Waltham Forest,E09000031,6445 ,3226 ,3219 
E02000907,2013,Waltham Forest 013,Waltham Forest,E09000031,6811 ,3304 ,3507 
E02000908,2013,Waltham Forest 014,Waltham Forest,E09000031,8178 ,4386 ,3792 
E02000909,2013,Waltham Forest 015,Waltham Forest,E09000031,6201 ,3013 ,3188 
E02000910,2013,Waltham Forest 016,Waltham Forest,E09000031,7738 ,3897 ,3841 
E02000911,2013,Waltham Forest 017,Waltham Forest,E09000031,8072 ,4012 ,4060 
E02000912,2013,Waltham Forest 018,Waltham Forest,E09000031,6133 ,2966 ,3167 
E02000913,2013,Waltham Forest 019,Waltham Forest,E09000031,6315 ,3295 ,3020 
E02000914,2013,Waltham Forest 020,Waltham Forest,E09000031,7666 ,3893 ,3773 
E02000915,2013,Waltham Forest 021,Waltham Forest,E09000031,6752 ,3566 ,3186 
E02000916,2013,Waltham Forest 022,Waltham Forest,E09000031,6672 ,3339 ,3333 
E02000917,2013,Waltham Forest 023,Waltham Forest,E09000031,6774 ,3462 ,3312 
E02000918,2013,Waltham Forest 024,Waltham Forest,E09000031,6856 ,3596 ,3260 
E02000919,2013,Waltham Forest 025,Waltham Forest,E09000031,7097 ,3691 ,3406 
E02000920,2013,Waltham Forest 026,Waltham Forest,E09000031,7301 ,3648 ,3653 
E02000921,2013,Waltham Forest 027,Waltham Forest,E09000031,7838 ,3911 ,3927 
E02000922,2013,Waltham Forest 028,Waltham Forest,E09000031,7708 ,4248 ,3460 
E02000923,2013,Wandsworth 001,Wandsworth,E09000032,5717 ,2916 ,2801 
E02000924,2013,Wandsworth 002,Wandsworth,E09000032,9073 ,4486 ,4587 
E02000925,2013,Wandsworth 003,Wandsworth,E09000032,5539 ,2682 ,2857 
E02000926,2013,Wandsworth 004,Wandsworth,E09000032,7315 ,3635 ,3680 
E02000927,2013,Wandsworth 005,Wandsworth,E09000032,5484 ,2633 ,2851 
E02000928,2013,Wandsworth 006,Wandsworth,E09000032,6037 ,2856 ,3181 
E02000929,2013,Wandsworth 007,Wandsworth,E09000032,5123 ,2246 ,2877 
E02000930,2013,Wandsworth 008,Wandsworth,E09000032,8596 ,4137 ,4459 
E02000931,2013,Wandsworth 009,Wandsworth,E09000032,6999 ,3563 ,3436 
E02000932,2013,Wandsworth 010,Wandsworth,E09000032,8391 ,4110 ,4281 
E02000933,2013,Wandsworth 011,Wandsworth,E09000032,6216 ,2949 ,3267 
E02000934,2013,Wandsworth 012,Wandsworth,E09000032,7912 ,3996 ,3916 
E02000935,2013,Wandsworth 013,Wandsworth,E09000032,4889 ,2085 ,2804 
E02000936,2013,Wandsworth 014,Wandsworth,E09000032,6562 ,3124 ,3438 
E02000937,2013,Wandsworth 015,Wandsworth,E09000032,5677 ,2789 ,2888 
E02000938,2013,Wandsworth 016,Wandsworth,E09000032,6822 ,3224 ,3598 
E02000939,2013,Wandsworth 017,Wandsworth,E09000032,5320 ,2629 ,2691 
E02000940,2013,Wandsworth 018,Wandsworth,E09000032,5894 ,2814 ,3080 
E02000941,2013,Wandsworth 019,Wandsworth,E09000032,7271 ,3516 ,3755 
E02000942,2013,Wandsworth 020,Wandsworth,E09000032,6460 ,3035 ,3425 
E02000943,2013,Wandsworth 021,Wandsworth,E09000032,6428 ,3140 ,3288 
E02000944,2013,Wandsworth 022,Wandsworth,E09000032,5032 ,2333 ,2699 
E02000945,2013,Wandsworth 023,Wandsworth,E09000032,5735 ,2670 ,3065 
E02000946,2013,Wandsworth 024,Wandsworth,E09000032,6454 ,3459 ,2995 
E02000947,2013,Wandsworth 025,Wandsworth,E09000032,6169 ,2824 ,3345 
E02000948,2013,Wandsworth 026,Wandsworth,E09000032,7699 ,3591 ,4108 
E02000949,2013,Wandsworth 027,Wandsworth,E09000032,6995 ,3336 ,3659 
E02000950,2013,Wandsworth 028,Wandsworth,E09000032,5394 ,2537 ,2857 
E02000951,2013,Wandsworth 029,Wandsworth,E09000032,5000 ,2366 ,2634 
E02000952,2013,Wandsworth 030,Wandsworth,E09000032,4451 ,2108 ,2343 
E02000953,2013,Wandsworth 031,Wandsworth,E09000032,5752 ,2544 ,3208 
E02000954,2013,Wandsworth 032,Wandsworth,E09000032,4432 ,2068 ,2364 
E02000955,2013,Wandsworth 033,Wandsworth,E09000032,4530 ,2131 ,2399 
E02000956,2013,Wandsworth 034,Wandsworth,E09000032,5798 ,2712 ,3086 
E02000957,2013,Wandsworth 035,Wandsworth,E09000032,8082 ,3955 ,4127 
E02000958,2013,Wandsworth 036,Wandsworth,E09000032,5782 ,2832 ,2950 
E02000959,2013,Wandsworth 037,Wandsworth,E09000032,5489 ,2707 ,2782 
E02000960,2013,Westminster 001,Westminster,E09000033,4614 ,2227 ,2387 
E02000961,2013,Westminster 002,Westminster,E09000033,6665 ,3180 ,3485 
E02000962,2013,Westminster 003,Westminster,E09000033,5883 ,2930 ,2953 
E02000963,2013,Westminster 004,Westminster,E09000033,7272 ,3417 ,3855 
E02000964,2013,Westminster 005,Westminster,E09000033,9396 ,4519 ,4877 
E02000965,2013,Westminster 006,Westminster,E09000033,6629 ,3356 ,3273 
E02000966,2013,Westminster 007,Westminster,E09000033,7147 ,3580 ,3567 
E02000967,2013,Westminster 008,Westminster,E09000033,6138 ,3273 ,2865 
E02000968,2013,Westminster 009,Westminster,E09000033,9834 ,4802 ,5032 
E02000969,2013,Westminster 010,Westminster,E09000033,6288 ,3039 ,3249 
E02000970,2013,Westminster 011,Westminster,E09000033,7386 ,4049 ,3337 
E02000971,2013,Westminster 012,Westminster,E09000033,6526 ,3610 ,2916 
E02000972,2013,Westminster 013,Westminster,E09000033,7506 ,4428 ,3078 
E02000973,2013,Westminster 014,Westminster,E09000033,7852 ,3966 ,3886 
E02000974,2013,Westminster 015,Westminster,E09000033,6389 ,3616 ,2773 
E02000975,2013,Westminster 016,Westminster,E09000033,7535 ,4092 ,3443 
E02000976,2013,Westminster 017,Westminster,E09000033,7746 ,4067 ,3679 
E02000977,2013,Westminster 018,Westminster,E09000033,5650 ,3568 ,2082 
E02000978,2013,Westminster 019,Westminster,E09000033,7337 ,4118 ,3219 
E02000979,2013,Westminster 020,Westminster,E09000033,6618 ,3710 ,2908 
E02000980,2013,Westminster 021,Westminster,E09000033,6622 ,3464 ,3158 
E02000981,2013,Westminster 022,Westminster,E09000033,7287 ,3704 ,3583 
E02000982,2013,Westminster 023,Westminster,E09000033,6131 ,3085 ,3046 
E02000983,2013,Westminster 024,Westminster,E09000033,6160 ,3101 ,3059 
E02000001,2014,City of London 001,City of London,E09000001,6010 ,3437 ,2573 
E02000002,2014,Barking and Dagenham 001,Barking and Dagenham,E09000002,4258 ,1972 ,2286 
E02000003,2014,Barking and Dagenham 002,Barking and Dagenham,E09000002,6972 ,3431 ,3541 
E02000004,2014,Barking and Dagenham 003,Barking and Dagenham,E09000002,4167 ,2020 ,2147 
E02000005,2014,Barking and Dagenham 004,Barking and Dagenham,E09000002,5775 ,2781 ,2994 
E02000007,2014,Barking and Dagenham 006,Barking and Dagenham,E09000002,5790 ,2770 ,3020 
E02000008,2014,Barking and Dagenham 007,Barking and Dagenham,E09000002,7694 ,3630 ,4064 
E02000009,2014,Barking and Dagenham 008,Barking and Dagenham,E09000002,6314 ,3063 ,3251 
E02000010,2014,Barking and Dagenham 009,Barking and Dagenham,E09000002,5826 ,2736 ,3090 
E02000011,2014,Barking and Dagenham 010,Barking and Dagenham,E09000002,4199 ,2108 ,2091 
E02000012,2014,Barking and Dagenham 011,Barking and Dagenham,E09000002,7042 ,3490 ,3552 
E02000013,2014,Barking and Dagenham 012,Barking and Dagenham,E09000002,5366 ,2540 ,2826 
E02000014,2014,Barking and Dagenham 013,Barking and Dagenham,E09000002,6046 ,2862 ,3184 
E02000015,2014,Barking and Dagenham 014,Barking and Dagenham,E09000002,4903 ,2327 ,2576 
E02000016,2014,Barking and Dagenham 015,Barking and Dagenham,E09000002,5794 ,3072 ,2722 
E02000017,2014,Barking and Dagenham 016,Barking and Dagenham,E09000002,6141 ,3300 ,2841 
E02000018,2014,Barking and Dagenham 017,Barking and Dagenham,E09000002,5824 ,2796 ,3028 
E02000019,2014,Barking and Dagenham 018,Barking and Dagenham,E09000002,5690 ,2751 ,2939 
E02000020,2014,Barking and Dagenham 019,Barking and Dagenham,E09000002,6888 ,3450 ,3438 
E02000021,2014,Barking and Dagenham 020,Barking and Dagenham,E09000002,5418 ,2602 ,2816 
E02000022,2014,Barking and Dagenham 021,Barking and Dagenham,E09000002,5332 ,2666 ,2666 
E02000023,2014,Barking and Dagenham 022,Barking and Dagenham,E09000002,4127 ,1980 ,2147 
E02006799,2014,Barking and Dagenham 023,Barking and Dagenham,E09000002,6839 ,3264 ,3575 
E02000024,2014,Barnet 001,Barnet,E09000003,6888 ,3342 ,3546 
E02000025,2014,Barnet 002,Barnet,E09000003,5562 ,2678 ,2884 
E02000026,2014,Barnet 003,Barnet,E09000003,4194 ,2037 ,2157 
E02000027,2014,Barnet 004,Barnet,E09000003,6273 ,2951 ,3322 
E02000028,2014,Barnet 005,Barnet,E09000003,4279 ,2131 ,2148 
E02000029,2014,Barnet 006,Barnet,E09000003,5837 ,2826 ,3011 
E02000030,2014,Barnet 007,Barnet,E09000003,5818 ,2790 ,3028 
E02000031,2014,Barnet 008,Barnet,E09000003,4711 ,2314 ,2397 
E02000032,2014,Barnet 009,Barnet,E09000003,5063 ,2474 ,2589 
E02000033,2014,Barnet 010,Barnet,E09000003,5876 ,2857 ,3019 
E02000034,2014,Barnet 011,Barnet,E09000003,5742 ,2719 ,3023 
E02000035,2014,Barnet 012,Barnet,E09000003,5588 ,2692 ,2896 
E02000036,2014,Barnet 013,Barnet,E09000003,7288 ,3569 ,3719 
E02000037,2014,Barnet 014,Barnet,E09000003,5744 ,2746 ,2998 
E02000038,2014,Barnet 015,Barnet,E09000003,7700 ,3926 ,3774 
E02000039,2014,Barnet 016,Barnet,E09000003,4502 ,2195 ,2307 
E02000040,2014,Barnet 017,Barnet,E09000003,4656 ,2253 ,2403 
E02000041,2014,Barnet 018,Barnet,E09000003,6066 ,3019 ,3047 
E02000042,2014,Barnet 019,Barnet,E09000003,7862 ,3940 ,3922 
E02000043,2014,Barnet 020,Barnet,E09000003,4947 ,2398 ,2549 
E02000044,2014,Barnet 021,Barnet,E09000003,5634 ,2622 ,3012 
E02000045,2014,Barnet 022,Barnet,E09000003,7475 ,3651 ,3824 
E02000046,2014,Barnet 023,Barnet,E09000003,5182 ,2663 ,2519 
E02000047,2014,Barnet 024,Barnet,E09000003,7998 ,3871 ,4127 
E02000048,2014,Barnet 025,Barnet,E09000003,6531 ,3221 ,3310 
E02000049,2014,Barnet 026,Barnet,E09000003,5715 ,2637 ,3078 
E02000050,2014,Barnet 027,Barnet,E09000003,7223 ,3546 ,3677 
E02000051,2014,Barnet 028,Barnet,E09000003,5765 ,2948 ,2817 
E02000052,2014,Barnet 029,Barnet,E09000003,7281 ,3635 ,3646 
E02000053,2014,Barnet 030,Barnet,E09000003,8318 ,4348 ,3970 
E02000054,2014,Barnet 031,Barnet,E09000003,5410 ,2725 ,2685 
E02000055,2014,Barnet 032,Barnet,E09000003,8215 ,4328 ,3887 
E02000056,2014,Barnet 033,Barnet,E09000003,5496 ,2602 ,2894 
E02000057,2014,Barnet 034,Barnet,E09000003,4852 ,2479 ,2373 
E02000058,2014,Barnet 035,Barnet,E09000003,6682 ,3214 ,3468 
E02000059,2014,Barnet 036,Barnet,E09000003,7927 ,4104 ,3823 
E02000060,2014,Barnet 037,Barnet,E09000003,6867 ,3507 ,3360 
E02000061,2014,Barnet 038,Barnet,E09000003,5793 ,3019 ,2774 
E02000062,2014,Barnet 039,Barnet,E09000003,4591 ,2257 ,2334 
E02000063,2014,Barnet 040,Barnet,E09000003,5054 ,2580 ,2474 
E02000064,2014,Barnet 041,Barnet,E09000003,4502 ,2186 ,2316 
E02000065,2014,Bexley 001,Bexley,E09000004,5477 ,2639 ,2838 
E02000066,2014,Bexley 002,Bexley,E09000004,6630 ,3141 ,3489 
E02000067,2014,Bexley 003,Bexley,E09000004,6178 ,2987 ,3191 
E02000068,2014,Bexley 004,Bexley,E09000004,5065 ,2421 ,2644 
E02000069,2014,Bexley 005,Bexley,E09000004,3833 ,1889 ,1944 
E02000070,2014,Bexley 006,Bexley,E09000004,5088 ,2452 ,2636 
E02000071,2014,Bexley 007,Bexley,E09000004,5012 ,2414 ,2598 
E02000072,2014,Bexley 008,Bexley,E09000004,7281 ,3339 ,3942 
E02000073,2014,Bexley 009,Bexley,E09000004,6759 ,3295 ,3464 
E02000074,2014,Bexley 010,Bexley,E09000004,5034 ,2353 ,2681 
E02000075,2014,Bexley 011,Bexley,E09000004,5077 ,2511 ,2566 
E02000077,2014,Bexley 013,Bexley,E09000004,5266 ,2542 ,2724 
E02000078,2014,Bexley 014,Bexley,E09000004,5055 ,2449 ,2606 
E02000079,2014,Bexley 015,Bexley,E09000004,5210 ,2550 ,2660 
E02000080,2014,Bexley 016,Bexley,E09000004,6377 ,3095 ,3282 
E02000081,2014,Bexley 017,Bexley,E09000004,4676 ,2311 ,2365 
E02000082,2014,Bexley 018,Bexley,E09000004,6001 ,2975 ,3026 
E02000083,2014,Bexley 019,Bexley,E09000004,6934 ,3474 ,3460 
E02000084,2014,Bexley 020,Bexley,E09000004,7070 ,3531 ,3539 
E02000085,2014,Bexley 021,Bexley,E09000004,5235 ,2514 ,2721 
E02000086,2014,Bexley 022,Bexley,E09000004,4849 ,2399 ,2450 
E02000087,2014,Bexley 023,Bexley,E09000004,4685 ,2283 ,2402 
E02000088,2014,Bexley 024,Bexley,E09000004,4959 ,2450 ,2509 
E02000089,2014,Bexley 025,Bexley,E09000004,4982 ,2447 ,2535 
E02000090,2014,Bexley 026,Bexley,E09000004,5827 ,2773 ,3054 
E02000091,2014,Bexley 027,Bexley,E09000004,6157 ,2927 ,3230 
E02000092,2014,Bexley 028,Bexley,E09000004,4117 ,1909 ,2208 
E02006785,2014,Bexley 029,Bexley,E09000004,4205 ,2049 ,2156 
E02000093,2014,Brent 001,Brent,E09000005,7353 ,3677 ,3676 
E02000094,2014,Brent 002,Brent,E09000005,5868 ,2992 ,2876 
E02000095,2014,Brent 003,Brent,E09000005,6693 ,3441 ,3252 
E02000096,2014,Brent 004,Brent,E09000005,4781 ,2346 ,2435 
E02000097,2014,Brent 005,Brent,E09000005,5953 ,3090 ,2863 
E02000098,2014,Brent 006,Brent,E09000005,5478 ,2790 ,2688 
E02000099,2014,Brent 007,Brent,E09000005,5877 ,2973 ,2904 
E02000100,2014,Brent 008,Brent,E09000005,6356 ,2987 ,3369 
E02000101,2014,Brent 009,Brent,E09000005,6333 ,3177 ,3156 
E02000102,2014,Brent 010,Brent,E09000005,5001 ,2486 ,2515 
E02000103,2014,Brent 011,Brent,E09000005,5783 ,2904 ,2879 
E02000104,2014,Brent 012,Brent,E09000005,4516 ,2356 ,2160 
E02000105,2014,Brent 013,Brent,E09000005,6574 ,3487 ,3087 
E02000106,2014,Brent 014,Brent,E09000005,7319 ,3815 ,3504 
E02000107,2014,Brent 015,Brent,E09000005,8329 ,4460 ,3869 
E02000108,2014,Brent 016,Brent,E09000005,4535 ,2356 ,2179 
E02000109,2014,Brent 017,Brent,E09000005,7489 ,4020 ,3469 
E02000110,2014,Brent 018,Brent,E09000005,6151 ,3168 ,2983 
E02000111,2014,Brent 019,Brent,E09000005,7331 ,3975 ,3356 
E02000112,2014,Brent 020,Brent,E09000005,6921 ,3806 ,3115 
E02000113,2014,Brent 021,Brent,E09000005,6153 ,2941 ,3212 
E02000114,2014,Brent 022,Brent,E09000005,7068 ,3748 ,3320 
E02000115,2014,Brent 023,Brent,E09000005,6376 ,3348 ,3028 
E02000116,2014,Brent 024,Brent,E09000005,6346 ,3236 ,3110 
E02000117,2014,Brent 025,Brent,E09000005,7970 ,3939 ,4031 
E02000118,2014,Brent 026,Brent,E09000005,7198 ,3833 ,3365 
E02000119,2014,Brent 027,Brent,E09000005,4925 ,2348 ,2577 
E02000120,2014,Brent 028,Brent,E09000005,6990 ,3397 ,3593 
E02000121,2014,Brent 029,Brent,E09000005,6899 ,3636 ,3263 
E02000122,2014,Brent 030,Brent,E09000005,5375 ,2621 ,2754 
E02000123,2014,Brent 031,Brent,E09000005,10913 ,5701 ,5212 
E02000124,2014,Brent 032,Brent,E09000005,7571 ,3799 ,3772 
E02000125,2014,Brent 033,Brent,E09000005,7654 ,3791 ,3863 
E02000126,2014,Brent 034,Brent,E09000005,4902 ,2416 ,2486 
E02000127,2014,Bromley 001,Bromley,E09000006,5707 ,2623 ,3084 
E02000128,2014,Bromley 002,Bromley,E09000006,4807 ,2279 ,2528 
E02000130,2014,Bromley 004,Bromley,E09000006,5745 ,2702 ,3043 
E02000131,2014,Bromley 005,Bromley,E09000006,7350 ,3681 ,3669 
E02000132,2014,Bromley 006,Bromley,E09000006,6640 ,3353 ,3287 
E02000133,2014,Bromley 007,Bromley,E09000006,6420 ,3092 ,3328 
E02000134,2014,Bromley 008,Bromley,E09000006,7775 ,3817 ,3958 
E02000135,2014,Bromley 009,Bromley,E09000006,7089 ,3443 ,3646 
E02000136,2014,Bromley 010,Bromley,E09000006,3447 ,1649 ,1798 
E02000137,2014,Bromley 011,Bromley,E09000006,5206 ,2531 ,2675 
E02000138,2014,Bromley 012,Bromley,E09000006,5332 ,2695 ,2637 
E02000139,2014,Bromley 013,Bromley,E09000006,5291 ,2550 ,2741 
E02000140,2014,Bromley 014,Bromley,E09000006,5092 ,2326 ,2766 
E02000141,2014,Bromley 015,Bromley,E09000006,5069 ,2445 ,2624 
E02000142,2014,Bromley 016,Bromley,E09000006,5510 ,2662 ,2848 
E02000144,2014,Bromley 018,Bromley,E09000006,6112 ,3097 ,3015 
E02000145,2014,Bromley 019,Bromley,E09000006,5254 ,2390 ,2864 
E02000146,2014,Bromley 020,Bromley,E09000006,5872 ,2843 ,3029 
E02000147,2014,Bromley 021,Bromley,E09000006,4899 ,2408 ,2491 
E02000148,2014,Bromley 022,Bromley,E09000006,3943 ,1930 ,2013 
E02000149,2014,Bromley 023,Bromley,E09000006,4973 ,2329 ,2644 
E02000150,2014,Bromley 024,Bromley,E09000006,5583 ,2722 ,2861 
E02000151,2014,Bromley 025,Bromley,E09000006,4537 ,2207 ,2330 
E02000152,2014,Bromley 026,Bromley,E09000006,4515 ,2131 ,2384 
E02000153,2014,Bromley 027,Bromley,E09000006,4878 ,2339 ,2539 
E02000154,2014,Bromley 028,Bromley,E09000006,5263 ,2592 ,2671 
E02000155,2014,Bromley 029,Bromley,E09000006,4226 ,2055 ,2171 
E02000156,2014,Bromley 030,Bromley,E09000006,7474 ,3637 ,3837 
E02000157,2014,Bromley 031,Bromley,E09000006,4724 ,2336 ,2388 
E02000158,2014,Bromley 032,Bromley,E09000006,4466 ,2132 ,2334 
E02000159,2014,Bromley 033,Bromley,E09000006,4167 ,2031 ,2136 
E02000160,2014,Bromley 034,Bromley,E09000006,4958 ,2431 ,2527 
E02000161,2014,Bromley 035,Bromley,E09000006,5304 ,2562 ,2742 
E02000162,2014,Bromley 036,Bromley,E09000006,4008 ,1865 ,2143 
E02000163,2014,Bromley 037,Bromley,E09000006,4647 ,2256 ,2391 
E02000165,2014,Bromley 039,Bromley,E09000006,4679 ,2286 ,2393 
E02006782,2014,Bromley 040,Bromley,E09000006,4838 ,2281 ,2557 
E02006787,2014,Bromley 041,Bromley,E09000006,5070 ,2377 ,2693 
E02006789,2014,Bromley 042,Bromley,E09000006,3799 ,1814 ,1985 
E02000166,2014,Camden 001,Camden,E09000007,5336 ,2472 ,2864 
E02000167,2014,Camden 002,Camden,E09000007,5215 ,2627 ,2588 
E02000168,2014,Camden 003,Camden,E09000007,6222 ,2998 ,3224 
E02000169,2014,Camden 004,Camden,E09000007,5538 ,2674 ,2864 
E02000170,2014,Camden 005,Camden,E09000007,6398 ,3302 ,3096 
E02000171,2014,Camden 006,Camden,E09000007,5915 ,2889 ,3026 
E02000172,2014,Camden 007,Camden,E09000007,7851 ,3853 ,3998 
E02000173,2014,Camden 008,Camden,E09000007,6016 ,3104 ,2912 
E02000174,2014,Camden 009,Camden,E09000007,6669 ,3156 ,3513 
E02000175,2014,Camden 010,Camden,E09000007,7390 ,3623 ,3767 
E02000176,2014,Camden 011,Camden,E09000007,5065 ,2584 ,2481 
E02000177,2014,Camden 012,Camden,E09000007,6567 ,3148 ,3419 
E02000178,2014,Camden 013,Camden,E09000007,7245 ,3793 ,3452 
E02000179,2014,Camden 014,Camden,E09000007,4519 ,2230 ,2289 
E02000180,2014,Camden 015,Camden,E09000007,6202 ,3066 ,3136 
E02000181,2014,Camden 016,Camden,E09000007,6188 ,3094 ,3094 
E02000182,2014,Camden 017,Camden,E09000007,5113 ,2450 ,2663 
E02000183,2014,Camden 018,Camden,E09000007,5579 ,2794 ,2785 
E02000184,2014,Camden 019,Camden,E09000007,6498 ,3220 ,3278 
E02000185,2014,Camden 020,Camden,E09000007,6039 ,2954 ,3085 
E02000186,2014,Camden 021,Camden,E09000007,5289 ,2826 ,2463 
E02000187,2014,Camden 022,Camden,E09000007,5966 ,2896 ,3070 
E02000188,2014,Camden 023,Camden,E09000007,5894 ,3044 ,2850 
E02000189,2014,Camden 024,Camden,E09000007,4590 ,2296 ,2294 
E02000190,2014,Camden 025,Camden,E09000007,6290 ,3202 ,3088 
E02000191,2014,Camden 026,Camden,E09000007,7255 ,4014 ,3241 
E02000192,2014,Camden 027,Camden,E09000007,5746 ,3196 ,2550 
E02000193,2014,Camden 028,Camden,E09000007,6726 ,3715 ,3011 
E02000194,2014,Croydon 001,Croydon,E09000008,6534 ,3267 ,3267 
E02000195,2014,Croydon 002,Croydon,E09000008,6391 ,3145 ,3246 
E02000196,2014,Croydon 003,Croydon,E09000008,5292 ,2631 ,2661 
E02000197,2014,Croydon 004,Croydon,E09000008,6138 ,2937 ,3201 
E02000198,2014,Croydon 005,Croydon,E09000008,5592 ,2637 ,2955 
E02000199,2014,Croydon 006,Croydon,E09000008,5700 ,2719 ,2981 
E02000200,2014,Croydon 007,Croydon,E09000008,6021 ,2881 ,3140 
E02000201,2014,Croydon 008,Croydon,E09000008,5954 ,2826 ,3128 
E02000202,2014,Croydon 009,Croydon,E09000008,5627 ,2827 ,2800 
E02000203,2014,Croydon 010,Croydon,E09000008,5224 ,2554 ,2670 
E02000204,2014,Croydon 011,Croydon,E09000008,6244 ,3037 ,3207 
E02000206,2014,Croydon 013,Croydon,E09000008,6460 ,3115 ,3345 
E02000207,2014,Croydon 014,Croydon,E09000008,6284 ,3025 ,3259 
E02000208,2014,Croydon 015,Croydon,E09000008,6861 ,3337 ,3524 
E02000209,2014,Croydon 016,Croydon,E09000008,5673 ,2745 ,2928 
E02000210,2014,Croydon 017,Croydon,E09000008,5826 ,2793 ,3033 
E02000211,2014,Croydon 018,Croydon,E09000008,5251 ,2549 ,2702 
E02000212,2014,Croydon 019,Croydon,E09000008,5801 ,2869 ,2932 
E02000213,2014,Croydon 020,Croydon,E09000008,6764 ,3415 ,3349 
E02000214,2014,Croydon 021,Croydon,E09000008,4311 ,2108 ,2203 
E02000215,2014,Croydon 022,Croydon,E09000008,7649 ,4057 ,3592 
E02000216,2014,Croydon 023,Croydon,E09000008,4184 ,2132 ,2052 
E02000217,2014,Croydon 024,Croydon,E09000008,7619 ,3816 ,3803 
E02000218,2014,Croydon 025,Croydon,E09000008,4225 ,1904 ,2321 
E02000219,2014,Croydon 026,Croydon,E09000008,4829 ,2344 ,2485 
E02000220,2014,Croydon 027,Croydon,E09000008,7848 ,4081 ,3767 
E02000221,2014,Croydon 028,Croydon,E09000008,6762 ,3183 ,3579 
E02000222,2014,Croydon 029,Croydon,E09000008,5747 ,2879 ,2868 
E02000223,2014,Croydon 030,Croydon,E09000008,4910 ,2098 ,2812 
E02000224,2014,Croydon 031,Croydon,E09000008,5464 ,2734 ,2730 
E02000225,2014,Croydon 032,Croydon,E09000008,4920 ,2291 ,2629 
E02000226,2014,Croydon 033,Croydon,E09000008,4986 ,2478 ,2508 
E02000227,2014,Croydon 034,Croydon,E09000008,7551 ,3519 ,4032 
E02000228,2014,Croydon 035,Croydon,E09000008,4730 ,2310 ,2420 
E02000229,2014,Croydon 036,Croydon,E09000008,3978 ,1855 ,2123 
E02000230,2014,Croydon 037,Croydon,E09000008,6757 ,3360 ,3397 
E02000231,2014,Croydon 038,Croydon,E09000008,5048 ,2459 ,2589 
E02000232,2014,Croydon 039,Croydon,E09000008,3944 ,1889 ,2055 
E02000233,2014,Croydon 040,Croydon,E09000008,4060 ,1941 ,2119 
E02000234,2014,Croydon 041,Croydon,E09000008,5414 ,2647 ,2767 
E02000235,2014,Croydon 042,Croydon,E09000008,4680 ,2243 ,2437 
E02000236,2014,Croydon 043,Croydon,E09000008,5018 ,2451 ,2567 
E02000237,2014,Croydon 044,Croydon,E09000008,4626 ,2205 ,2421 
E02006788,2014,Croydon 045,Croydon,E09000008,5001 ,2236 ,2765 
E02000238,2014,Ealing 001,Ealing,E09000009,6533 ,3354 ,3179 
E02000239,2014,Ealing 002,Ealing,E09000009,6195 ,3218 ,2977 
E02000240,2014,Ealing 003,Ealing,E09000009,6706 ,3196 ,3510 
E02000241,2014,Ealing 004,Ealing,E09000009,4614 ,2343 ,2271 
E02000242,2014,Ealing 005,Ealing,E09000009,4761 ,2529 ,2232 
E02000243,2014,Ealing 006,Ealing,E09000009,5828 ,2947 ,2881 
E02000244,2014,Ealing 007,Ealing,E09000009,4978 ,2654 ,2324 
E02000245,2014,Ealing 008,Ealing,E09000009,5461 ,2555 ,2906 
E02000246,2014,Ealing 009,Ealing,E09000009,5618 ,2647 ,2971 
E02000247,2014,Ealing 010,Ealing,E09000009,6622 ,3190 ,3432 
E02000248,2014,Ealing 011,Ealing,E09000009,5124 ,2651 ,2473 
E02000249,2014,Ealing 012,Ealing,E09000009,5094 ,2517 ,2577 
E02000250,2014,Ealing 013,Ealing,E09000009,4072 ,1940 ,2132 
E02000251,2014,Ealing 014,Ealing,E09000009,5351 ,2749 ,2602 
E02000252,2014,Ealing 015,Ealing,E09000009,7725 ,4050 ,3675 
E02000253,2014,Ealing 016,Ealing,E09000009,5960 ,2851 ,3109 
E02000254,2014,Ealing 017,Ealing,E09000009,5995 ,3075 ,2920 
E02000255,2014,Ealing 018,Ealing,E09000009,6157 ,2934 ,3223 
E02000256,2014,Ealing 019,Ealing,E09000009,6391 ,3304 ,3087 
E02000257,2014,Ealing 020,Ealing,E09000009,9629 ,4973 ,4656 
E02000258,2014,Ealing 021,Ealing,E09000009,4996 ,2626 ,2370 
E02000259,2014,Ealing 022,Ealing,E09000009,4223 ,2036 ,2187 
E02000260,2014,Ealing 023,Ealing,E09000009,6115 ,3252 ,2863 
E02000261,2014,Ealing 024,Ealing,E09000009,8028 ,4010 ,4018 
E02000262,2014,Ealing 025,Ealing,E09000009,6498 ,3286 ,3212 
E02000263,2014,Ealing 026,Ealing,E09000009,8055 ,4407 ,3648 
E02000264,2014,Ealing 027,Ealing,E09000009,5803 ,2972 ,2831 
E02000265,2014,Ealing 028,Ealing,E09000009,7416 ,3736 ,3680 
E02000266,2014,Ealing 029,Ealing,E09000009,7921 ,3959 ,3962 
E02000267,2014,Ealing 030,Ealing,E09000009,4966 ,2401 ,2565 
E02000268,2014,Ealing 031,Ealing,E09000009,6478 ,3267 ,3211 
E02000269,2014,Ealing 032,Ealing,E09000009,5617 ,2796 ,2821 
E02000270,2014,Ealing 033,Ealing,E09000009,5266 ,2500 ,2766 
E02000271,2014,Ealing 034,Ealing,E09000009,4579 ,2282 ,2297 
E02000272,2014,Ealing 035,Ealing,E09000009,4327 ,2136 ,2191 
E02000274,2014,Ealing 037,Ealing,E09000009,9242 ,5120 ,4122 
E02000275,2014,Ealing 038,Ealing,E09000009,4906 ,2576 ,2330 
E02000276,2014,Ealing 039,Ealing,E09000009,4606 ,2355 ,2251 
E02006791,2014,Ealing 040,Ealing,E09000009,4878 ,2392 ,2486 
E02000277,2014,Enfield 001,Enfield,E09000010,4793 ,2274 ,2519 
E02000278,2014,Enfield 002,Enfield,E09000010,5800 ,2664 ,3136 
E02000279,2014,Enfield 003,Enfield,E09000010,7990 ,3701 ,4289 
E02000280,2014,Enfield 004,Enfield,E09000010,5470 ,2609 ,2861 
E02000281,2014,Enfield 005,Enfield,E09000010,5682 ,2687 ,2995 
E02000282,2014,Enfield 006,Enfield,E09000010,5878 ,2673 ,3205 
E02000283,2014,Enfield 007,Enfield,E09000010,5535 ,2600 ,2935 
E02000284,2014,Enfield 008,Enfield,E09000010,5586 ,2706 ,2880 
E02000285,2014,Enfield 009,Enfield,E09000010,4199 ,2034 ,2165 
E02000286,2014,Enfield 010,Enfield,E09000010,5426 ,2710 ,2716 
E02000287,2014,Enfield 011,Enfield,E09000010,4339 ,2195 ,2144 
E02000288,2014,Enfield 012,Enfield,E09000010,6980 ,3382 ,3598 
E02000289,2014,Enfield 013,Enfield,E09000010,4038 ,1955 ,2083 
E02000290,2014,Enfield 014,Enfield,E09000010,4625 ,2175 ,2450 
E02000291,2014,Enfield 015,Enfield,E09000010,6148 ,2993 ,3155 
E02000292,2014,Enfield 016,Enfield,E09000010,6513 ,3186 ,3327 
E02000293,2014,Enfield 017,Enfield,E09000010,3917 ,1933 ,1984 
E02000294,2014,Enfield 018,Enfield,E09000010,5888 ,2831 ,3057 
E02000295,2014,Enfield 019,Enfield,E09000010,5610 ,2763 ,2847 
E02000296,2014,Enfield 020,Enfield,E09000010,6758 ,3266 ,3492 
E02000297,2014,Enfield 021,Enfield,E09000010,6227 ,3081 ,3146 
E02000298,2014,Enfield 022,Enfield,E09000010,5329 ,2673 ,2656 
E02000299,2014,Enfield 023,Enfield,E09000010,6177 ,2950 ,3227 
E02000300,2014,Enfield 024,Enfield,E09000010,5685 ,2735 ,2950 
E02000301,2014,Enfield 025,Enfield,E09000010,6803 ,3161 ,3642 
E02000302,2014,Enfield 026,Enfield,E09000010,5691 ,2737 ,2954 
E02000303,2014,Enfield 027,Enfield,E09000010,5729 ,2719 ,3010 
E02000304,2014,Enfield 028,Enfield,E09000010,5028 ,2449 ,2579 
E02000305,2014,Enfield 029,Enfield,E09000010,6536 ,3341 ,3195 
E02000306,2014,Enfield 030,Enfield,E09000010,6167 ,2876 ,3291 
E02000307,2014,Enfield 031,Enfield,E09000010,6586 ,3194 ,3392 
E02000308,2014,Enfield 032,Enfield,E09000010,5589 ,2963 ,2626 
E02000309,2014,Enfield 033,Enfield,E09000010,7413 ,3722 ,3691 
E02000311,2014,Enfield 035,Enfield,E09000010,7156 ,3436 ,3720 
E02000312,2014,Enfield 036,Enfield,E09000010,8434 ,4523 ,3911 
E02006793,2014,Enfield 037,Enfield,E09000010,6318 ,2945 ,3373 
E02000313,2014,Greenwich 001,Greenwich,E09000011,4858 ,2502 ,2356 
E02000314,2014,Greenwich 002,Greenwich,E09000011,10354 ,5866 ,4488 
E02000315,2014,Greenwich 003,Greenwich,E09000011,5927 ,2842 ,3085 
E02000316,2014,Greenwich 004,Greenwich,E09000011,9397 ,4978 ,4419 
E02000317,2014,Greenwich 005,Greenwich,E09000011,5614 ,2750 ,2864 
E02000318,2014,Greenwich 006,Greenwich,E09000011,7385 ,3934 ,3451 
E02000319,2014,Greenwich 007,Greenwich,E09000011,8395 ,4573 ,3822 
E02000320,2014,Greenwich 008,Greenwich,E09000011,4767 ,2341 ,2426 
E02000321,2014,Greenwich 009,Greenwich,E09000011,5032 ,2513 ,2519 
E02000323,2014,Greenwich 011,Greenwich,E09000011,7360 ,3702 ,3658 
E02000324,2014,Greenwich 012,Greenwich,E09000011,5084 ,2508 ,2576 
E02000326,2014,Greenwich 014,Greenwich,E09000011,5070 ,2496 ,2574 
E02000327,2014,Greenwich 015,Greenwich,E09000011,4668 ,2499 ,2169 
E02000328,2014,Greenwich 016,Greenwich,E09000011,4561 ,2260 ,2301 
E02000329,2014,Greenwich 017,Greenwich,E09000011,4321 ,2210 ,2111 
E02000331,2014,Greenwich 019,Greenwich,E09000011,5689 ,2836 ,2853 
E02000332,2014,Greenwich 020,Greenwich,E09000011,5054 ,2533 ,2521 
E02000333,2014,Greenwich 021,Greenwich,E09000011,4382 ,2169 ,2213 
E02000334,2014,Greenwich 022,Greenwich,E09000011,4480 ,2283 ,2197 
E02000335,2014,Greenwich 023,Greenwich,E09000011,4406 ,2212 ,2194 
E02000337,2014,Greenwich 025,Greenwich,E09000011,5545 ,2730 ,2815 
E02000339,2014,Greenwich 027,Greenwich,E09000011,3939 ,1963 ,1976 
E02000340,2014,Greenwich 028,Greenwich,E09000011,4020 ,2034 ,1986 
E02000341,2014,Greenwich 029,Greenwich,E09000011,5171 ,2450 ,2721 
E02000342,2014,Greenwich 030,Greenwich,E09000011,4444 ,1999 ,2445 
E02000343,2014,Greenwich 031,Greenwich,E09000011,4357 ,2236 ,2121 
E02000344,2014,Greenwich 032,Greenwich,E09000011,4325 ,2255 ,2070 
E02006786,2014,Greenwich 033,Greenwich,E09000011,4927 ,2481 ,2446 
E02006927,2014,Greenwich 034,Greenwich,E09000011,5716 ,2796 ,2920 
E02006928,2014,Greenwich 035,Greenwich,E09000011,6853 ,3275 ,3578 
E02006929,2014,Greenwich 036,Greenwich,E09000011,5932 ,2933 ,2999 
E02006930,2014,Greenwich 037,Greenwich,E09000011,5037 ,2554 ,2483 
E02006931,2014,Greenwich 038,Greenwich,E09000011,6589 ,3254 ,3335 
E02000345,2014,Hackney 001,Hackney,E09000012,5385 ,2727 ,2658 
E02000346,2014,Hackney 002,Hackney,E09000012,4457 ,2186 ,2271 
E02000347,2014,Hackney 003,Hackney,E09000012,5124 ,2533 ,2591 
E02000348,2014,Hackney 004,Hackney,E09000012,5120 ,2532 ,2588 
E02000350,2014,Hackney 006,Hackney,E09000012,7386 ,3679 ,3707 
E02000351,2014,Hackney 007,Hackney,E09000012,7334 ,3635 ,3699 
E02000352,2014,Hackney 008,Hackney,E09000012,4817 ,2238 ,2579 
E02000353,2014,Hackney 009,Hackney,E09000012,6199 ,2989 ,3210 
E02000354,2014,Hackney 010,Hackney,E09000012,7619 ,3810 ,3809 
E02000355,2014,Hackney 011,Hackney,E09000012,6632 ,3328 ,3304 
E02000356,2014,Hackney 012,Hackney,E09000012,5735 ,2769 ,2966 
E02000357,2014,Hackney 013,Hackney,E09000012,4041 ,1829 ,2212 
E02000358,2014,Hackney 014,Hackney,E09000012,9038 ,4549 ,4489 
E02000359,2014,Hackney 015,Hackney,E09000012,4813 ,2266 ,2547 
E02000360,2014,Hackney 016,Hackney,E09000012,8218 ,3970 ,4248 
E02000361,2014,Hackney 017,Hackney,E09000012,6336 ,3135 ,3201 
E02000362,2014,Hackney 018,Hackney,E09000012,4966 ,2464 ,2502 
E02000363,2014,Hackney 019,Hackney,E09000012,7633 ,3677 ,3956 
E02000364,2014,Hackney 020,Hackney,E09000012,7150 ,3481 ,3669 
E02000365,2014,Hackney 021,Hackney,E09000012,11480 ,5897 ,5583 
E02000366,2014,Hackney 022,Hackney,E09000012,6262 ,3085 ,3177 
E02000367,2014,Hackney 023,Hackney,E09000012,8441 ,4157 ,4284 
E02000368,2014,Hackney 024,Hackney,E09000012,7254 ,3562 ,3692 
E02000369,2014,Hackney 025,Hackney,E09000012,9946 ,5080 ,4866 
E02000370,2014,Hackney 026,Hackney,E09000012,6753 ,3624 ,3129 
E02000371,2014,Hackney 027,Hackney,E09000012,12128 ,6512 ,5616 
E02006918,2014,Hackney 028,Hackney,E09000012,5842 ,2809 ,3033 
E02006921,2014,Hackney 029,Hackney,E09000012,5058 ,2439 ,2619 
E02000372,2014,Hammersmith and Fulham 001,Hammersmith and Fulham,E09000013,6751 ,3177 ,3574 
E02000373,2014,Hammersmith and Fulham 002,Hammersmith and Fulham,E09000013,4102 ,1900 ,2202 
E02000374,2014,Hammersmith and Fulham 003,Hammersmith and Fulham,E09000013,4560 ,2215 ,2345 
E02000375,2014,Hammersmith and Fulham 004,Hammersmith and Fulham,E09000013,5006 ,2532 ,2474 
E02000376,2014,Hammersmith and Fulham 005,Hammersmith and Fulham,E09000013,5284 ,2787 ,2497 
E02000377,2014,Hammersmith and Fulham 006,Hammersmith and Fulham,E09000013,5930 ,3035 ,2895 
E02000378,2014,Hammersmith and Fulham 007,Hammersmith and Fulham,E09000013,4865 ,2445 ,2420 
E02000379,2014,Hammersmith and Fulham 008,Hammersmith and Fulham,E09000013,5286 ,2615 ,2671 
E02000380,2014,Hammersmith and Fulham 009,Hammersmith and Fulham,E09000013,4028 ,2091 ,1937 
E02000381,2014,Hammersmith and Fulham 010,Hammersmith and Fulham,E09000013,5539 ,2685 ,2854 
E02000382,2014,Hammersmith and Fulham 011,Hammersmith and Fulham,E09000013,4142 ,2034 ,2108 
E02000383,2014,Hammersmith and Fulham 012,Hammersmith and Fulham,E09000013,7064 ,3499 ,3565 
E02000384,2014,Hammersmith and Fulham 013,Hammersmith and Fulham,E09000013,5249 ,2625 ,2624 
E02000385,2014,Hammersmith and Fulham 014,Hammersmith and Fulham,E09000013,5005 ,2544 ,2461 
E02000386,2014,Hammersmith and Fulham 015,Hammersmith and Fulham,E09000013,6017 ,2965 ,3052 
E02000387,2014,Hammersmith and Fulham 016,Hammersmith and Fulham,E09000013,4634 ,2356 ,2278 
E02000388,2014,Hammersmith and Fulham 017,Hammersmith and Fulham,E09000013,5987 ,2953 ,3034 
E02000389,2014,Hammersmith and Fulham 018,Hammersmith and Fulham,E09000013,5730 ,2852 ,2878 
E02000390,2014,Hammersmith and Fulham 019,Hammersmith and Fulham,E09000013,4628 ,2252 ,2376 
E02000391,2014,Hammersmith and Fulham 020,Hammersmith and Fulham,E09000013,5461 ,2688 ,2773 
E02000392,2014,Hammersmith and Fulham 021,Hammersmith and Fulham,E09000013,6668 ,3139 ,3529 
E02000393,2014,Hammersmith and Fulham 022,Hammersmith and Fulham,E09000013,4251 ,2029 ,2222 
E02000394,2014,Hammersmith and Fulham 023,Hammersmith and Fulham,E09000013,5926 ,2763 ,3163 
E02000395,2014,Hammersmith and Fulham 024,Hammersmith and Fulham,E09000013,4077 ,1960 ,2117 
E02000396,2014,Hammersmith and Fulham 025,Hammersmith and Fulham,E09000013,4470 ,2151 ,2319 
E02000397,2014,Haringey 001,Haringey,E09000014,6188 ,3278 ,2910 
E02000398,2014,Haringey 002,Haringey,E09000014,4906 ,2524 ,2382 
E02000400,2014,Haringey 004,Haringey,E09000014,5693 ,2814 ,2879 
E02000401,2014,Haringey 005,Haringey,E09000014,4681 ,2244 ,2437 
E02000402,2014,Haringey 006,Haringey,E09000014,4637 ,2149 ,2488 
E02000403,2014,Haringey 007,Haringey,E09000014,6142 ,3272 ,2870 
E02000404,2014,Haringey 008,Haringey,E09000014,5577 ,2881 ,2696 
E02000405,2014,Haringey 009,Haringey,E09000014,4459 ,2196 ,2263 
E02000406,2014,Haringey 010,Haringey,E09000014,5308 ,2638 ,2670 
E02000407,2014,Haringey 011,Haringey,E09000014,5442 ,2743 ,2699 
E02000408,2014,Haringey 012,Haringey,E09000014,5671 ,2774 ,2897 
E02000409,2014,Haringey 013,Haringey,E09000014,4356 ,2145 ,2211 
E02000410,2014,Haringey 014,Haringey,E09000014,4698 ,2256 ,2442 
E02000411,2014,Haringey 015,Haringey,E09000014,6809 ,3537 ,3272 
E02000412,2014,Haringey 016,Haringey,E09000014,5662 ,2952 ,2710 
E02000413,2014,Haringey 017,Haringey,E09000014,5004 ,2355 ,2649 
E02000414,2014,Haringey 018,Haringey,E09000014,5411 ,2885 ,2526 
E02000415,2014,Haringey 019,Haringey,E09000014,5218 ,2752 ,2466 
E02000416,2014,Haringey 020,Haringey,E09000014,5700 ,2858 ,2842 
E02000417,2014,Haringey 021,Haringey,E09000014,4527 ,2132 ,2395 
E02000418,2014,Haringey 022,Haringey,E09000014,3897 ,1852 ,2045 
E02000419,2014,Haringey 023,Haringey,E09000014,6941 ,3723 ,3218 
E02000420,2014,Haringey 024,Haringey,E09000014,5622 ,2815 ,2807 
E02000421,2014,Haringey 025,Haringey,E09000014,5249 ,2627 ,2622 
E02000422,2014,Haringey 026,Haringey,E09000014,5903 ,3171 ,2732 
E02000423,2014,Haringey 027,Haringey,E09000014,5866 ,3147 ,2719 
E02000424,2014,Haringey 028,Haringey,E09000014,5531 ,2757 ,2774 
E02000425,2014,Haringey 029,Haringey,E09000014,4229 ,2138 ,2091 
E02000426,2014,Haringey 030,Haringey,E09000014,4147 ,1919 ,2228 
E02000427,2014,Haringey 031,Haringey,E09000014,5732 ,3121 ,2611 
E02000428,2014,Haringey 032,Haringey,E09000014,5661 ,2855 ,2806 
E02000429,2014,Haringey 033,Haringey,E09000014,4984 ,2517 ,2467 
E02000430,2014,Haringey 034,Haringey,E09000014,5967 ,3086 ,2881 
E02000431,2014,Haringey 035,Haringey,E09000014,4645 ,2239 ,2406 
E02000432,2014,Haringey 036,Haringey,E09000014,5229 ,2639 ,2590 
E02006794,2014,Haringey 037,Haringey,E09000014,5346 ,2667 ,2679 
E02000433,2014,Harrow 001,Harrow,E09000015,4669 ,2256 ,2413 
E02000434,2014,Harrow 002,Harrow,E09000015,5944 ,2869 ,3075 
E02000435,2014,Harrow 003,Harrow,E09000015,4893 ,2402 ,2491 
E02000436,2014,Harrow 004,Harrow,E09000015,3477 ,1709 ,1768 
E02000437,2014,Harrow 005,Harrow,E09000015,5555 ,2691 ,2864 
E02000438,2014,Harrow 006,Harrow,E09000015,5035 ,2424 ,2611 
E02000439,2014,Harrow 007,Harrow,E09000015,5810 ,2984 ,2826 
E02000440,2014,Harrow 008,Harrow,E09000015,6327 ,3172 ,3155 
E02000441,2014,Harrow 009,Harrow,E09000015,4317 ,2050 ,2267 
E02000442,2014,Harrow 010,Harrow,E09000015,6240 ,3197 ,3043 
E02000443,2014,Harrow 011,Harrow,E09000015,6424 ,3190 ,3234 
E02000444,2014,Harrow 012,Harrow,E09000015,5711 ,2879 ,2832 
E02000445,2014,Harrow 013,Harrow,E09000015,7184 ,3699 ,3485 
E02000447,2014,Harrow 015,Harrow,E09000015,4572 ,2191 ,2381 
E02000448,2014,Harrow 016,Harrow,E09000015,4294 ,2110 ,2184 
E02000449,2014,Harrow 017,Harrow,E09000015,5807 ,3000 ,2807 
E02000451,2014,Harrow 019,Harrow,E09000015,4338 ,2151 ,2187 
E02000452,2014,Harrow 020,Harrow,E09000015,5844 ,3046 ,2798 
E02000453,2014,Harrow 021,Harrow,E09000015,5481 ,2699 ,2782 
E02000454,2014,Harrow 022,Harrow,E09000015,4367 ,2095 ,2272 
E02000455,2014,Harrow 023,Harrow,E09000015,5878 ,3001 ,2877 
E02000456,2014,Harrow 024,Harrow,E09000015,4826 ,2386 ,2440 
E02000457,2014,Harrow 025,Harrow,E09000015,4076 ,2076 ,2000 
E02000459,2014,Harrow 027,Harrow,E09000015,5816 ,2888 ,2928 
E02000460,2014,Harrow 028,Harrow,E09000015,4448 ,2220 ,2228 
E02000461,2014,Harrow 029,Harrow,E09000015,5024 ,2908 ,2116 
E02000462,2014,Harrow 030,Harrow,E09000015,4469 ,2286 ,2183 
E02000463,2014,Harrow 031,Harrow,E09000015,5618 ,2749 ,2869 
E02006795,2014,Harrow 032,Harrow,E09000015,5416 ,2763 ,2653 
E02006882,2014,Harrow 033,Harrow,E09000015,9697 ,4830 ,4867 
E02000464,2014,Havering 001,Havering,E09000016,4092 ,1921 ,2171 
E02000465,2014,Havering 002,Havering,E09000016,5425 ,2589 ,2836 
E02000466,2014,Havering 003,Havering,E09000016,5361 ,2489 ,2872 
E02000467,2014,Havering 004,Havering,E09000016,6543 ,3123 ,3420 
E02000468,2014,Havering 005,Havering,E09000016,4948 ,2330 ,2618 
E02000469,2014,Havering 006,Havering,E09000016,4312 ,2021 ,2291 
E02000470,2014,Havering 007,Havering,E09000016,5213 ,2603 ,2610 
E02000471,2014,Havering 008,Havering,E09000016,4601 ,2240 ,2361 
E02000472,2014,Havering 009,Havering,E09000016,5734 ,2796 ,2938 
E02000473,2014,Havering 010,Havering,E09000016,6372 ,3181 ,3191 
E02000474,2014,Havering 011,Havering,E09000016,5521 ,2686 ,2835 
E02000475,2014,Havering 012,Havering,E09000016,6157 ,3065 ,3092 
E02000476,2014,Havering 013,Havering,E09000016,6199 ,3082 ,3117 
E02000477,2014,Havering 014,Havering,E09000016,6089 ,3001 ,3088 
E02000478,2014,Havering 015,Havering,E09000016,3658 ,1843 ,1815 
E02000479,2014,Havering 016,Havering,E09000016,5996 ,2882 ,3114 
E02000480,2014,Havering 017,Havering,E09000016,7134 ,3419 ,3715 
E02000481,2014,Havering 018,Havering,E09000016,4730 ,2256 ,2474 
E02000482,2014,Havering 019,Havering,E09000016,3834 ,1903 ,1931 
E02000483,2014,Havering 020,Havering,E09000016,5013 ,2476 ,2537 
E02000484,2014,Havering 021,Havering,E09000016,5600 ,2826 ,2774 
E02000485,2014,Havering 022,Havering,E09000016,5222 ,2589 ,2633 
E02000486,2014,Havering 023,Havering,E09000016,4867 ,2396 ,2471 
E02000487,2014,Havering 024,Havering,E09000016,4694 ,2322 ,2372 
E02000488,2014,Havering 025,Havering,E09000016,4846 ,2379 ,2467 
E02000489,2014,Havering 026,Havering,E09000016,5194 ,2543 ,2651 
E02000490,2014,Havering 027,Havering,E09000016,4793 ,2289 ,2504 
E02000491,2014,Havering 028,Havering,E09000016,5627 ,2803 ,2824 
E02000492,2014,Havering 029,Havering,E09000016,3991 ,2011 ,1980 
E02000493,2014,Havering 030,Havering,E09000016,4150 ,1964 ,2186 
E02000494,2014,Hillingdon 001,Hillingdon,E09000017,4544 ,2200 ,2344 
E02000495,2014,Hillingdon 002,Hillingdon,E09000017,6377 ,3108 ,3269 
E02000496,2014,Hillingdon 003,Hillingdon,E09000017,4822 ,2340 ,2482 
E02000497,2014,Hillingdon 004,Hillingdon,E09000017,5854 ,2837 ,3017 
E02000498,2014,Hillingdon 005,Hillingdon,E09000017,3778 ,1845 ,1933 
E02000499,2014,Hillingdon 006,Hillingdon,E09000017,4803 ,2369 ,2434 
E02000500,2014,Hillingdon 007,Hillingdon,E09000017,5050 ,2504 ,2546 
E02000501,2014,Hillingdon 008,Hillingdon,E09000017,5362 ,2596 ,2766 
E02000502,2014,Hillingdon 009,Hillingdon,E09000017,5269 ,2606 ,2663 
E02000503,2014,Hillingdon 010,Hillingdon,E09000017,6303 ,3222 ,3081 
E02000504,2014,Hillingdon 011,Hillingdon,E09000017,4490 ,2222 ,2268 
E02000506,2014,Hillingdon 013,Hillingdon,E09000017,5024 ,2503 ,2521 
E02000507,2014,Hillingdon 014,Hillingdon,E09000017,5274 ,2625 ,2649 
E02000508,2014,Hillingdon 015,Hillingdon,E09000017,8385 ,4678 ,3707 
E02000509,2014,Hillingdon 016,Hillingdon,E09000017,9532 ,4881 ,4651 
E02000510,2014,Hillingdon 017,Hillingdon,E09000017,5840 ,2940 ,2900 
E02000511,2014,Hillingdon 018,Hillingdon,E09000017,6446 ,3256 ,3190 
E02000512,2014,Hillingdon 019,Hillingdon,E09000017,5515 ,2751 ,2764 
E02000513,2014,Hillingdon 020,Hillingdon,E09000017,6107 ,2891 ,3216 
E02000514,2014,Hillingdon 021,Hillingdon,E09000017,6929 ,3645 ,3284 
E02000515,2014,Hillingdon 022,Hillingdon,E09000017,7890 ,4074 ,3816 
E02000516,2014,Hillingdon 023,Hillingdon,E09000017,5969 ,2908 ,3061 
E02000517,2014,Hillingdon 024,Hillingdon,E09000017,6184 ,3020 ,3164 
E02000518,2014,Hillingdon 025,Hillingdon,E09000017,5883 ,2894 ,2989 
E02000519,2014,Hillingdon 026,Hillingdon,E09000017,6021 ,3063 ,2958 
E02000520,2014,Hillingdon 027,Hillingdon,E09000017,8519 ,4382 ,4137 
E02000521,2014,Hillingdon 028,Hillingdon,E09000017,7619 ,3777 ,3842 
E02000522,2014,Hillingdon 029,Hillingdon,E09000017,5943 ,2914 ,3029 
E02000523,2014,Hillingdon 030,Hillingdon,E09000017,7410 ,3845 ,3565 
E02000524,2014,Hillingdon 031,Hillingdon,E09000017,5175 ,2884 ,2291 
E02000525,2014,Hillingdon 032,Hillingdon,E09000017,6467 ,3315 ,3152 
E02006796,2014,Hillingdon 033,Hillingdon,E09000017,5758 ,2848 ,2910 
E02000526,2014,Hounslow 001,Hounslow,E09000018,5856 ,2870 ,2986 
E02000528,2014,Hounslow 003,Hounslow,E09000018,7725 ,3755 ,3970 
E02000529,2014,Hounslow 004,Hounslow,E09000018,5862 ,3033 ,2829 
E02000530,2014,Hounslow 005,Hounslow,E09000018,4540 ,2279 ,2261 
E02000531,2014,Hounslow 006,Hounslow,E09000018,7485 ,3726 ,3759 
E02000532,2014,Hounslow 007,Hounslow,E09000018,6196 ,3081 ,3115 
E02000533,2014,Hounslow 008,Hounslow,E09000018,5814 ,2933 ,2881 
E02000534,2014,Hounslow 009,Hounslow,E09000018,5683 ,2973 ,2710 
E02000535,2014,Hounslow 010,Hounslow,E09000018,6426 ,3378 ,3048 
E02000536,2014,Hounslow 011,Hounslow,E09000018,6584 ,3427 ,3157 
E02000537,2014,Hounslow 012,Hounslow,E09000018,6391 ,3486 ,2905 
E02000538,2014,Hounslow 013,Hounslow,E09000018,6588 ,3485 ,3103 
E02000539,2014,Hounslow 014,Hounslow,E09000018,7747 ,3792 ,3955 
E02000540,2014,Hounslow 015,Hounslow,E09000018,7056 ,3888 ,3168 
E02000541,2014,Hounslow 016,Hounslow,E09000018,6423 ,3413 ,3010 
E02000542,2014,Hounslow 017,Hounslow,E09000018,7534 ,4049 ,3485 
E02000543,2014,Hounslow 018,Hounslow,E09000018,9168 ,5008 ,4160 
E02000544,2014,Hounslow 019,Hounslow,E09000018,5846 ,2952 ,2894 
E02000545,2014,Hounslow 020,Hounslow,E09000018,5760 ,2785 ,2975 
E02000546,2014,Hounslow 021,Hounslow,E09000018,6914 ,3637 ,3277 
E02000547,2014,Hounslow 022,Hounslow,E09000018,6643 ,3355 ,3288 
E02000548,2014,Hounslow 023,Hounslow,E09000018,6357 ,3160 ,3197 
E02000549,2014,Hounslow 024,Hounslow,E09000018,7657 ,3904 ,3753 
E02000550,2014,Hounslow 025,Hounslow,E09000018,7338 ,3626 ,3712 
E02000551,2014,Hounslow 026,Hounslow,E09000018,5897 ,2865 ,3032 
E02000552,2014,Hounslow 027,Hounslow,E09000018,6209 ,3305 ,2904 
E02000553,2014,Hounslow 028,Hounslow,E09000018,4564 ,2229 ,2335 
E02006792,2014,Hounslow 029,Hounslow,E09000018,6234 ,3213 ,3021 
E02000554,2014,Islington 001,Islington,E09000019,6797 ,3241 ,3556 
E02000555,2014,Islington 002,Islington,E09000019,6801 ,3180 ,3621 
E02000556,2014,Islington 003,Islington,E09000019,7848 ,3832 ,4016 
E02000557,2014,Islington 004,Islington,E09000019,6072 ,2921 ,3151 
E02000558,2014,Islington 005,Islington,E09000019,6596 ,3255 ,3341 
E02000559,2014,Islington 006,Islington,E09000019,7377 ,3841 ,3536 
E02000560,2014,Islington 007,Islington,E09000019,6248 ,3268 ,2980 
E02000561,2014,Islington 008,Islington,E09000019,6024 ,2956 ,3068 
E02000562,2014,Islington 009,Islington,E09000019,6083 ,2942 ,3141 
E02000563,2014,Islington 010,Islington,E09000019,6480 ,3188 ,3292 
E02000564,2014,Islington 011,Islington,E09000019,9207 ,4610 ,4597 
E02000565,2014,Islington 012,Islington,E09000019,6337 ,2994 ,3343 
E02000566,2014,Islington 013,Islington,E09000019,6694 ,3284 ,3410 
E02000567,2014,Islington 014,Islington,E09000019,8600 ,4132 ,4468 
E02000568,2014,Islington 015,Islington,E09000019,8779 ,4601 ,4178 
E02000569,2014,Islington 016,Islington,E09000019,7790 ,3769 ,4021 
E02000570,2014,Islington 017,Islington,E09000019,7210 ,3733 ,3477 
E02000571,2014,Islington 018,Islington,E09000019,6293 ,3162 ,3131 
E02000572,2014,Islington 019,Islington,E09000019,6362 ,3016 ,3346 
E02000573,2014,Islington 020,Islington,E09000019,7351 ,3882 ,3469 
E02000574,2014,Islington 021,Islington,E09000019,7213 ,3745 ,3468 
E02000575,2014,Islington 022,Islington,E09000019,11057 ,5906 ,5151 
E02000576,2014,Islington 023,Islington,E09000019,8314 ,4473 ,3841 
E02000577,2014,Kensington and Chelsea 001,Kensington and Chelsea,E09000020,4889 ,2410 ,2479 
E02000578,2014,Kensington and Chelsea 002,Kensington and Chelsea,E09000020,3866 ,1814 ,2052 
E02000579,2014,Kensington and Chelsea 003,Kensington and Chelsea,E09000020,5855 ,2801 ,3054 
E02000580,2014,Kensington and Chelsea 004,Kensington and Chelsea,E09000020,6095 ,2970 ,3125 
E02000581,2014,Kensington and Chelsea 005,Kensington and Chelsea,E09000020,4545 ,2133 ,2412 
E02000582,2014,Kensington and Chelsea 006,Kensington and Chelsea,E09000020,5168 ,2541 ,2627 
E02000583,2014,Kensington and Chelsea 007,Kensington and Chelsea,E09000020,4817 ,2237 ,2580 
E02000584,2014,Kensington and Chelsea 008,Kensington and Chelsea,E09000020,5046 ,2251 ,2795 
E02000585,2014,Kensington and Chelsea 009,Kensington and Chelsea,E09000020,5683 ,2791 ,2892 
E02000586,2014,Kensington and Chelsea 010,Kensington and Chelsea,E09000020,5270 ,2652 ,2618 
E02000587,2014,Kensington and Chelsea 011,Kensington and Chelsea,E09000020,4878 ,2460 ,2418 
E02000588,2014,Kensington and Chelsea 012,Kensington and Chelsea,E09000020,5874 ,3191 ,2683 
E02000589,2014,Kensington and Chelsea 013,Kensington and Chelsea,E09000020,6516 ,3540 ,2976 
E02000590,2014,Kensington and Chelsea 014,Kensington and Chelsea,E09000020,5107 ,2374 ,2733 
E02000591,2014,Kensington and Chelsea 015,Kensington and Chelsea,E09000020,5039 ,2649 ,2390 
E02000592,2014,Kensington and Chelsea 016,Kensington and Chelsea,E09000020,5050 ,2560 ,2490 
E02000593,2014,Kensington and Chelsea 017,Kensington and Chelsea,E09000020,5641 ,2965 ,2676 
E02000594,2014,Kensington and Chelsea 018,Kensington and Chelsea,E09000020,5054 ,2561 ,2493 
E02000595,2014,Kensington and Chelsea 019,Kensington and Chelsea,E09000020,5209 ,2487 ,2722 
E02000596,2014,Kensington and Chelsea 020,Kensington and Chelsea,E09000020,5916 ,3038 ,2878 
E02000597,2014,Kensington and Chelsea 021,Kensington and Chelsea,E09000020,4951 ,2435 ,2516 
E02000598,2014,Kingston upon Thames 001,Kingston upon Thames,E09000021,5065 ,2410 ,2655 
E02000599,2014,Kingston upon Thames 002,Kingston upon Thames,E09000021,5121 ,2460 ,2661 
E02000600,2014,Kingston upon Thames 003,Kingston upon Thames,E09000021,6115 ,3100 ,3015 
E02000601,2014,Kingston upon Thames 004,Kingston upon Thames,E09000021,8012 ,3969 ,4043 
E02000602,2014,Kingston upon Thames 005,Kingston upon Thames,E09000021,7591 ,3756 ,3835 
E02000603,2014,Kingston upon Thames 006,Kingston upon Thames,E09000021,5496 ,2689 ,2807 
E02000604,2014,Kingston upon Thames 007,Kingston upon Thames,E09000021,5876 ,2972 ,2904 
E02000605,2014,Kingston upon Thames 008,Kingston upon Thames,E09000021,5391 ,2738 ,2653 
E02000606,2014,Kingston upon Thames 009,Kingston upon Thames,E09000021,8120 ,4135 ,3985 
E02000607,2014,Kingston upon Thames 010,Kingston upon Thames,E09000021,5420 ,2638 ,2782 
E02000608,2014,Kingston upon Thames 011,Kingston upon Thames,E09000021,6904 ,3226 ,3678 
E02000609,2014,Kingston upon Thames 012,Kingston upon Thames,E09000021,4765 ,2382 ,2383 
E02000610,2014,Kingston upon Thames 013,Kingston upon Thames,E09000021,5907 ,3000 ,2907 
E02000611,2014,Kingston upon Thames 014,Kingston upon Thames,E09000021,4582 ,2281 ,2301 
E02000612,2014,Kingston upon Thames 015,Kingston upon Thames,E09000021,5238 ,2598 ,2640 
E02000613,2014,Kingston upon Thames 016,Kingston upon Thames,E09000021,5409 ,2638 ,2771 
E02000614,2014,Kingston upon Thames 017,Kingston upon Thames,E09000021,5921 ,2990 ,2931 
E02000615,2014,Kingston upon Thames 018,Kingston upon Thames,E09000021,5048 ,2582 ,2466 
E02000616,2014,Kingston upon Thames 019,Kingston upon Thames,E09000021,4073 ,2051 ,2022 
E02000617,2014,Kingston upon Thames 020,Kingston upon Thames,E09000021,5736 ,2830 ,2906 
E02000619,2014,Lambeth 002,Lambeth,E09000022,6258 ,3204 ,3054 
E02000620,2014,Lambeth 003,Lambeth,E09000022,7585 ,4131 ,3454 
E02000621,2014,Lambeth 004,Lambeth,E09000022,8990 ,4957 ,4033 
E02000622,2014,Lambeth 005,Lambeth,E09000022,6804 ,3749 ,3055 
E02000623,2014,Lambeth 006,Lambeth,E09000022,6092 ,3215 ,2877 
E02000624,2014,Lambeth 007,Lambeth,E09000022,6405 ,3389 ,3016 
E02000625,2014,Lambeth 008,Lambeth,E09000022,6190 ,3258 ,2932 
E02000626,2014,Lambeth 009,Lambeth,E09000022,6084 ,3020 ,3064 
E02000627,2014,Lambeth 010,Lambeth,E09000022,7545 ,3861 ,3684 
E02000628,2014,Lambeth 011,Lambeth,E09000022,7134 ,3594 ,3540 
E02000629,2014,Lambeth 012,Lambeth,E09000022,7329 ,3751 ,3578 
E02000630,2014,Lambeth 013,Lambeth,E09000022,6216 ,3222 ,2994 
E02000631,2014,Lambeth 014,Lambeth,E09000022,7025 ,3474 ,3551 
E02000632,2014,Lambeth 015,Lambeth,E09000022,7604 ,3766 ,3838 
E02000633,2014,Lambeth 016,Lambeth,E09000022,6865 ,3294 ,3571 
E02000634,2014,Lambeth 017,Lambeth,E09000022,5076 ,2473 ,2603 
E02000635,2014,Lambeth 018,Lambeth,E09000022,7170 ,3611 ,3559 
E02000636,2014,Lambeth 019,Lambeth,E09000022,5944 ,2955 ,2989 
E02000637,2014,Lambeth 020,Lambeth,E09000022,7213 ,3661 ,3552 
E02000638,2014,Lambeth 021,Lambeth,E09000022,8254 ,4432 ,3822 
E02000639,2014,Lambeth 022,Lambeth,E09000022,6042 ,2844 ,3198 
E02000640,2014,Lambeth 023,Lambeth,E09000022,7182 ,3484 ,3698 
E02000641,2014,Lambeth 024,Lambeth,E09000022,6242 ,2874 ,3368 
E02000642,2014,Lambeth 025,Lambeth,E09000022,6808 ,3320 ,3488 
E02000643,2014,Lambeth 026,Lambeth,E09000022,6949 ,3445 ,3504 
E02000644,2014,Lambeth 027,Lambeth,E09000022,6553 ,3281 ,3272 
E02000645,2014,Lambeth 028,Lambeth,E09000022,6720 ,3269 ,3451 
E02000646,2014,Lambeth 029,Lambeth,E09000022,7691 ,3973 ,3718 
E02000647,2014,Lambeth 030,Lambeth,E09000022,6185 ,3148 ,3037 
E02000648,2014,Lambeth 031,Lambeth,E09000022,5269 ,2304 ,2965 
E02000649,2014,Lambeth 032,Lambeth,E09000022,9620 ,4888 ,4732 
E02000650,2014,Lambeth 033,Lambeth,E09000022,5369 ,2486 ,2883 
E02000651,2014,Lambeth 034,Lambeth,E09000022,6769 ,3376 ,3393 
E02000652,2014,Lambeth 035,Lambeth,E09000022,5666 ,2929 ,2737 
E02006801,2014,Lambeth 036,Lambeth,E09000022,7876 ,3970 ,3906 
E02000653,2014,Lewisham 001,Lewisham,E09000023,7034 ,3661 ,3373 
E02000654,2014,Lewisham 002,Lewisham,E09000023,5876 ,2848 ,3028 
E02000655,2014,Lewisham 003,Lewisham,E09000023,6497 ,3130 ,3367 
E02000657,2014,Lewisham 005,Lewisham,E09000023,7719 ,3856 ,3863 
E02000658,2014,Lewisham 006,Lewisham,E09000023,6515 ,3340 ,3175 
E02000659,2014,Lewisham 007,Lewisham,E09000023,5797 ,2866 ,2931 
E02000660,2014,Lewisham 008,Lewisham,E09000023,7009 ,3475 ,3534 
E02000661,2014,Lewisham 009,Lewisham,E09000023,4915 ,2509 ,2406 
E02000662,2014,Lewisham 010,Lewisham,E09000023,6515 ,3224 ,3291 
E02000663,2014,Lewisham 011,Lewisham,E09000023,5577 ,2962 ,2615 
E02000664,2014,Lewisham 012,Lewisham,E09000023,8193 ,4149 ,4044 
E02000665,2014,Lewisham 013,Lewisham,E09000023,6186 ,3195 ,2991 
E02000666,2014,Lewisham 014,Lewisham,E09000023,5312 ,2517 ,2795 
E02000667,2014,Lewisham 015,Lewisham,E09000023,4861 ,2399 ,2462 
E02000668,2014,Lewisham 016,Lewisham,E09000023,4874 ,2471 ,2403 
E02000669,2014,Lewisham 017,Lewisham,E09000023,5767 ,2937 ,2830 
E02000670,2014,Lewisham 018,Lewisham,E09000023,4664 ,2220 ,2444 
E02000671,2014,Lewisham 019,Lewisham,E09000023,6134 ,2948 ,3186 
E02000672,2014,Lewisham 020,Lewisham,E09000023,6288 ,3316 ,2972 
E02000673,2014,Lewisham 021,Lewisham,E09000023,5809 ,2910 ,2899 
E02000674,2014,Lewisham 022,Lewisham,E09000023,5675 ,2656 ,3019 
E02000675,2014,Lewisham 023,Lewisham,E09000023,5826 ,2818 ,3008 
E02000676,2014,Lewisham 024,Lewisham,E09000023,5680 ,2727 ,2953 
E02000677,2014,Lewisham 025,Lewisham,E09000023,5142 ,2540 ,2602 
E02000678,2014,Lewisham 026,Lewisham,E09000023,4086 ,1915 ,2171 
E02000679,2014,Lewisham 027,Lewisham,E09000023,5789 ,2801 ,2988 
E02000680,2014,Lewisham 028,Lewisham,E09000023,5059 ,2551 ,2508 
E02000681,2014,Lewisham 029,Lewisham,E09000023,5569 ,2546 ,3023 
E02000682,2014,Lewisham 030,Lewisham,E09000023,5690 ,2715 ,2975 
E02000683,2014,Lewisham 031,Lewisham,E09000023,3995 ,1906 ,2089 
E02000685,2014,Lewisham 033,Lewisham,E09000023,5673 ,2700 ,2973 
E02000686,2014,Lewisham 034,Lewisham,E09000023,4457 ,2002 ,2455 
E02000687,2014,Lewisham 035,Lewisham,E09000023,5861 ,3008 ,2853 
E02006783,2014,Lewisham 037,Lewisham,E09000023,4680 ,2114 ,2566 
E02006784,2014,Lewisham 038,Lewisham,E09000023,5149 ,2465 ,2684 
E02006798,2014,Lewisham 039,Lewisham,E09000023,5878 ,2963 ,2915 
E02000689,2014,Merton 001,Merton,E09000024,5578 ,2709 ,2869 
E02000690,2014,Merton 002,Merton,E09000024,3151 ,1515 ,1636 
E02000691,2014,Merton 003,Merton,E09000024,5416 ,2655 ,2761 
E02000692,2014,Merton 004,Merton,E09000024,5202 ,2595 ,2607 
E02000693,2014,Merton 005,Merton,E09000024,7248 ,3735 ,3513 
E02000694,2014,Merton 006,Merton,E09000024,6499 ,3163 ,3336 
E02000695,2014,Merton 007,Merton,E09000024,5918 ,3209 ,2709 
E02000696,2014,Merton 008,Merton,E09000024,6147 ,3100 ,3047 
E02000697,2014,Merton 009,Merton,E09000024,6266 ,3157 ,3109 
E02000698,2014,Merton 010,Merton,E09000024,4897 ,2345 ,2552 
E02000699,2014,Merton 011,Merton,E09000024,5309 ,2586 ,2723 
E02000700,2014,Merton 012,Merton,E09000024,6065 ,2930 ,3135 
E02000701,2014,Merton 013,Merton,E09000024,5674 ,2880 ,2794 
E02000702,2014,Merton 014,Merton,E09000024,5647 ,2688 ,2959 
E02000703,2014,Merton 015,Merton,E09000024,5042 ,2499 ,2543 
E02000704,2014,Merton 016,Merton,E09000024,5659 ,2772 ,2887 
E02000705,2014,Merton 017,Merton,E09000024,5851 ,2868 ,2983 
E02000706,2014,Merton 018,Merton,E09000024,6034 ,2864 ,3170 
E02000707,2014,Merton 019,Merton,E09000024,5029 ,2381 ,2648 
E02000708,2014,Merton 020,Merton,E09000024,5590 ,2762 ,2828 
E02000709,2014,Merton 021,Merton,E09000024,5003 ,2483 ,2520 
E02000710,2014,Merton 022,Merton,E09000024,5550 ,2755 ,2795 
E02000711,2014,Merton 023,Merton,E09000024,5848 ,2904 ,2944 
E02000712,2014,Merton 024,Merton,E09000024,5725 ,2821 ,2904 
E02000713,2014,Merton 025,Merton,E09000024,4835 ,2413 ,2422 
E02000714,2014,Newham 001,Newham,E09000025,5945 ,3140 ,2805 
E02000715,2014,Newham 002,Newham,E09000025,5031 ,2687 ,2344 
E02000716,2014,Newham 003,Newham,E09000025,5315 ,2888 ,2427 
E02000717,2014,Newham 004,Newham,E09000025,5866 ,3172 ,2694 
E02000718,2014,Newham 005,Newham,E09000025,4485 ,2243 ,2242 
E02000719,2014,Newham 006,Newham,E09000025,6115 ,3184 ,2931 
E02000720,2014,Newham 007,Newham,E09000025,5451 ,3026 ,2425 
E02000721,2014,Newham 008,Newham,E09000025,6962 ,3838 ,3124 
E02000722,2014,Newham 009,Newham,E09000025,6356 ,3284 ,3072 
E02000723,2014,Newham 010,Newham,E09000025,7728 ,4356 ,3372 
E02000724,2014,Newham 011,Newham,E09000025,6673 ,3721 ,2952 
E02000725,2014,Newham 012,Newham,E09000025,7148 ,3699 ,3449 
E02000726,2014,Newham 013,Newham,E09000025,8415 ,4589 ,3826 
E02000727,2014,Newham 014,Newham,E09000025,6157 ,3578 ,2579 
E02000728,2014,Newham 015,Newham,E09000025,5793 ,3206 ,2587 
E02000729,2014,Newham 016,Newham,E09000025,5087 ,2681 ,2406 
E02000730,2014,Newham 017,Newham,E09000025,6502 ,3665 ,2837 
E02000731,2014,Newham 018,Newham,E09000025,7579 ,4519 ,3060 
E02000732,2014,Newham 019,Newham,E09000025,5280 ,2900 ,2380 
E02000733,2014,Newham 020,Newham,E09000025,7237 ,3817 ,3420 
E02000734,2014,Newham 021,Newham,E09000025,5765 ,3067 ,2698 
E02000735,2014,Newham 022,Newham,E09000025,5601 ,3167 ,2434 
E02000736,2014,Newham 023,Newham,E09000025,5866 ,3062 ,2804 
E02000737,2014,Newham 024,Newham,E09000025,6724 ,3488 ,3236 
E02000738,2014,Newham 025,Newham,E09000025,6075 ,3270 ,2805 
E02000739,2014,Newham 026,Newham,E09000025,5210 ,2734 ,2476 
E02000740,2014,Newham 027,Newham,E09000025,4999 ,2559 ,2440 
E02000741,2014,Newham 028,Newham,E09000025,5963 ,3125 ,2838 
E02000742,2014,Newham 029,Newham,E09000025,5664 ,2890 ,2774 
E02000743,2014,Newham 030,Newham,E09000025,6135 ,3168 ,2967 
E02000744,2014,Newham 031,Newham,E09000025,5984 ,3070 ,2914 
E02000745,2014,Newham 032,Newham,E09000025,5912 ,2875 ,3037 
E02000746,2014,Newham 033,Newham,E09000025,5990 ,2883 ,3107 
E02000747,2014,Newham 034,Newham,E09000025,8668 ,4649 ,4019 
E02000748,2014,Newham 035,Newham,E09000025,4526 ,2168 ,2358 
E02000749,2014,Newham 036,Newham,E09000025,5630 ,2702 ,2928 
E02000750,2014,Newham 037,Newham,E09000025,8986 ,4771 ,4215 
E02000751,2014,Redbridge 001,Redbridge,E09000026,6435 ,3141 ,3294 
E02000752,2014,Redbridge 002,Redbridge,E09000026,4611 ,2161 ,2450 
E02000753,2014,Redbridge 003,Redbridge,E09000026,4133 ,1954 ,2179 
E02000754,2014,Redbridge 004,Redbridge,E09000026,4443 ,2151 ,2292 
E02000755,2014,Redbridge 005,Redbridge,E09000026,3701 ,1820 ,1881 
E02000756,2014,Redbridge 006,Redbridge,E09000026,8728 ,4234 ,4494 
E02000757,2014,Redbridge 007,Redbridge,E09000026,8664 ,4330 ,4334 
E02000758,2014,Redbridge 008,Redbridge,E09000026,3872 ,1879 ,1993 
E02000759,2014,Redbridge 009,Redbridge,E09000026,8626 ,4199 ,4427 
E02000760,2014,Redbridge 010,Redbridge,E09000026,4525 ,2175 ,2350 
E02000762,2014,Redbridge 012,Redbridge,E09000026,4264 ,2143 ,2121 
E02000763,2014,Redbridge 013,Redbridge,E09000026,4624 ,2266 ,2358 
E02000764,2014,Redbridge 014,Redbridge,E09000026,8274 ,4024 ,4250 
E02000765,2014,Redbridge 015,Redbridge,E09000026,4297 ,2118 ,2179 
E02000767,2014,Redbridge 017,Redbridge,E09000026,5170 ,2545 ,2625 
E02000768,2014,Redbridge 018,Redbridge,E09000026,3709 ,1754 ,1955 
E02000769,2014,Redbridge 019,Redbridge,E09000026,10260 ,4990 ,5270 
E02000770,2014,Redbridge 020,Redbridge,E09000026,5119 ,2591 ,2528 
E02000772,2014,Redbridge 022,Redbridge,E09000026,5609 ,2867 ,2742 
E02000773,2014,Redbridge 023,Redbridge,E09000026,6562 ,3235 ,3327 
E02000774,2014,Redbridge 024,Redbridge,E09000026,5015 ,2611 ,2404 
E02000776,2014,Redbridge 026,Redbridge,E09000026,4472 ,2204 ,2268 
E02000777,2014,Redbridge 027,Redbridge,E09000026,3999 ,1905 ,2094 
E02000779,2014,Redbridge 029,Redbridge,E09000026,5547 ,2937 ,2610 
E02000780,2014,Redbridge 030,Redbridge,E09000026,10496 ,5402 ,5094 
E02000781,2014,Redbridge 031,Redbridge,E09000026,9392 ,4742 ,4650 
E02000782,2014,Redbridge 032,Redbridge,E09000026,6577 ,3354 ,3223 
E02000783,2014,Redbridge 033,Redbridge,E09000026,4691 ,2373 ,2318 
E02006800,2014,Redbridge 034,Redbridge,E09000026,9390 ,4809 ,4581 
E02006924,2014,Redbridge 035,Redbridge,E09000026,8911 ,4751 ,4160 
E02006925,2014,Redbridge 036,Redbridge,E09000026,8843 ,4364 ,4479 
E02000784,2014,Richmond upon Thames 001,Richmond upon Thames,E09000027,6629 ,3255 ,3374 
E02000785,2014,Richmond upon Thames 002,Richmond upon Thames,E09000027,6289 ,3028 ,3261 
E02000786,2014,Richmond upon Thames 003,Richmond upon Thames,E09000027,7426 ,3597 ,3829 
E02000787,2014,Richmond upon Thames 004,Richmond upon Thames,E09000027,7626 ,3773 ,3853 
E02000788,2014,Richmond upon Thames 005,Richmond upon Thames,E09000027,5768 ,2821 ,2947 
E02000789,2014,Richmond upon Thames 006,Richmond upon Thames,E09000027,4201 ,2103 ,2098 
E02000790,2014,Richmond upon Thames 007,Richmond upon Thames,E09000027,4450 ,2172 ,2278 
E02000791,2014,Richmond upon Thames 008,Richmond upon Thames,E09000027,4550 ,2346 ,2204 
E02000792,2014,Richmond upon Thames 009,Richmond upon Thames,E09000027,4740 ,2378 ,2362 
E02000793,2014,Richmond upon Thames 010,Richmond upon Thames,E09000027,5356 ,2665 ,2691 
E02000794,2014,Richmond upon Thames 011,Richmond upon Thames,E09000027,4575 ,2308 ,2267 
E02000795,2014,Richmond upon Thames 012,Richmond upon Thames,E09000027,3910 ,1914 ,1996 
E02000796,2014,Richmond upon Thames 013,Richmond upon Thames,E09000027,6891 ,3412 ,3479 
E02000797,2014,Richmond upon Thames 014,Richmond upon Thames,E09000027,5318 ,2661 ,2657 
E02000798,2014,Richmond upon Thames 015,Richmond upon Thames,E09000027,7228 ,3475 ,3753 
E02000799,2014,Richmond upon Thames 016,Richmond upon Thames,E09000027,4607 ,2235 ,2372 
E02000800,2014,Richmond upon Thames 017,Richmond upon Thames,E09000027,3466 ,1702 ,1764 
E02000801,2014,Richmond upon Thames 018,Richmond upon Thames,E09000027,4659 ,2215 ,2444 
E02000802,2014,Richmond upon Thames 019,Richmond upon Thames,E09000027,4565 ,2194 ,2371 
E02000803,2014,Richmond upon Thames 020,Richmond upon Thames,E09000027,6067 ,2878 ,3189 
E02000804,2014,Richmond upon Thames 021,Richmond upon Thames,E09000027,4882 ,2345 ,2537 
E02000805,2014,Richmond upon Thames 022,Richmond upon Thames,E09000027,7457 ,3615 ,3842 
E02000806,2014,Richmond upon Thames 023,Richmond upon Thames,E09000027,6569 ,3141 ,3428 
E02000807,2014,Southwark 001,Southwark,E09000028,7412 ,3846 ,3566 
E02000808,2014,Southwark 002,Southwark,E09000028,8843 ,4519 ,4324 
E02000809,2014,Southwark 003,Southwark,E09000028,11244 ,6400 ,4844 
E02000810,2014,Southwark 004,Southwark,E09000028,8525 ,4430 ,4095 
E02000812,2014,Southwark 006,Southwark,E09000028,8337 ,3975 ,4362 
E02000813,2014,Southwark 007,Southwark,E09000028,7417 ,3541 ,3876 
E02000814,2014,Southwark 008,Southwark,E09000028,7154 ,3756 ,3398 
E02000815,2014,Southwark 009,Southwark,E09000028,5664 ,2681 ,2983 
E02000816,2014,Southwark 010,Southwark,E09000028,7033 ,3542 ,3491 
E02000817,2014,Southwark 011,Southwark,E09000028,4619 ,2278 ,2341 
E02000818,2014,Southwark 012,Southwark,E09000028,5666 ,2791 ,2875 
E02000819,2014,Southwark 013,Southwark,E09000028,6528 ,3224 ,3304 
E02000820,2014,Southwark 014,Southwark,E09000028,7363 ,3971 ,3392 
E02000821,2014,Southwark 015,Southwark,E09000028,5567 ,2703 ,2864 
E02000822,2014,Southwark 016,Southwark,E09000028,5246 ,2669 ,2577 
E02000823,2014,Southwark 017,Southwark,E09000028,6098 ,2980 ,3118 
E02000824,2014,Southwark 018,Southwark,E09000028,6683 ,3209 ,3474 
E02000825,2014,Southwark 019,Southwark,E09000028,6577 ,3152 ,3425 
E02000826,2014,Southwark 020,Southwark,E09000028,6496 ,3239 ,3257 
E02000827,2014,Southwark 021,Southwark,E09000028,7708 ,3840 ,3868 
E02000828,2014,Southwark 022,Southwark,E09000028,5958 ,2916 ,3042 
E02000829,2014,Southwark 023,Southwark,E09000028,8524 ,4547 ,3977 
E02000830,2014,Southwark 024,Southwark,E09000028,6831 ,3376 ,3455 
E02000831,2014,Southwark 025,Southwark,E09000028,7246 ,3609 ,3637 
E02000832,2014,Southwark 026,Southwark,E09000028,7327 ,3465 ,3862 
E02000833,2014,Southwark 027,Southwark,E09000028,5634 ,2534 ,3100 
E02000834,2014,Southwark 028,Southwark,E09000028,7139 ,3433 ,3706 
E02000835,2014,Southwark 029,Southwark,E09000028,5398 ,2581 ,2817 
E02000836,2014,Southwark 030,Southwark,E09000028,5795 ,2898 ,2897 
E02000837,2014,Southwark 031,Southwark,E09000028,6162 ,3078 ,3084 
E02000838,2014,Southwark 032,Southwark,E09000028,6372 ,3017 ,3355 
E02000839,2014,Southwark 033,Southwark,E09000028,5403 ,2603 ,2800 
E02006802,2014,Southwark 034,Southwark,E09000028,6079 ,2896 ,3183 
E02000840,2014,Sutton 001,Sutton,E09000029,5511 ,2556 ,2955 
E02000841,2014,Sutton 002,Sutton,E09000029,5874 ,2807 ,3067 
E02000842,2014,Sutton 003,Sutton,E09000029,5181 ,2548 ,2633 
E02000843,2014,Sutton 004,Sutton,E09000029,5369 ,2602 ,2767 
E02000844,2014,Sutton 005,Sutton,E09000029,5351 ,2557 ,2794 
E02000845,2014,Sutton 006,Sutton,E09000029,6376 ,3129 ,3247 
E02000846,2014,Sutton 007,Sutton,E09000029,4662 ,2315 ,2347 
E02000847,2014,Sutton 008,Sutton,E09000029,5803 ,2871 ,2932 
E02000848,2014,Sutton 009,Sutton,E09000029,5170 ,2568 ,2602 
E02000849,2014,Sutton 010,Sutton,E09000029,5181 ,2551 ,2630 
E02000850,2014,Sutton 011,Sutton,E09000029,7028 ,3497 ,3531 
E02000851,2014,Sutton 012,Sutton,E09000029,6087 ,3091 ,2996 
E02000852,2014,Sutton 013,Sutton,E09000029,5267 ,2580 ,2687 
E02000853,2014,Sutton 014,Sutton,E09000029,5141 ,2482 ,2659 
E02000854,2014,Sutton 015,Sutton,E09000029,4926 ,2430 ,2496 
E02000855,2014,Sutton 016,Sutton,E09000029,5140 ,2543 ,2597 
E02000856,2014,Sutton 017,Sutton,E09000029,5889 ,2905 ,2984 
E02000857,2014,Sutton 018,Sutton,E09000029,5552 ,2799 ,2753 
E02000858,2014,Sutton 019,Sutton,E09000029,5266 ,2425 ,2841 
E02000859,2014,Sutton 020,Sutton,E09000029,5271 ,2506 ,2765 
E02000860,2014,Sutton 021,Sutton,E09000029,5515 ,2839 ,2676 
E02000861,2014,Sutton 022,Sutton,E09000029,4834 ,2371 ,2463 
E02000863,2014,Sutton 024,Sutton,E09000029,4196 ,2029 ,2167 
E02006836,2014,Sutton 025,Sutton,E09000029,5122 ,2531 ,2591 
E02000864,2014,Tower Hamlets 001,Tower Hamlets,E09000030,6406 ,3169 ,3237 
E02000865,2014,Tower Hamlets 002,Tower Hamlets,E09000030,5414 ,2660 ,2754 
E02000866,2014,Tower Hamlets 003,Tower Hamlets,E09000030,7477 ,3768 ,3709 
E02000867,2014,Tower Hamlets 004,Tower Hamlets,E09000030,8940 ,4546 ,4394 
E02000868,2014,Tower Hamlets 005,Tower Hamlets,E09000030,5467 ,2824 ,2643 
E02000869,2014,Tower Hamlets 006,Tower Hamlets,E09000030,4412 ,2340 ,2072 
E02000870,2014,Tower Hamlets 007,Tower Hamlets,E09000030,4690 ,2310 ,2380 
E02000871,2014,Tower Hamlets 008,Tower Hamlets,E09000030,7108 ,3632 ,3476 
E02000872,2014,Tower Hamlets 009,Tower Hamlets,E09000030,6583 ,3526 ,3057 
E02000873,2014,Tower Hamlets 010,Tower Hamlets,E09000030,7181 ,3561 ,3620 
E02000874,2014,Tower Hamlets 011,Tower Hamlets,E09000030,5209 ,2674 ,2535 
E02000875,2014,Tower Hamlets 012,Tower Hamlets,E09000030,8337 ,4208 ,4129 
E02000876,2014,Tower Hamlets 013,Tower Hamlets,E09000030,5986 ,3208 ,2778 
E02000877,2014,Tower Hamlets 014,Tower Hamlets,E09000030,7955 ,4070 ,3885 
E02000878,2014,Tower Hamlets 015,Tower Hamlets,E09000030,9201 ,5048 ,4153 
E02000879,2014,Tower Hamlets 016,Tower Hamlets,E09000030,6009 ,3094 ,2915 
E02000880,2014,Tower Hamlets 017,Tower Hamlets,E09000030,4606 ,2471 ,2135 
E02000881,2014,Tower Hamlets 018,Tower Hamlets,E09000030,5117 ,2503 ,2614 
E02000882,2014,Tower Hamlets 019,Tower Hamlets,E09000030,6266 ,3186 ,3080 
E02000883,2014,Tower Hamlets 020,Tower Hamlets,E09000030,5685 ,2840 ,2845 
E02000884,2014,Tower Hamlets 021,Tower Hamlets,E09000030,8480 ,4845 ,3635 
E02000885,2014,Tower Hamlets 022,Tower Hamlets,E09000030,5076 ,2677 ,2399 
E02000886,2014,Tower Hamlets 023,Tower Hamlets,E09000030,6137 ,3353 ,2784 
E02000887,2014,Tower Hamlets 024,Tower Hamlets,E09000030,6611 ,3257 ,3354 
E02000888,2014,Tower Hamlets 025,Tower Hamlets,E09000030,6826 ,3841 ,2985 
E02000889,2014,Tower Hamlets 026,Tower Hamlets,E09000030,5610 ,3092 ,2518 
E02000890,2014,Tower Hamlets 027,Tower Hamlets,E09000030,4865 ,2624 ,2241 
E02000891,2014,Tower Hamlets 028,Tower Hamlets,E09000030,12111 ,6559 ,5552 
E02000893,2014,Tower Hamlets 030,Tower Hamlets,E09000030,5229 ,2638 ,2591 
E02000894,2014,Tower Hamlets 031,Tower Hamlets,E09000030,8774 ,4651 ,4123 
E02006853,2014,Tower Hamlets 032,Tower Hamlets,E09000030,6985 ,3776 ,3209 
E02006854,2014,Tower Hamlets 033,Tower Hamlets,E09000030,6132 ,3514 ,2618 
E02000895,2014,Waltham Forest 001,Waltham Forest,E09000031,4800 ,2280 ,2520 
E02000896,2014,Waltham Forest 002,Waltham Forest,E09000031,5743 ,2852 ,2891 
E02000897,2014,Waltham Forest 003,Waltham Forest,E09000031,5235 ,2481 ,2754 
E02000898,2014,Waltham Forest 004,Waltham Forest,E09000031,5053 ,2511 ,2542 
E02000899,2014,Waltham Forest 005,Waltham Forest,E09000031,5430 ,2714 ,2716 
E02000900,2014,Waltham Forest 006,Waltham Forest,E09000031,5527 ,2652 ,2875 
E02000901,2014,Waltham Forest 007,Waltham Forest,E09000031,6440 ,3076 ,3364 
E02000902,2014,Waltham Forest 008,Waltham Forest,E09000031,5563 ,2707 ,2856 
E02000903,2014,Waltham Forest 009,Waltham Forest,E09000031,6048 ,2949 ,3099 
E02000904,2014,Waltham Forest 010,Waltham Forest,E09000031,5860 ,2970 ,2890 
E02000905,2014,Waltham Forest 011,Waltham Forest,E09000031,6925 ,3508 ,3417 
E02000906,2014,Waltham Forest 012,Waltham Forest,E09000031,6491 ,3242 ,3249 
E02000907,2014,Waltham Forest 013,Waltham Forest,E09000031,7092 ,3421 ,3671 
E02000908,2014,Waltham Forest 014,Waltham Forest,E09000031,8365 ,4461 ,3904 
E02000909,2014,Waltham Forest 015,Waltham Forest,E09000031,6159 ,2994 ,3165 
E02000910,2014,Waltham Forest 016,Waltham Forest,E09000031,7868 ,3956 ,3912 
E02000911,2014,Waltham Forest 017,Waltham Forest,E09000031,8213 ,4075 ,4138 
E02000912,2014,Waltham Forest 018,Waltham Forest,E09000031,6221 ,3054 ,3167 
E02000913,2014,Waltham Forest 019,Waltham Forest,E09000031,6247 ,3273 ,2974 
E02000914,2014,Waltham Forest 020,Waltham Forest,E09000031,7704 ,3937 ,3767 
E02000915,2014,Waltham Forest 021,Waltham Forest,E09000031,6819 ,3628 ,3191 
E02000916,2014,Waltham Forest 022,Waltham Forest,E09000031,6586 ,3330 ,3256 
E02000917,2014,Waltham Forest 023,Waltham Forest,E09000031,6870 ,3522 ,3348 
E02000918,2014,Waltham Forest 024,Waltham Forest,E09000031,6904 ,3606 ,3298 
E02000919,2014,Waltham Forest 025,Waltham Forest,E09000031,7090 ,3684 ,3406 
E02000920,2014,Waltham Forest 026,Waltham Forest,E09000031,7323 ,3631 ,3692 
E02000921,2014,Waltham Forest 027,Waltham Forest,E09000031,7825 ,3904 ,3921 
E02000922,2014,Waltham Forest 028,Waltham Forest,E09000031,7618 ,4180 ,3438 
E02000923,2014,Wandsworth 001,Wandsworth,E09000032,5625 ,2838 ,2787 
E02000924,2014,Wandsworth 002,Wandsworth,E09000032,9124 ,4497 ,4627 
E02000925,2014,Wandsworth 003,Wandsworth,E09000032,5496 ,2624 ,2872 
E02000926,2014,Wandsworth 004,Wandsworth,E09000032,7247 ,3603 ,3644 
E02000927,2014,Wandsworth 005,Wandsworth,E09000032,5414 ,2586 ,2828 
E02000928,2014,Wandsworth 006,Wandsworth,E09000032,5946 ,2839 ,3107 
E02000929,2014,Wandsworth 007,Wandsworth,E09000032,5068 ,2268 ,2800 
E02000930,2014,Wandsworth 008,Wandsworth,E09000032,8582 ,4140 ,4442 
E02000931,2014,Wandsworth 009,Wandsworth,E09000032,7037 ,3546 ,3491 
E02000932,2014,Wandsworth 010,Wandsworth,E09000032,8316 ,4165 ,4151 
E02000933,2014,Wandsworth 011,Wandsworth,E09000032,6050 ,2919 ,3131 
E02000934,2014,Wandsworth 012,Wandsworth,E09000032,7838 ,3998 ,3840 
E02000935,2014,Wandsworth 013,Wandsworth,E09000032,4729 ,2067 ,2662 
E02000936,2014,Wandsworth 014,Wandsworth,E09000032,6494 ,3135 ,3359 
E02000937,2014,Wandsworth 015,Wandsworth,E09000032,5671 ,2760 ,2911 
E02000938,2014,Wandsworth 016,Wandsworth,E09000032,6858 ,3235 ,3623 
E02000939,2014,Wandsworth 017,Wandsworth,E09000032,5343 ,2584 ,2759 
E02000940,2014,Wandsworth 018,Wandsworth,E09000032,5994 ,2840 ,3154 
E02000941,2014,Wandsworth 019,Wandsworth,E09000032,7271 ,3500 ,3771 
E02000942,2014,Wandsworth 020,Wandsworth,E09000032,6435 ,3051 ,3384 
E02000943,2014,Wandsworth 021,Wandsworth,E09000032,6501 ,3108 ,3393 
E02000944,2014,Wandsworth 022,Wandsworth,E09000032,5017 ,2338 ,2679 
E02000945,2014,Wandsworth 023,Wandsworth,E09000032,5703 ,2708 ,2995 
E02000946,2014,Wandsworth 024,Wandsworth,E09000032,6684 ,3656 ,3028 
E02000947,2014,Wandsworth 025,Wandsworth,E09000032,6146 ,2771 ,3375 
E02000948,2014,Wandsworth 026,Wandsworth,E09000032,7669 ,3548 ,4121 
E02000949,2014,Wandsworth 027,Wandsworth,E09000032,7034 ,3289 ,3745 
E02000950,2014,Wandsworth 028,Wandsworth,E09000032,5335 ,2517 ,2818 
E02000951,2014,Wandsworth 029,Wandsworth,E09000032,5042 ,2338 ,2704 
E02000952,2014,Wandsworth 030,Wandsworth,E09000032,4488 ,2124 ,2364 
E02000953,2014,Wandsworth 031,Wandsworth,E09000032,5770 ,2543 ,3227 
E02000954,2014,Wandsworth 032,Wandsworth,E09000032,4418 ,2050 ,2368 
E02000955,2014,Wandsworth 033,Wandsworth,E09000032,4450 ,2083 ,2367 
E02000956,2014,Wandsworth 034,Wandsworth,E09000032,5937 ,2714 ,3223 
E02000957,2014,Wandsworth 035,Wandsworth,E09000032,8087 ,3925 ,4162 
E02000958,2014,Wandsworth 036,Wandsworth,E09000032,5876 ,2822 ,3054 
E02000959,2014,Wandsworth 037,Wandsworth,E09000032,5653 ,2762 ,2891 
E02000960,2014,Westminster 001,Westminster,E09000033,4746 ,2311 ,2435 
E02000961,2014,Westminster 002,Westminster,E09000033,6758 ,3248 ,3510 
E02000962,2014,Westminster 003,Westminster,E09000033,6089 ,3020 ,3069 
E02000963,2014,Westminster 004,Westminster,E09000033,7391 ,3484 ,3907 
E02000964,2014,Westminster 005,Westminster,E09000033,9736 ,4701 ,5035 
E02000965,2014,Westminster 006,Westminster,E09000033,6806 ,3476 ,3330 
E02000966,2014,Westminster 007,Westminster,E09000033,7319 ,3683 ,3636 
E02000967,2014,Westminster 008,Westminster,E09000033,6313 ,3357 ,2956 
E02000968,2014,Westminster 009,Westminster,E09000033,10027 ,4891 ,5136 
E02000969,2014,Westminster 010,Westminster,E09000033,6432 ,3136 ,3296 
E02000970,2014,Westminster 011,Westminster,E09000033,7450 ,4119 ,3331 
E02000971,2014,Westminster 012,Westminster,E09000033,6638 ,3703 ,2935 
E02000972,2014,Westminster 013,Westminster,E09000033,7912 ,4705 ,3207 
E02000973,2014,Westminster 014,Westminster,E09000033,7943 ,4042 ,3901 
E02000974,2014,Westminster 015,Westminster,E09000033,6634 ,3838 ,2796 
E02000975,2014,Westminster 016,Westminster,E09000033,7684 ,4253 ,3431 
E02000976,2014,Westminster 017,Westminster,E09000033,7972 ,4222 ,3750 
E02000977,2014,Westminster 018,Westminster,E09000033,5477 ,3520 ,1957 
E02000978,2014,Westminster 019,Westminster,E09000033,7702 ,4326 ,3376 
E02000979,2014,Westminster 020,Westminster,E09000033,6829 ,3884 ,2945 
E02000980,2014,Westminster 021,Westminster,E09000033,6772 ,3541 ,3231 
E02000981,2014,Westminster 022,Westminster,E09000033,7413 ,3757 ,3656 
E02000982,2014,Westminster 023,Westminster,E09000033,6280 ,3195 ,3085 
E02000983,2014,Westminster 024,Westminster,E09000033,6337 ,3220 ,3117 
